,Player,Class,Season,Pos,School,Conf,G,MP,FG,FGA,FG%,2P,2PA,3P,3PA,3P%,FT,FTA,FT%,ORB,DRB,TRB,AST,STL,BLK,TOV,PF,PTS
0,Jimmer Fredette,SR,2010-11,G,Brigham Young,MWC,37,1323,346,765,.452,222,452,124,313,.396,252,282,.894,24,103,127,160,49,1,131,49,1068
1,Chris Clemons,SR,2018-19,G,Campbell,Big South,33,1208,304,679,.448,165,290,139,389,.357,246,283,.869,25,142,167,94,49,11,84,63,993
2,Stephen Curry,JR,2008-09,G,Davidson,Southern,34,1145,312,687,.454,182,351,130,336,.387,220,251,.876,21,130,151,189,86,8,126,81,974
3,Kemba Walker,JR,2010-11,G,Connecticut,Big East,41,1543,316,739,.428,241,512,75,227,.330,258,315,.819,53,170,223,184,77,7,93,56,965
4,J.J. Redick,SR,2005-06,G,Duke,ACC,36,1336,302,643,.470,163,313,139,330,.421,221,256,.863,7,64,71,95,52,2,90,54,964
5,Marcus Keene,JR,2016-17,G,Central Michigan,MAC,32,1179,313,700,.447,188,360,125,340,.368,208,254,.819,22,121,143,156,26,0,145,63,959
6,Justin Wright-Foreman,SR,2018-19,G,Hofstra,CAA,35,1321,330,646,.511,220,387,110,259,.425,178,206,.864,12,129,141,102,30,7,91,67,948
7,Trey Johnson,SR,2006-07,G,Jackson State,SWAC,35,1323,311,752,.414,232,515,79,237,.333,246,331,.743,46,112,158,90,32,3,127,63,947
8,Reggie Hamilton,SR,2011-12,G,Oakland,Summit,36,1284,281,630,.446,163,349,118,281,.420,262,299,.876,26,111,137,185,72,2,134,101,942
9,Doug McDermott,SR,2013-14,F,Creighton,Big East,35,1181,330,627,.526,234,413,96,214,.449,178,206,.864,57,187,244,55,8,5,62,67,934
10,Stephen Curry,SO,2007-08,G,Davidson,Southern,36,1193,317,656,.483,155,287,162,369,.439,135,151,.894,28,137,165,104,73,14,93,85,931
11,Reggie Williams,JR,2006-07,F,Virginia Military Institute,Big South,33,1070,338,636,.531,262,398,76,238,.319,176,267,.659,110,153,263,146,55,10,98,67,928
12,Adam Morrison,JR,2005-06,F,Gonzaga,WCC,33,1205,306,617,.496,232,444,74,173,.428,240,311,.772,47,135,182,56,35,11,76,66,926
13,Buddy Hield,SR,2015-16,G,Oklahoma,Big 12,37,1309,301,601,.501,154,279,147,322,.457,176,200,.880,46,166,212,75,42,18,113,76,925
14,Stefon Jackson,SR,2008-09,G,Texas-El Paso,CUSA,37,1336,282,660,.427,250,556,32,104,.308,312,374,.834,61,139,200,71,39,4,78,100,908
15,Chris Clemons,SO,2016-17,G,Campbell,Big South,36,1205,301,674,.447,183,341,118,333,.354,184,223,.825,18,149,167,92,70,18,100,69,904
16,Kevin Durant,FR,2006-07,F,Texas,Big 12,35,1255,306,647,.473,224,444,82,203,.404,209,256,.816,106,284,390,46,66,67,99,71,903
17,Aubrey Coleman,SR,2009-10,G,Houston,CUSA,35,1293,305,717,.425,254,556,51,161,.317,235,319,.737,85,174,259,90,93,6,81,76,896
18,Tyler Hansbrough,JR,2007-08,F,North Carolina,ACC,39,1286,289,535,.540,289,528,0,7,.000,304,377,.806,151,248,399,35,59,14,83,93,882
19,Jordan Howard,SR,2017-18,G,Central Arkansas,Southland,35,1259,280,613,.457,167,326,113,287,.394,207,233,.888,10,115,125,93,36,0,80,41,880
22,Lester Hudson,SR,2008-09,G,Tennessee-Martin,OVC,32,1153,313,697,.449,207,398,106,299,.355,148,168,.881,70,184,254,135,75,18,106,86,880
23,Mike Daum,SO,2016-17,F,South Dakota State,Summit,35,1143,274,533,.514,195,344,79,189,.418,251,289,.869,76,209,285,49,20,15,98,87,878
24,Andrew Goudelock,SR,2010-11,G,College of Charleston,Southern,37,1302,318,699,.455,187,377,131,322,.407,110,134,.821,25,118,143,157,33,7,119,66,877
25,Trae Young,FR,2017-18,G,Oklahoma,Big 12,32,1133,261,618,.422,143,290,118,328,.360,236,274,.861,14,111,125,279,54,8,167,57,876
26,Carsen Edwards,JR,2018-19,G,Purdue,Big Ten,36,1275,277,703,.394,142,323,135,380,.355,185,221,.837,14,116,130,104,48,10,113,73,874
27,T.J. Warren,SO,2013-14,F,North Carolina State,ACC,35,1238,342,652,.525,311,536,31,116,.267,156,226,.690,113,137,250,40,63,21,83,97,871
28,Michael Beasley,FR,2007-08,F,Kansas State,Big 12,33,1041,307,577,.532,271,482,36,95,.379,216,279,.774,131,277,408,38,42,54,95,85,866
29,R.J. Barrett,FR,2018-19,F,Duke,ACC,38,1341,319,702,.454,246,465,73,237,.308,149,224,.665,59,229,288,164,34,16,123,70,860
30,Andre Spight,SR,2017-18,G,Northern Colorado,Big Sky,38,1285,293,661,.443,165,341,128,320,.400,141,180,.783,20,128,148,139,44,10,112,73,855
31,Jermaine Marrow,JR,2018-19,G,Hampton,Big South,35,1275,274,649,.422,186,411,88,238,.370,218,269,.810,26,116,142,171,56,6,111,110,854
32,Jodie Meeks,JR,2008-09,G,Kentucky,SEC,36,1237,263,568,.463,146,280,117,288,.406,211,234,.902,19,103,122,63,48,5,96,69,854
33,Kay Felder,JR,2015-16,G,Oakland,Horizon,35,1286,269,612,.440,193,398,76,214,.355,239,282,.848,26,123,149,324,69,7,120,104,853
34,Markus Howard,JR,2018-19,G,Marquette,Big East,34,1138,252,600,.420,132,302,120,298,.403,227,255,.890,14,121,135,133,36,1,134,72,851
35,Lester Hudson,JR,2007-08,G,Tennessee-Martin,OVC,33,1219,291,627,.464,167,307,124,320,.388,141,169,.834,72,187,259,148,94,22,126,87,847
36,Antoine Mason,JR,2013-14,G,Niagara,MAAC,33,1242,269,612,.440,221,444,48,168,.286,260,357,.728,32,86,118,51,40,5,91,95,846
37,Morris Almond,SR,2006-07,G,Rice,CUSA,32,1069,263,544,.483,186,375,77,169,.456,241,285,.846,43,167,210,37,38,24,109,68,844
38,Keydren Clark,SR,2005-06,G,Saint Peter's,MAAC,32,1243,273,694,.393,168,372,105,322,.326,189,212,.892,42,90,132,140,80,8,102,60,840
39,Quincy Douby,JR,2005-06,G,Rutgers,Big East,33,1211,287,621,.462,171,332,116,289,.401,149,176,.847,27,114,141,103,58,27,92,61,839
40,Trey Freeman,SR,2015-16,G,Old Dominion,CUSA,38,1333,323,753,.429,272,607,51,146,.349,141,170,.829,21,139,160,115,39,4,48,68,838
41,Mike Daum,JR,2017-18,F,South Dakota State,Summit,35,1090,273,591,.462,177,365,96,226,.425,194,228,.851,64,295,359,45,17,26,72,84,836
44,Mike Daum,SR,2018-19,F,South Dakota State,Summit,33,1099,286,559,.512,219,378,67,181,.370,196,234,.838,78,307,385,58,24,32,73,95,835
45,Doug McDermott,JR,2012-13,F,Creighton,MVC,36,1138,284,518,.548,207,361,77,157,.490,189,216,.875,58,218,276,57,8,2,93,56,834
46,David Holston,SR,2008-09,G,Chicago State,Ind,32,1118,269,632,.426,122,237,147,395,.372,145,176,.824,32,87,119,204,97,0,131,68,830
47,Billy Baron,SR,2013-14,G,Canisius,MAAC,34,1325,247,532,.464,140,278,107,254,.421,220,249,.884,17,149,166,180,56,1,101,38,821
48,Lamine Diane,FR,2018-19,F,Cal State Northridge,Big West,33,1165,340,701,.485,333,678,7,23,.304,131,251,.522,108,260,368,68,50,72,105,112,818
49,Jon Elmore,JR,2017-18,G,Marshall,CUSA,36,1380,243,554,.439,145,279,98,275,.356,232,281,.826,16,194,210,244,58,13,132,56,816
50,James Daniel,JR,2015-16,G,Howard,MEAC,30,1115,226,582,.388,146,341,80,241,.332,280,331,.846,22,44,66,84,59,7,123,62,812
51,Dallas Moore,SR,2016-17,G,North Florida,A-Sun,34,1192,299,613,.488,199,362,100,251,.398,114,138,.826,26,81,107,135,39,3,82,39,812
52,Jermaine Taylor,SR,2008-09,G,Central Florida,CUSA,31,989,291,606,.480,199,361,92,245,.376,138,170,.812,59,102,161,58,39,24,87,55,812
53,Gary Neal,SR,2006-07,G,Towson,CAA,32,1167,267,599,.446,174,321,93,278,.335,183,219,.836,28,107,135,111,46,5,74,66,810
54,Ja Morant,SO,2018-19,G,Murray State,OVC,33,1207,265,531,.499,208,374,57,157,.363,221,272,.813,40,148,188,331,58,27,170,48,808
55,Erick Green,SR,2012-13,G,Virginia Tech,ACC,32,1166,261,550,.475,200,393,61,157,.389,218,267,.816,15,112,127,121,42,6,69,44,801
56,Doug McDermott,SO,2011-12,F,Creighton,MVC,35,1117,307,511,.601,253,400,54,111,.486,133,167,.796,84,204,288,37,7,3,79,61,801
57,Rob McKiver,SR,2007-08,G,Houston,CUSA,34,1183,233,588,.396,88,212,145,376,.386,190,215,.884,18,113,131,99,56,2,86,65,801
58,Charron Fisher,SR,2007-08,F,Niagara,MAAC,29,1084,256,645,.397,187,428,69,217,.318,219,284,.771,92,183,275,34,49,18,89,75,800
59,Blake Griffin,SO,2008-09,F,Oklahoma,Big 12,35,1165,300,459,.654,297,451,3,8,.375,191,324,.590,135,369,504,80,39,41,116,89,794
60,Reggie Holmes,SR,2009-10,G,Morgan State,MEAC,37,1226,226,583,.388,126,304,100,279,.358,241,294,.820,56,102,158,31,57,6,74,88,793
61,Luke Harangody,JR,2008-09,F,Notre Dame,Big East,34,1164,300,653,.459,286,615,14,38,.368,178,229,.777,120,281,401,70,31,31,62,77,792
62,Marshon Brooks,SR,2010-11,G,Providence,Big East,32,1168,276,571,.483,209,374,67,197,.340,169,219,.772,72,153,225,80,48,39,98,80,788
63,Jaycee Carroll,SR,2007-08,G,Utah State,WAC,35,1304,267,508,.526,153,279,114,229,.498,137,149,.919,56,153,209,76,33,7,70,65,785
66,Antoine Davis,FR,2018-19,G,Detroit Mercy,Horizon,30,1122,263,657,.400,131,310,132,347,.380,126,147,.857,22,72,94,107,28,0,99,70,784
67,Damian Lillard,JR,2011-12,G,Weber State,Big Sky,32,1105,231,495,.467,137,265,94,230,.409,228,257,.887,17,144,161,128,47,7,74,62,784
68,Myles Powell,JR,2018-19,G,Seton Hall,Big East,34,1225,252,564,.447,145,269,107,295,.363,173,206,.840,26,110,136,99,68,6,101,76,784
69,R.J. Cole,FR,2017-18,G,Howard,MEAC,33,1252,241,612,.394,132,308,109,304,.359,191,248,.770,27,103,130,200,57,0,127,87,782
70,Steve Burtt,SR,2005-06,G,Iona,MAAC,31,1103,258,579,.446,162,343,96,236,.407,168,204,.824,18,85,103,79,22,2,98,72,780
71,Norris Cole,SR,2010-11,G,Cleveland State,Horizon,36,1285,251,572,.439,200,423,51,149,.342,227,266,.853,27,183,210,191,80,3,97,87,780
72,Tyler Haws,SO,2012-13,G,Brigham Young,WCC,36,1235,276,571,.483,233,458,43,113,.381,185,211,.877,49,116,165,71,45,5,71,54,780
73,Randy Onwuasor,JR,2016-17,G,Southern Utah,Big Sky,33,1155,253,619,.409,194,426,59,193,.306,215,260,.827,52,165,217,107,50,14,113,104,780
74,Grayson Allen,SO,2015-16,G,Duke,ACC,36,1317,239,513,.466,149,297,90,216,.417,211,252,.837,24,141,165,127,47,5,72,98,779
75,Alec Burks,SO,2010-11,G,Colorado,Big 12,38,1193,251,535,.469,223,439,28,96,.292,249,302,.825,91,156,247,112,41,12,99,89,779
76,Stefon Jackson,JR,2007-08,G,Texas-El Paso,CUSA,33,1158,261,562,.464,226,457,35,105,.333,221,303,.729,56,132,188,57,39,3,77,77,778
77,Kendrick Nunn,SR,2017-18,G,Oakland,Horizon,30,1136,262,602,.435,128,262,134,340,.394,119,142,.838,27,115,142,113,45,11,88,67,777
78,Anthony Barber,JR,2015-16,G,North Carolina State,ACC,33,1278,248,572,.434,205,453,43,119,.361,237,274,.865,21,130,151,147,21,2,85,71,776
79,Tyler Haws,SR,2014-15,G,Brigham Young,WCC,35,1125,258,538,.480,204,391,54,147,.367,206,236,.873,46,110,156,83,33,9,69,48,776
80,Bo McCalebb,JR,2006-07,G,New Orleans,Sun Belt,31,1071,287,601,.478,261,523,26,78,.333,176,248,.710,76,135,211,101,62,5,88,86,776
81,Chris Clemons,JR,2017-18,G,Campbell,Big South,31,1055,233,515,.452,138,259,95,256,.371,211,245,.861,10,132,142,95,49,10,83,58,772
82,MoMo Jones,SR,2012-13,G,Iona,MAAC,34,1246,246,561,.439,190,383,56,178,.315,221,249,.888,24,77,101,116,40,2,114,73,769
83,Tyler Haws,JR,2013-14,G,Brigham Young,WCC,33,1143,252,544,.463,212,445,40,99,.404,223,253,.881,33,93,126,49,34,9,63,75,767
84,Kevin Foster,SO,2010-11,G,Santa Clara,WCC,38,1221,229,594,.386,89,214,140,380,.368,168,210,.800,14,90,104,141,61,5,117,90,766
85,C.J. McCollum,JR,2011-12,G,Lehigh,Patriot,35,1160,254,573,.443,194,397,60,176,.341,198,244,.811,50,179,229,124,91,19,81,73,766
88,Ben Woodside,SR,2008-09,G,North Dakota State,Summit,33,1137,234,504,.464,167,347,67,157,.427,231,275,.840,9,97,106,204,47,5,104,44,766
89,Rashawn Thomas,SR,2016-17,F,Texas A&M-Corpus Christi,Southland,34,1145,268,511,.524,254,474,14,37,.378,215,298,.721,78,227,305,92,53,69,126,118,765
90,Josh Akognon,SR,2008-09,G,Cal State Fullerton,Big West,32,1140,248,618,.401,112,252,136,366,.372,132,148,.892,18,83,101,51,32,1,84,63,764
91,Nolan Smith,SR,2010-11,G,Duke,ACC,37,1259,260,568,.458,203,405,57,163,.350,187,230,.813,44,122,166,189,45,3,118,72,764
92,Bryce Cotton,SR,2013-14,G,Providence,Big East,35,1398,230,549,.419,153,339,77,210,.367,226,265,.853,19,105,124,205,35,3,85,51,763
93,Jock Landale,JR,2017-18,C,Saint Mary's (CA),WCC,36,1200,301,470,.640,298,460,3,10,.300,156,209,.746,106,260,366,72,14,36,84,109,761
94,Eric Maynor,SR,2008-09,G,Virginia Commonwealth,CAA,34,1206,248,536,.463,182,353,66,183,.361,198,243,.815,16,106,122,210,58,6,101,82,760
95,Jalen Brunson,JR,2017-18,G,Villanova,Big East,40,1272,270,518,.521,184,307,86,211,.408,130,162,.802,12,110,122,184,37,1,71,78,756
96,Justin Wright-Foreman,JR,2017-18,G,Hofstra,CAA,31,1171,264,588,.449,168,326,96,262,.366,131,164,.799,10,93,103,100,25,7,69,62,755
97,Malik Monk,FR,2016-17,G,Kentucky,SEC,38,1218,251,558,.450,147,296,104,262,.397,148,180,.822,12,83,95,87,36,19,75,72,754
98,Donald Sims,JR,2009-10,G,Appalachian State,Southern,37,1273,228,499,.457,105,211,123,288,.427,175,184,.951,9,108,117,84,33,1,90,43,754
99,Frank Mason,SR,2016-17,G,Kansas,Big 12,36,1301,241,492,.490,159,318,82,174,.471,189,238,.794,22,128,150,187,47,2,86,73,753
100,D.J. Balentine,SO,2013-14,G,Evansville,MVC,33,1252,229,528,.434,151,332,78,196,.398,216,255,.847,16,72,88,139,19,4,84,56,752
101,Jordan Davis,SR,2018-19,G,Northern Colorado,Big Sky,32,1082,256,540,.474,202,390,54,150,.360,186,231,.805,29,121,150,149,45,10,107,73,752
102,Toney Douglas,SR,2008-09,G,Florida State,ACC,35,1279,239,536,.446,154,315,85,221,.385,188,232,.810,28,109,137,102,63,15,87,76,751
103,Jimmer Fredette,JR,2009-10,G,Brigham Young,MWC,34,1059,225,491,.458,148,316,77,175,.440,224,251,.892,25,80,105,159,41,5,93,36,751
104,Trey Johnson,JR,2005-06,G,Jackson State,SWAC,32,1114,255,560,.455,188,408,67,152,.441,174,232,.750,52,103,155,73,46,2,86,71,751
105,Fletcher Magee,JR,2017-18,G,Wofford,Southern,34,1143,253,523,.484,105,186,148,337,.439,97,107,.907,9,91,100,58,31,3,57,62,751
106,Jon Elmore,SR,2018-19,G,Marshall,CUSA,37,1330,234,595,.393,120,282,114,313,.364,168,213,.789,11,178,189,187,64,20,114,74,750
107,Garrison Mathews,SR,2018-19,G,Lipscomb,A-Sun,36,1082,222,501,.443,106,213,116,288,.403,190,221,.860,25,172,197,70,30,9,82,68,750
108,Russ Smith,JR,2012-13,G,Louisville,Big East,40,1211,232,560,.414,170,371,62,189,.328,222,276,.804,41,91,132,116,83,2,108,102,748
109,Jaycee Carroll,JR,2006-07,G,Utah State,WAC,35,1255,256,486,.527,173,294,83,192,.432,151,170,.888,80,140,220,62,31,7,88,76,746
110,Charles Jenkins,SR,2010-11,G,Hofstra,CAA,33,1232,249,482,.517,183,325,66,157,.420,182,221,.824,18,93,111,158,57,22,73,66,746
111,Bryson Scott,SR,2017-18,G,Purdue-Fort Wayne,Summit,33,1026,247,541,.457,197,372,50,169,.296,202,247,.818,20,128,148,86,65,5,91,65,746
112,Zion Williamson,FR,2018-19,F,Duke,ACC,33,990,296,435,.680,272,364,24,71,.338,130,203,.640,116,177,293,68,70,59,78,68,746
113,Joe Young,SR,2014-15,G,Oregon,Pac-12,36,1322,265,592,.448,174,337,91,255,.357,124,134,.925,19,141,160,135,41,1,87,51,745
114,Luke Babbitt,SO,2009-10,F,Nevada,WAC,34,1260,251,502,.500,209,401,42,101,.416,199,217,.917,70,233,303,72,35,27,81,87,743
115,Kelan Martin,SR,2017-18,F,Butler,Big East,35,1249,259,580,.447,164,319,95,261,.364,130,154,.844,33,186,219,70,26,16,84,67,743
116,Adrian Oliver,SR,2010-11,G,San Jose State,WAC,31,1086,246,569,.432,176,398,70,171,.409,181,220,.823,39,126,165,78,23,12,96,85,743
117,Bo McCalebb,SR,2007-08,G,New Orleans,Sun Belt,32,1065,261,516,.506,214,400,47,116,.405,173,224,.772,50,93,143,99,76,3,74,85,742
118,Arizona Reid,SR,2007-08,F,High Point,Big South,31,1093,304,571,.532,270,481,34,90,.378,100,134,.746,105,237,342,75,54,16,65,87,742
119,D'Marcus Simonds,SO,2017-18,G,Georgia State,Sun Belt,35,1223,277,601,.461,235,457,42,144,.292,146,208,.702,46,155,201,153,60,24,127,100,742
120,Roosevelt Smart,SO,2017-18,G,North Texas,CUSA,38,1274,221,557,.397,88,205,133,352,.378,167,188,.888,17,141,158,35,23,10,65,86,742
121,Bogdan Bliznyuk,SR,2017-18,F,Eastern Washington,Big Sky,35,1228,265,502,.528,220,389,45,113,.398,166,184,.902,33,205,238,137,29,10,119,83,741
122,Derrick Williams,SO,2010-11,F,Arizona,Pac-10,38,1141,226,380,.595,184,306,42,74,.568,247,331,.746,105,209,314,43,37,26,100,106,741
123,Josh Adams,SR,2015-16,G,Wyoming,MWC,30,1106,217,492,.441,121,238,96,254,.378,210,254,.827,18,148,166,127,44,18,114,84,740
124,Tyler Hall,SO,2016-17,G,Montana State,Big Sky,32,1101,240,504,.476,120,224,120,280,.429,139,166,.837,17,155,172,90,34,12,65,78,739
125,Marcus Thornton,SR,2008-09,G,Louisiana State,SEC,35,1116,256,542,.472,178,341,78,201,.388,149,200,.745,71,121,192,75,56,13,64,72,739
126,Ben Bentil,SO,2015-16,F,Providence,Big East,35,1198,246,533,.462,194,375,52,158,.329,194,248,.782,94,174,268,40,30,36,67,97,738
127,Tyler Harvey,JR,2014-15,G,Eastern Washington,Big Sky,32,1182,230,490,.469,102,193,128,297,.431,150,176,.852,20,96,116,82,36,4,64,60,738
130,Aaric Murray,SR,2013-14,C,Texas Southern,SWAC,34,1088,241,491,.491,210,399,31,92,.337,223,301,.741,74,181,255,41,29,86,89,88,736
131,Kyle Wiltjer,SR,2015-16,F,Gonzaga,WCC,36,1209,260,529,.491,170,323,90,206,.437,126,147,.857,61,167,228,53,13,29,74,66,736
132,James Anderson,JR,2009-10,G,Oklahoma State,Big 12,33,1124,226,494,.457,152,277,74,217,.341,209,258,.810,64,128,192,80,46,20,78,88,735
133,Courtney Lee,SR,2007-08,G,Western Kentucky,Sun Belt,36,1079,259,543,.477,190,369,69,174,.397,148,180,.822,48,127,175,75,65,28,84,87,735
134,Nate Wolters,SR,2012-13,G,South Dakota State,Summit,33,1256,242,499,.485,178,330,64,169,.379,187,230,.813,36,148,184,193,57,4,77,51,735
135,Nick Mayo,SR,2018-19,F,Eastern Kentucky,OVC,31,1079,245,530,.462,191,367,54,163,.331,190,220,.864,70,201,271,70,38,55,85,83,734
136,Klay Thompson,JR,2010-11,G,Washington State,Pac-10,34,1179,240,551,.436,142,305,98,246,.398,155,185,.838,25,153,178,127,56,32,115,99,733
137,Cassius Winston,JR,2018-19,G,Michigan State,Big Ten,39,1308,243,528,.460,159,317,84,211,.398,163,194,.840,13,104,117,291,40,4,114,75,733
138,Kevin Foster,SR,2012-13,G,Santa Clara,WCC,38,1233,241,602,.400,121,267,120,335,.358,130,166,.783,15,88,103,165,91,5,131,90,732
139,Frank Kaminsky,SR,2014-15,C,Wisconsin,Big Ten,39,1311,267,488,.547,225,387,42,101,.416,156,200,.780,58,262,320,103,33,57,63,65,732
140,Tyler Nelson,SR,2017-18,G,Fairfield,MAAC,33,1205,230,547,.420,126,252,104,295,.353,168,191,.880,18,120,138,110,45,3,82,55,732
141,D.J. Augustin,SO,2007-08,G,Texas,Big 12,38,1417,242,551,.439,168,357,74,194,.381,173,221,.783,20,92,112,219,47,0,105,61,731
142,Andre Collins,SR,2005-06,G,Loyola (MD),MAAC,28,1066,256,619,.414,138,297,118,322,.366,101,112,.902,21,79,100,131,67,4,104,65,731
143,Justin Jackson,JR,2016-17,F,North Carolina,ACC,40,1281,264,596,.443,159,312,105,284,.370,98,131,.748,58,128,186,113,31,9,69,55,731
144,Sam Merrill,JR,2018-19,G,Utah State,MWC,35,1237,228,495,.461,142,266,86,229,.376,189,208,.909,12,126,138,147,37,10,66,86,731
145,Stefan Moody,SR,2015-16,G,Mississippi,SEC,31,1072,208,509,.409,105,237,103,272,.379,212,256,.828,31,69,100,133,46,3,118,75,731
146,Deshaun Thomas,JR,2012-13,F,Ohio State,Big Ten,37,1309,259,583,.444,187,374,72,209,.344,141,169,.834,63,157,220,48,19,11,52,54,731
147,Travis Bader,JR,2012-13,G,Oakland,Summit,33,1261,206,523,.394,67,163,139,360,.386,179,202,.886,12,83,95,32,30,2,47,93,730
148,Stephen Curry,FR,2006-07,G,Davidson,Southern,34,1049,242,523,.463,120,224,122,299,.408,124,145,.855,32,125,157,95,62,6,95,87,730
149,Alan Daniels,SR,2005-06,F,Lamar,Southland,31,1089,250,574,.436,175,327,75,247,.304,155,233,.665,59,148,207,92,72,21,76,76,730
152,Rui Hachimura,JR,2018-19,F,Gonzaga,WCC,37,1117,275,465,.591,260,429,15,36,.417,164,222,.739,52,188,240,56,35,27,68,74,729
153,Kevin Tiggs,SR,2008-09,F,East Tennessee State,A-Sun,34,1150,248,469,.529,211,364,37,105,.352,196,256,.766,63,99,162,68,72,8,104,75,729
154,R.J. Cole,SO,2018-19,G,Howard,MEAC,34,1209,218,525,.415,134,308,84,217,.387,208,254,.819,24,116,140,218,64,1,110,76,728
155,Jack Gibbs,JR,2015-16,G,Davidson,A-10,31,1099,244,565,.432,162,320,82,245,.335,158,188,.840,28,100,128,152,56,2,100,59,728
156,Jon Scheyer,SR,2009-10,G,Duke,ACC,40,1470,212,531,.399,102,244,110,287,.383,194,221,.878,31,113,144,194,65,10,65,54,728
157,Cameron Young,SR,2018-19,G,Quinnipiac,MAAC,31,1113,222,461,.482,118,223,104,238,.437,180,235,.766,31,128,159,58,35,9,89,69,728
158,Trey Burke,SO,2012-13,G,Michigan,Big Ten,39,1378,259,560,.463,183,362,76,198,.384,133,166,.801,21,103,124,260,62,20,86,73,727
159,Jeremy Hazell,SO,2008-09,G,Seton Hall,Big East,32,1161,235,550,.427,130,260,105,290,.362,151,204,.740,41,81,122,29,56,1,69,63,726
160,Rodney Stuckey,FR,2005-06,G,Eastern Washington,Big Sky,30,990,250,510,.490,195,362,55,148,.372,171,225,.760,32,112,144,123,66,8,107,75,726
161,Tony Carr,SO,2017-18,G,Penn State,Big Ten,37,1308,245,600,.408,157,397,88,203,.433,147,184,.799,33,150,183,186,30,11,85,68,725
162,Marvelle Harris,SR,2015-16,G,Fresno State,MWC,35,1284,240,589,.407,174,386,66,203,.325,179,238,.752,19,144,163,156,76,21,77,102,725
163,Jerome Robinson,JR,2017-18,F,Boston College,ACC,35,1260,249,513,.485,168,315,81,198,.409,146,176,.830,17,109,126,116,30,5,96,88,725
164,Chris Douglas-Roberts,JR,2007-08,G,Memphis,CUSA,40,1147,259,479,.541,214,370,45,109,.413,161,226,.712,53,112,165,71,49,18,83,68,724
165,Chasson Randle,SR,2014-15,G,Stanford,Pac-12,37,1347,217,539,.403,127,291,90,248,.363,200,228,.877,11,112,123,112,50,5,75,82,724
166,Grant Riller,JR,2018-19,G,College of Charleston,CAA,33,1172,264,491,.538,218,351,46,140,.329,150,186,.806,19,94,113,134,41,2,79,56,724
167,Omar Samhan,SR,2009-10,C,Saint Mary's (CA),WCC,34,1098,282,510,.553,282,509,0,1,.000,160,220,.727,119,250,369,34,15,99,72,102,724
168,D.J. Balentine,JR,2014-15,G,Evansville,MVC,36,1318,245,563,.435,171,374,74,189,.392,159,212,.750,18,96,114,116,29,7,78,35,723
169,Drake Reed,SR,2008-09,F,Austin Peay,OVC,33,1211,275,487,.565,258,441,17,46,.370,156,209,.746,84,165,249,78,24,19,83,66,723
170,Jonathan Stark,JR,2016-17,G,Murray State,OVC,33,1207,249,568,.438,141,314,108,254,.425,117,141,.830,9,119,128,172,43,1,95,75,723
171,Marshall Henderson,JR,2012-13,G,Mississippi,SEC,36,1134,209,549,.381,71,155,138,394,.350,166,188,.883,17,94,111,63,48,2,76,59,722
174,Luke Kennard,SO,2016-17,G,Duke,ACC,37,1314,237,485,.489,149,284,88,201,.438,160,187,.856,43,145,188,91,31,13,59,83,722
175,Nick Fazekas,JR,2005-06,F,Nevada,WAC,33,1051,268,507,.529,237,400,31,107,.290,154,182,.846,100,242,342,68,36,49,59,59,721
176,Nate Wolters,JR,2011-12,G,South Dakota State,Summit,34,1216,250,558,.448,217,421,33,137,.241,188,240,.783,31,143,174,202,59,2,75,63,721
177,Jamal Murray,FR,2015-16,G,Kentucky,SEC,36,1267,244,538,.454,131,261,113,277,.408,119,152,.783,53,133,186,79,35,11,84,75,720
178,Shabazz Napier,SR,2013-14,G,Connecticut,AAC,40,1404,213,496,.429,126,281,87,215,.405,207,238,.870,38,196,234,195,73,13,114,84,720
179,Jeremy Senglin,SR,2016-17,G,Weber State,Big Sky,34,1198,233,490,.476,101,195,132,295,.447,121,158,.766,6,125,131,96,38,1,81,73,719
180,Jordan Crawford,SO,2009-10,G,Xavier,A-10,35,1147,260,563,.462,181,361,79,202,.391,119,154,.773,34,132,166,101,47,7,85,57,718
181,Joel Hernandez,JR,2017-18,G,Long Island University,NEC,35,1152,256,555,.461,198,400,58,155,.374,148,223,.664,65,138,203,90,19,17,104,90,718
182,Georges Niang,SR,2015-16,F,Iowa State,Big 12,35,1162,283,518,.546,227,375,56,143,.392,96,119,.807,46,172,218,117,31,22,92,111,718
183,Ty Cockfield,SR,2018-19,G,Arkansas State,Sun Belt,32,1122,237,540,.439,168,346,69,194,.356,173,211,.820,26,88,114,103,36,4,94,65,716
184,Jordan Ford,JR,2018-19,G,Saint Mary's (CA),WCC,34,1255,255,521,.489,185,351,70,170,.412,136,170,.800,17,78,95,85,43,1,65,57,716
185,Andrew Rowsey,SR,2017-18,G,Marquette,Big East,35,1143,208,495,.420,83,194,125,301,.415,175,194,.902,14,91,105,169,32,7,99,83,716
186,Zach Thomas,SR,2017-18,G,Bucknell,Patriot,35,1113,206,446,.462,143,281,63,165,.382,241,310,.777,45,272,317,74,35,24,103,71,716
187,Alando Tucker,SR,2006-07,G,Wisconsin,Big Ten,36,1181,256,545,.470,216,422,40,123,.325,164,249,.659,78,118,196,73,33,10,60,45,716
188,Keon Johnson,SR,2016-17,G,Winthrop,Big South,32,1124,221,511,.432,119,256,102,255,.400,171,197,.868,14,113,127,83,22,0,74,60,715
189,Garrison Mathews,JR,2017-18,G,Lipscomb,A-Sun,33,1003,213,458,.465,123,222,90,236,.381,199,249,.799,41,139,180,58,32,9,71,83,715
190,Jacob Pullen,JR,2009-10,G,Kansas State,Big 12,37,1168,201,480,.419,91,202,110,278,.396,203,247,.822,16,80,96,125,67,2,93,89,715
191,Robert Glenn,SR,2009-10,F,IUPUI,Summit,36,1118,259,446,.581,254,423,5,23,.217,191,253,.755,74,166,240,62,44,50,109,105,714
192,David Kool,SR,2009-10,G,Western Michigan,MAC,33,1155,221,492,.449,158,316,63,176,.358,209,233,.897,35,100,135,87,58,0,73,53,714
193,Andrew Andrews,SR,2015-16,G,Washington,Pac-12,34,1150,181,461,.393,104,269,77,192,.401,273,321,.850,50,145,195,165,47,1,95,96,712
196,Tyus Battle,SO,2017-18,G,Syracuse,ACC,37,1443,234,586,.399,157,347,77,239,.322,167,199,.839,17,91,108,76,54,7,87,74,712
197,Pierre Jackson,SR,2012-13,G,Baylor,Big 12,36,1252,216,506,.427,128,261,88,245,.359,192,240,.800,24,111,135,255,54,0,122,80,712
198,Patrick Miller,JR,2013-14,G,Tennessee State,OVC,30,1132,230,514,.447,186,383,44,131,.336,208,268,.776,45,89,134,123,49,5,100,88,712
199,Rodney Stuckey,SO,2006-07,G,Eastern Washington,Big Sky,29,965,227,501,.453,184,340,43,161,.267,215,254,.846,35,100,135,160,71,9,98,68,712
200,Cameron Morse,JR,2016-17,G,Youngstown State,Horizon,31,1123,260,627,.415,184,389,76,238,.319,115,156,.737,16,84,100,96,32,3,66,44,711
201,Zeek Woodley,SO,2014-15,G,Northwestern State,Southland,32,1009,262,468,.560,223,370,39,98,.398,148,182,.813,55,105,160,34,33,22,38,73,711
202,Karvel Anderson,SR,2013-14,G,Robert Morris,NEC,36,1100,248,486,.510,129,229,119,257,.463,95,113,.841,27,93,120,50,48,8,44,72,710
203,Ty Greene,SR,2014-15,G,South Carolina Upstate,A-Sun,35,1191,232,522,.444,129,269,103,253,.407,142,189,.751,30,78,108,74,74,7,45,56,709
204,Fletcher Magee,SR,2018-19,G,Wofford,Southern,35,1098,225,513,.439,67,136,158,377,.419,101,111,.910,13,76,89,55,26,3,49,50,709
205,Jeremy Ingram,SR,2013-14,G,North Carolina Central,MEAC,34,1170,212,483,.439,144,299,68,184,.370,216,280,.771,33,97,130,41,54,22,70,90,708
206,Jeremiah Martin,SR,2018-19,G,Memphis,AAC,36,1230,220,488,.451,154,297,66,191,.346,202,265,.762,39,114,153,157,79,23,95,69,708
207,James Palmer,SR,2018-19,G,Nebraska,Big Ten,36,1266,213,578,.369,146,364,67,214,.313,215,282,.762,39,111,150,107,52,14,77,78,708
208,Seth Curry,FR,2008-09,G,Liberty,Big South,35,1277,243,583,.417,141,289,102,294,.347,119,143,.832,24,129,153,79,48,9,79,53,707
209,Cameron Payne,SO,2014-15,G,Murray State,OVC,35,1127,245,537,.456,161,314,84,223,.377,133,169,.787,21,108,129,209,68,17,87,72,707
210,Kyle Singler,JR,2009-10,F,Duke,ACC,40,1436,228,550,.415,143,337,85,213,.399,166,208,.798,90,190,280,96,41,32,79,86,707
211,Mikal Bridges,JR,2017-18,F,Villanova,Big East,40,1285,244,475,.514,140,236,104,239,.435,114,134,.851,54,158,212,77,61,43,54,86,706
212,Justin James,SR,2018-19,G,Wyoming,MWC,32,1221,228,557,.409,178,388,50,169,.296,200,270,.741,32,241,273,141,48,18,133,68,706
213,Shane Gibson,JR,2011-12,G,Sacred Heart,NEC,32,1082,253,496,.510,166,295,87,201,.433,112,130,.862,25,124,149,70,48,11,101,91,705
214,Dominique Jones,JR,2009-10,G,South Florida,Big East,33,1224,222,493,.450,170,326,52,167,.311,209,282,.741,37,164,201,120,56,19,97,93,705
215,Max Strus,SR,2018-19,G,DePaul,Big East,35,1309,232,541,.429,119,230,113,311,.363,128,152,.842,39,168,207,77,33,17,70,103,705
216,Deandre Ayton,FR,2017-18,F,Arizona,Pac-12,35,1172,276,451,.612,264,416,12,35,.343,140,191,.733,118,287,405,57,20,66,69,81,704
217,D.J. Covington,SR,2013-14,F,Virginia Military Institute,Big South,35,1040,268,452,.593,268,450,0,2,.000,168,241,.697,94,232,326,29,34,106,74,108,704
218,Jarrett Culver,SO,2018-19,G,Texas Tech,Big 12,38,1234,254,551,.461,205,390,49,161,.304,147,208,.707,54,189,243,142,57,21,103,73,704
219,LaceDarius Dunn,JR,2009-10,G,Baylor,Big 12,36,1174,231,513,.450,115,236,116,277,.419,126,147,.857,30,143,173,67,49,11,91,108,704
220,Landry Fields,SR,2009-10,G,Stanford,Pac-10,32,1161,248,506,.490,219,420,29,86,.337,179,257,.696,81,199,280,89,51,25,83,65,704
221,Tyler Hansbrough,SR,2008-09,F,North Carolina,ACC,34,1029,223,434,.514,214,411,9,23,.391,249,296,.841,103,173,276,34,42,12,63,77,704
222,James Harden,SO,2008-09,G,Arizona State,Pac-10,35,1254,221,452,.489,163,289,58,163,.356,204,270,.756,48,147,195,148,59,11,118,99,704
223,D.J. Newbill,SR,2014-15,G,Penn State,Big Ten,34,1261,243,540,.450,182,375,61,165,.370,157,207,.758,37,123,160,105,44,7,90,73,704
224,Shawn Glover,SR,2013-14,F,Oral Roberts,Southland,33,1151,273,547,.499,248,495,25,52,.481,132,159,.830,42,150,192,49,28,53,72,67,703
225,Junior Robinson,SR,2017-18,G,Mount St. Mary's,NEC,32,1162,228,511,.446,150,310,78,201,.388,169,188,.899,19,73,92,154,37,1,89,87,703
226,C.J. Burks,JR,2017-18,G,Marshall,CUSA,35,1256,260,551,.472,174,315,86,236,.364,96,108,.889,18,126,144,107,36,4,108,74,702
227,Charles Jenkins,JR,2009-10,G,Hofstra,CAA,34,1234,235,531,.443,172,377,63,154,.409,169,210,.805,38,116,154,134,61,19,108,89,702
228,Dylan Windler,SR,2018-19,F,Belmont,OVC,33,1097,243,450,.540,143,217,100,233,.429,116,137,.847,64,293,357,84,47,19,69,69,702
229,Peyton Aldridge,SR,2017-18,F,Davidson,A-10,33,1245,252,526,.479,175,324,77,202,.381,120,141,.851,46,205,251,82,13,20,40,51,701
230,Bogdan Bliznyuk,JR,2016-17,F,Eastern Washington,Big Sky,34,1251,251,529,.474,213,409,38,120,.317,161,196,.821,36,186,222,136,36,7,104,92,701
231,Sean Kilpatrick,SR,2013-14,G,Cincinnati,AAC,34,1149,214,506,.423,121,239,93,267,.348,180,213,.845,36,110,146,86,48,1,70,46,701
232,Dedric Lawson,JR,2018-19,F,Kansas,Big 12,36,1175,249,508,.490,214,419,35,89,.393,167,205,.815,111,260,371,61,45,38,83,94,700
233,Devan Downey,SR,2009-10,G,South Carolina,SEC,31,1055,237,592,.400,168,390,69,202,.342,156,187,.834,17,85,102,108,85,1,109,72,699
234,Tyler Hansbrough,SO,2006-07,F,North Carolina,ACC,38,1136,228,434,.525,227,430,1,4,.250,242,315,.768,117,184,301,45,41,17,74,90,699
235,Adrian Oliver,JR,2009-10,G,San Jose State,WAC,31,1119,230,526,.437,179,401,51,125,.408,188,212,.887,49,115,164,89,30,15,99,92,699
238,D.J. Balentine,SR,2015-16,G,Evansville,MVC,34,1253,240,543,.442,182,372,58,171,.339,160,204,.784,26,87,113,148,24,9,92,58,698
239,Jabari Brown,JR,2013-14,G,Missouri,SEC,35,1295,203,435,.467,123,240,80,195,.410,212,266,.797,17,138,155,67,22,5,82,57,698
240,Gary Forbes,SR,2007-08,F,Massachusetts,A-10,36,1214,233,572,.407,176,377,57,195,.292,175,243,.720,65,205,270,109,41,25,113,87,698
241,Caleb Green,SR,2006-07,F,Oral Roberts,Mid-Cont,34,1184,207,413,.501,201,396,6,17,.353,278,366,.760,95,220,315,87,47,12,135,99,698
242,JaJuan Johnson,SR,2010-11,F,Purdue,Big Ten,34,1203,257,520,.494,242,469,15,51,.294,169,209,.809,82,209,291,33,30,79,56,53,698
243,Ryan Anderson,SO,2007-08,F,University of California,Pac-10,33,1082,230,469,.490,166,313,64,156,.410,173,199,.869,100,228,328,47,12,18,74,71,697
244,Khalif Wyatt,SR,2012-13,G,Temple,A-10,34,1136,209,501,.417,134,264,75,237,.316,204,244,.836,14,84,98,135,58,7,106,75,697
245,John Jenkins,JR,2011-12,G,Vanderbilt,SEC,35,1177,217,458,.474,83,153,134,305,.439,128,153,.837,16,85,101,42,29,11,55,42,696
246,Grant Williams,JR,2018-19,F,Tennessee,SEC,37,1181,234,415,.564,219,369,15,46,.326,213,260,.819,82,196,278,117,42,55,83,110,696
247,Adrian Banks,JR,2006-07,G,Arkansas State,Sun Belt,33,1219,232,468,.496,135,264,97,204,.475,134,183,.732,25,119,144,63,29,3,85,39,695
248,Quincy Pondexter,SR,2009-10,F,Washington,Pac-10,36,1162,245,464,.528,227,413,18,51,.353,187,226,.827,107,158,265,63,46,21,68,90,695
249,Robert Vaden,JR,2007-08,G,Alabama-Birmingham,CUSA,33,1170,220,539,.408,78,184,142,355,.400,113,131,.863,14,102,116,85,32,7,97,65,695
250,Reggie Williams,SR,2007-08,F,Virginia Military Institute,Big South,25,878,269,509,.528,226,355,43,154,.279,114,170,.671,93,149,242,97,55,17,76,53,695
251,Marvin Bagley,FR,2017-18,F,Duke,ACC,33,1118,270,440,.614,247,382,23,58,.397,131,209,.627,132,234,366,50,27,29,75,60,694
252,Cameron Bairstow,SR,2013-14,F,New Mexico,MWC,34,1119,237,426,.556,236,423,1,3,.333,219,298,.735,76,175,251,53,19,51,68,72,694
253,Cane Broome,SO,2015-16,G,Sacred Heart,NEC,30,1126,236,530,.445,170,318,66,212,.311,156,203,.768,17,131,148,88,51,0,115,71,694
254,Elijah Brown,SO,2015-16,G,New Mexico,MWC,32,1077,194,453,.428,105,227,89,226,.394,217,255,.851,22,154,176,101,35,2,108,64,694
255,Markus Howard,SO,2017-18,G,Marquette,Big East,34,1071,239,515,.464,128,240,111,275,.404,105,112,.938,13,95,108,94,33,2,85,85,694
256,Nick King,SR,2017-18,F,Middle Tennessee,CUSA,33,1086,259,523,.495,217,415,42,108,.389,134,183,.732,78,200,278,65,23,7,94,50,694
257,Jason Thompson,SR,2007-08,C,Rider,MAAC,34,1177,275,491,.560,264,457,11,34,.324,133,229,.581,114,298,412,93,36,91,99,100,694
260,Jacob Wiley,SR,2016-17,F,Eastern Washington,Big Sky,34,1165,265,412,.643,260,405,5,7,.714,159,192,.828,95,214,309,80,26,94,128,102,694
261,Jerel McNeal,SR,2008-09,G,Marquette,Big East,35,1226,236,534,.442,150,318,86,216,.398,135,183,.738,28,131,159,137,71,21,103,87,693
262,Justin Robinson,JR,2015-16,G,Monmouth,MAAC,36,1184,214,488,.439,134,285,80,203,.394,185,219,.845,21,115,136,132,79,0,80,55,693
263,Kahlil Dukes,SR,2017-18,G,Niagara,MAAC,33,1120,224,482,.465,129,254,95,228,.417,149,164,.909,6,66,72,108,27,1,83,56,692
264,Austin McBroom,SR,2015-16,G,Eastern Washington,Big Sky,33,1235,212,488,.434,97,202,115,286,.402,153,184,.832,21,63,84,121,35,0,93,52,692
265,Jordan McRae,SR,2013-14,G,Tennessee,SEC,37,1190,223,512,.436,144,287,79,225,.351,167,212,.788,26,102,128,91,25,38,77,78,692
266,Thomas Robinson,JR,2011-12,F,Kansas,Big 12,39,1242,261,517,.505,254,503,7,14,.500,163,239,.682,113,350,463,72,42,34,104,107,692
267,Jon Elmore,JR,2016-17,G,Marshall,CUSA,35,1230,210,508,.413,127,272,83,236,.352,188,233,.807,21,131,152,207,40,7,109,63,691
268,Shan Foster,SR,2007-08,G,Vanderbilt,SEC,34,1147,242,463,.523,108,177,134,286,.469,73,96,.760,39,128,167,56,36,8,58,66,691
269,Eric Mika,SO,2016-17,F,Brigham Young,WCC,34,974,233,441,.528,233,440,0,1,.000,225,295,.763,104,208,312,56,19,63,84,92,691
270,Pascal Siakam,SO,2015-16,F,New Mexico State,WAC,34,1176,275,510,.539,272,495,3,15,.200,137,202,.678,132,263,395,58,34,75,67,92,690
271,Terrell Stoglin,SO,2011-12,G,Maryland,ACC,32,1045,220,533,.413,129,296,91,237,.384,159,202,.787,17,93,110,62,23,3,71,66,690
272,Al Thornton,SR,2006-07,G,Florida State,ACC,35,1092,244,460,.530,208,379,36,81,.444,166,210,.790,106,145,251,24,53,40,87,95,690
273,Sam Young,SR,2008-09,F,Pittsburgh,Big East,36,1146,261,520,.502,207,375,54,145,.372,114,154,.740,69,156,225,40,35,30,88,60,690
274,Jaylon Brown,SR,2016-17,G,Evansville,MVC,33,1215,220,475,.463,182,386,38,89,.427,211,246,.858,16,129,145,101,34,3,82,80,689
275,Marcus Marshall,SR,2016-17,G,Nevada,MWC,35,1240,205,487,.421,90,184,115,303,.380,164,198,.828,12,75,87,128,30,2,60,72,689
276,Gerardo Suero,JR,2011-12,G,Albany (NY),AEC,32,1015,220,479,.459,191,398,29,81,.358,220,265,.830,68,116,184,100,42,11,134,82,689
277,Jahmar Young,JR,2009-10,G,New Mexico State,WAC,34,1182,228,497,.459,155,302,73,195,.374,160,191,.838,15,105,120,107,27,7,92,88,689
278,George Hill,JR,2007-08,G,IUPUI,Summit,32,1179,220,404,.545,171,295,49,109,.450,199,245,.812,49,167,216,137,57,13,94,89,688
279,R.J. Hunter,JR,2014-15,G,Georgia State,Sun Belt,35,1294,203,514,.395,123,252,80,262,.305,202,230,.878,27,138,165,126,75,35,77,85,688
282,Anthony Ireland,JR,2012-13,G,Loyola Marymount,WCC,34,1274,228,552,.413,163,379,65,173,.376,167,203,.823,42,107,149,121,58,1,112,71,688
283,Talor Battle,SR,2010-11,G,Penn State,Big Ten,34,1294,225,532,.423,119,245,106,287,.369,131,175,.749,16,134,150,100,26,3,67,52,687
284,Devon Beitzel,SR,2010-11,G,Northern Colorado,Big Sky,32,1134,201,421,.477,114,200,87,221,.394,198,219,.904,11,94,105,56,44,1,77,56,687
285,Matt Morgan,SR,2018-19,G,Cornell,Ivy,31,1000,215,419,.513,112,180,103,239,.431,154,179,.860,7,134,141,93,43,9,104,63,687
286,Carsen Edwards,SO,2017-18,G,Purdue,Big Ten,37,1092,229,500,.458,132,261,97,239,.406,131,159,.824,13,129,142,104,42,8,64,65,686
287,Andrew Gonzalez,JR,2010-11,F,Houston Baptist,GWC,30,1111,204,491,.415,146,342,58,149,.389,220,270,.815,47,119,166,67,47,14,104,70,686
288,Caleb Green,JR,2005-06,F,Oral Roberts,Mid-Cont,33,1062,224,425,.527,221,415,3,10,.300,235,308,.763,123,167,290,53,34,11,96,94,686
289,Bubba Parham,SO,2018-19,G,Virginia Military Institute,Southern,32,1085,210,494,.425,94,202,116,292,.397,150,189,.794,10,99,109,112,20,1,82,60,686
290,A.J. English,JR,2014-15,G,Iona,MAAC,34,1272,212,491,.432,106,217,106,274,.387,155,197,.787,26,148,174,172,49,18,128,91,685
291,Marcus Evans,FR,2015-16,G,Rice,CUSA,32,1073,223,474,.470,171,304,52,170,.306,187,235,.796,28,100,128,91,70,6,100,92,685
292,Jack Gibbs,SR,2016-17,G,Davidson,A-10,31,1122,215,503,.427,121,263,94,240,.392,161,202,.797,22,103,125,127,41,0,82,77,685
293,Colt Ryan,SR,2012-13,G,Evansville,MVC,34,1121,219,517,.424,156,357,63,160,.394,184,206,.893,25,96,121,137,50,2,74,75,685
294,Jonathan Stark,SR,2017-18,G,Murray State,OVC,32,1165,221,490,.451,111,214,110,276,.399,133,149,.893,12,73,85,126,43,6,78,56,685
295,Stephen Madison,SR,2013-14,F,Idaho,WAC,34,1172,218,457,.477,179,337,39,120,.325,209,275,.760,70,190,260,81,34,17,93,101,684
296,O.J. Mayo,FR,2007-08,G,Southern California,Pac-10,33,1216,237,536,.442,149,321,88,215,.409,122,152,.803,35,115,150,109,51,13,117,80,684
297,J'Covan Brown,JR,2011-12,G,Texas,Big 12,34,1209,223,535,.417,143,318,80,217,.369,157,182,.863,30,85,115,130,41,4,92,66,683
298,Jimmy Hall,SR,2016-17,F,Kent State,MAC,36,1172,267,513,.520,264,493,3,20,.150,146,188,.777,148,235,383,91,32,48,104,105,683
299,Noah Dahlman,SR,2010-11,F,Wofford,Southern,34,1065,255,417,.612,255,416,0,1,.000,172,227,.758,94,98,192,41,26,12,41,75,682
300,Michael Glover,JR,2010-11,F,Iona,MAAC,37,1269,260,426,.610,260,423,0,3,.000,162,260,.623,138,236,374,34,28,34,85,102,682
301,Jerrick Harding,SO,2017-18,G,Weber State,Big Sky,31,1019,249,470,.530,192,336,57,134,.425,127,144,.882,19,87,106,53,33,5,74,57,682
304,Adnan Hodzic,JR,2009-10,C,Lipscomb,A-Sun,30,970,269,445,.604,269,445,0,0,,144,213,.676,103,169,272,23,14,12,80,66,682
305,Andrew Kostecka,JR,2018-19,G,Loyola (MD),Patriot,32,1064,241,461,.523,193,335,48,126,.381,152,187,.813,39,115,154,76,85,29,89,99,682
306,Kendrick Perry,SR,2013-14,G,Youngstown State,Horizon,32,1168,215,425,.506,153,251,62,174,.356,190,258,.736,29,103,132,140,76,10,60,85,682
307,Reid Travis,JR,2017-18,F,Stanford,Pac-12,35,1190,250,474,.527,232,413,18,61,.295,164,243,.675,104,202,306,47,26,4,72,91,682
308,Travis Bader,SR,2013-14,G,Oakland,Horizon,33,1242,185,479,.386,38,119,147,360,.408,164,174,.943,10,81,91,47,29,3,43,100,681
309,Chavis Holmes,SR,2008-09,G,Virginia Military Institute,Big South,31,1029,212,414,.512,129,226,83,188,.441,174,210,.829,55,89,144,96,105,33,70,81,681
310,Kevin Love,FR,2007-08,C,UCLA,Pac-10,39,1156,227,406,.559,198,324,29,82,.354,198,258,.767,142,273,415,75,27,56,78,73,681
311,Kevin Murphy,SR,2011-12,G,Tennessee Tech,OVC,33,1139,239,538,.444,160,348,79,190,.416,124,172,.721,30,143,173,76,28,7,108,71,681
312,Caleb Martin,JR,2017-18,F,Nevada,MWC,36,1199,223,491,.454,123,243,100,248,.403,134,179,.749,34,160,194,92,45,21,61,95,680
313,Larry Blair,JR,2005-06,G,Liberty,Big South,30,1101,234,579,.404,170,399,64,180,.356,147,184,.799,25,115,140,80,61,11,79,57,679
314,Yoeli Childs,JR,2018-19,F,Brigham Young,WCC,32,1066,258,509,.507,226,410,32,99,.323,131,185,.708,65,244,309,66,31,33,88,84,679
315,Alec Peters,JR,2015-16,F,Valparaiso,Horizon,37,1186,223,442,.505,132,235,91,207,.440,142,167,.850,93,219,312,49,26,11,63,77,679
316,Braylon Rayson,SR,2016-17,G,Central Michigan,MAC,32,1191,209,549,.381,116,291,93,258,.360,168,198,.848,25,115,140,101,39,1,86,69,679
317,Davon Usher,SR,2013-14,G,Delaware,CAA,35,1282,216,479,.451,131,245,85,234,.363,162,218,.743,51,161,212,62,62,14,71,91,679
318,Marquez Haynes,SR,2009-10,G,Texas-Arlington,Southland,30,999,215,445,.483,152,291,63,154,.409,185,248,.746,23,105,128,112,46,10,107,63,678
319,Brice Johnson,SR,2015-16,F,North Carolina,ACC,40,1121,267,435,.614,267,435,0,0,,144,184,.783,115,301,416,58,43,59,71,106,678
320,Anthony Lamb,JR,2018-19,F,Vermont,AEC,32,1011,242,470,.515,192,333,50,137,.365,144,189,.762,55,195,250,72,29,62,69,63,678
321,Luwane Pipkins,SO,2017-18,G,Massachusetts,A-10,32,1114,228,530,.430,121,279,107,251,.426,115,146,.788,15,99,114,128,48,0,108,68,678
322,Randy Foye,SR,2005-06,G,Villanova,Big East,33,1145,226,550,.411,137,296,89,254,.350,136,172,.791,54,136,190,100,46,21,71,71,677
323,Greg Gantt,SR,2012-13,G,Florida Atlantic,Sun Belt,32,1175,235,550,.427,151,333,84,217,.387,123,155,.794,22,111,133,44,25,3,78,48,677
324,Tyler Harvey,SO,2013-14,G,Eastern Washington,Big Sky,31,1158,206,465,.443,97,213,109,252,.433,156,174,.897,21,108,129,84,35,9,66,71,677
325,Jarrius Jackson,SR,2006-07,G,Texas Tech,Big 12,34,1293,224,517,.433,145,336,79,181,.436,150,190,.789,33,79,112,60,46,0,47,55,677
326,C.J. McCollum,SO,2010-11,G,Lehigh,Patriot,31,1073,214,537,.399,162,372,52,165,.315,197,233,.845,59,183,242,66,77,21,88,53,677
327,Isaiah Pineiro,SR,2018-19,F,San Diego,WCC,36,1249,232,476,.487,192,357,40,119,.336,173,211,.820,68,271,339,76,44,19,107,119,677
328,Shelden Williams,SR,2005-06,F,Duke,ACC,36,1198,237,410,.578,235,404,2,6,.333,201,270,.744,117,267,384,39,60,137,89,114,677
329,Trevon Bluiett,SR,2017-18,F,Xavier,Big East,35,1200,202,462,.437,97,210,105,252,.417,167,197,.848,29,164,193,87,26,9,70,76,676
330,Isaiah Canaan,SR,2012-13,G,Murray State,OVC,31,1131,215,499,.431,121,245,94,254,.370,152,185,.822,19,91,110,133,47,4,98,58,676
331,Kevin Hervey,SR,2017-18,F,Texas-Arlington,Sun Belt,33,1064,243,545,.446,166,318,77,227,.339,113,140,.807,77,205,282,73,41,20,90,60,676
332,Chris Horton,SR,2015-16,C,Austin Peay,OVC,36,1213,248,414,.599,248,414,0,0,,180,290,.621,177,254,431,54,49,63,98,76,676
333,Malcolm Brogdon,SR,2015-16,G,Virginia,ACC,37,1263,230,503,.457,155,311,75,192,.391,140,156,.897,19,131,150,115,35,9,52,76,675
334,Devonte' Graham,SR,2017-18,G,Kansas,Big 12,39,1474,199,498,.400,89,227,110,271,.406,167,202,.827,24,133,157,282,62,2,109,56,675
335,Chasson Randle,JR,2013-14,G,Stanford,Pac-12,36,1263,218,460,.474,150,285,68,175,.389,171,223,.767,20,109,129,77,37,2,88,93,675
336,D'Angelo Russell,FR,2014-15,G,Ohio State,Big Ten,35,1188,231,515,.449,136,284,95,231,.411,118,156,.756,35,163,198,175,55,11,102,74,675
337,Terry Taylor,SO,2018-19,G,Austin Peay,OVC,33,1092,258,486,.531,208,339,50,147,.340,109,147,.741,111,183,294,57,35,30,64,66,675
338,Randy Culpepper,SR,2010-11,G,Texas-El Paso,CUSA,35,1261,227,521,.436,161,317,66,204,.324,154,203,.759,22,80,102,107,71,10,82,85,674
339,Orlando Johnson,JR,2010-11,G,UC-Santa Barbara,Big West,32,1065,222,467,.475,156,304,66,163,.405,164,204,.804,49,149,198,94,39,16,87,67,674
340,David Laury,SR,2014-15,F,Iona,MAAC,34,1201,244,514,.475,217,443,27,71,.380,159,233,.682,85,244,329,96,27,45,101,92,674
341,Dominique Morrison,SR,2011-12,F,Oral Roberts,Summit,34,1240,215,441,.488,160,311,55,130,.423,189,229,.825,34,113,147,55,28,12,57,100,674
342,Jerrelle Benimon,SR,2013-14,F,Towson,CAA,36,1307,225,425,.529,211,381,14,44,.318,209,293,.713,84,320,404,130,25,44,124,104,673
343,Chase Fischer,SR,2015-16,G,Brigham Young,WCC,37,1257,209,509,.411,97,204,112,305,.367,143,173,.827,14,88,102,77,41,2,55,63,673
346,Josh Hart,SR,2016-17,G,Villanova,Big East,36,1193,236,463,.510,162,280,74,183,.404,127,170,.747,51,179,230,106,56,10,71,81,673
347,John Holland,JR,2009-10,F,Boston University,AEC,35,1205,215,468,.459,155,300,60,168,.357,183,215,.851,59,155,214,37,56,10,72,116,673
348,Daishon Smith,SR,2018-19,G,Louisiana-Monroe,Sun Belt,32,1108,195,440,.443,85,165,110,275,.400,173,201,.861,22,121,143,126,69,2,70,58,673
349,Russ Smith,SR,2013-14,G,Louisville,AAC,37,1084,225,481,.468,155,300,70,181,.387,153,217,.705,29,93,122,172,74,4,105,92,673
350,Charles Williams,SO,2017-18,G,Howard,MEAC,33,1173,253,567,.446,179,386,74,181,.409,93,119,.782,23,89,112,19,28,10,58,72,673
351,Keita Bates-Diop,JR,2017-18,F,Ohio State,Big Ten,34,1125,247,515,.480,181,331,66,184,.359,112,141,.794,52,244,296,56,31,56,62,57,672
352,Luke Harangody,SO,2007-08,F,Notre Dame,Big East,33,958,259,518,.500,256,509,3,9,.333,151,198,.763,116,235,351,55,26,29,76,85,672
353,Markis McDuffie,SR,2018-19,F,Wichita State,AAC,37,1235,214,525,.408,130,279,84,246,.341,160,196,.816,66,118,184,37,38,7,61,72,672
354,Dallas Moore,JR,2015-16,G,North Florida,A-Sun,34,1211,256,496,.516,192,334,64,162,.395,96,135,.711,20,115,135,205,31,5,64,28,672
355,Elfrid Payton,JR,2013-14,G,Louisiana,Sun Belt,35,1258,237,466,.509,223,412,14,54,.259,184,302,.609,81,129,210,208,80,21,127,83,672
356,Jordan Hamilton,SO,2010-11,G,Texas,Big 12,36,1159,243,552,.440,153,318,90,234,.385,95,122,.779,72,204,276,76,31,23,77,64,671
357,Aaron Holiday,JR,2017-18,G,UCLA,Pac-12,33,1244,212,460,.461,124,255,88,205,.429,159,192,.828,17,104,121,192,42,8,125,87,671
358,Amere May,SR,2014-15,G,Delaware State,MEAC,32,1095,227,543,.418,138,313,89,230,.387,128,156,.821,32,101,133,85,32,6,93,57,671
359,Arizona Reid,JR,2006-07,F,High Point,Big South,32,1061,285,560,.509,265,502,20,58,.345,81,123,.659,100,204,304,60,38,15,91,91,671
360,Dionte Christmas,JR,2007-08,G,Temple,A-10,34,1266,210,478,.439,106,196,104,282,.369,146,189,.772,43,159,202,86,46,7,96,90,670
361,T.J. Cromer,SR,2016-17,G,East Tennessee State,Southern,35,1110,224,491,.456,118,230,106,261,.406,116,141,.823,16,83,99,111,36,14,97,83,670
362,Nick Dixon,SR,2017-18,G,Texas-Rio Grande Valley,WAC,33,978,197,440,.448,143,287,54,153,.353,222,279,.796,52,94,146,78,47,6,82,63,670
363,Jabari Parker,FR,2013-14,F,Duke,ACC,35,1074,236,499,.473,198,393,38,106,.358,160,214,.748,105,201,306,41,37,43,81,83,670
364,Victor Sanders,JR,2016-17,G,Idaho,Big Sky,32,1052,206,453,.455,105,223,101,230,.439,157,201,.781,12,94,106,106,55,11,103,91,670
365,Jeremy Combs,SR,2018-19,F,Texas Southern,SWAC,38,1203,242,402,.602,237,381,5,21,.238,180,305,.590,142,210,352,56,59,23,92,121,669
368,Glen Davis,SO,2005-06,F,Louisiana State,SEC,36,1144,250,505,.495,244,482,6,23,.261,163,241,.676,145,205,350,50,47,41,96,89,669
369,Obi Emegano,JR,2015-16,G,Oral Roberts,Summit,29,1026,210,484,.434,159,350,51,134,.381,198,232,.853,28,121,149,53,33,10,51,69,669
370,Eric Gordon,FR,2007-08,G,Indiana,Big Ten,32,1110,184,425,.433,114,217,70,208,.337,231,277,.834,23,81,104,78,42,20,115,69,669
371,LaDontae Henton,SR,2014-15,F,Providence,Big East,34,1257,230,516,.446,166,327,64,189,.339,145,191,.759,60,162,222,29,46,16,68,76,669
372,Whit Holcomb-Faye,SR,2005-06,G,Radford,Big South,29,1108,202,511,.395,119,263,83,248,.335,182,225,.809,16,67,83,116,33,2,86,69,669
373,Justin Robinson,SR,2016-17,G,Monmouth,MAAC,34,1128,212,508,.417,116,270,96,238,.403,149,174,.856,20,109,129,162,49,3,89,54,669
374,Phil Booth,SR,2018-19,G,Villanova,Big East,36,1265,218,502,.434,123,243,95,259,.367,137,183,.749,13,127,140,137,30,7,84,70,668
375,Sam Young,JR,2007-08,F,Pittsburgh,Big East,37,1187,254,505,.503,210,390,44,115,.383,116,168,.690,83,149,232,45,41,42,87,73,668
376,Malcolm Delaney,JR,2009-10,G,Virginia Tech,ACC,33,1183,187,483,.387,124,277,63,206,.306,230,273,.842,30,92,122,147,41,3,99,96,667
377,Martaveous McKnight,SR,2018-19,G,Arkansas-Pine Bluff,SWAC,32,1177,226,511,.442,152,320,74,191,.387,141,199,.709,22,138,160,94,48,11,87,39,667
378,Sandy Cohen,SR,2018-19,F,Green Bay,Horizon,38,1297,219,461,.475,161,289,58,172,.337,170,220,.773,19,225,244,177,71,40,118,97,666
379,Michael Deloach,SR,2008-09,G,Norfolk State,MEAC,31,1154,244,536,.455,209,430,35,106,.330,143,200,.715,50,101,151,86,63,8,114,91,666
380,James Florence,JR,2008-09,G,Mercer,A-Sun,32,1091,229,547,.419,166,334,63,213,.296,145,208,.697,25,88,113,119,72,2,123,81,666
381,Stan Okoye,SR,2012-13,F,Virginia Military Institute,Big South,31,1010,236,523,.451,177,362,59,161,.366,135,202,.668,79,211,290,82,47,13,100,67,666
382,Alec Peters,SR,2016-17,F,Valparaiso,Horizon,29,1019,218,468,.466,160,308,58,160,.363,172,194,.887,74,219,293,64,23,11,71,64,666
383,Brandon Roy,SR,2005-06,G,Washington,Pac-10,33,1046,228,449,.508,189,352,39,97,.402,171,211,.810,69,117,186,135,46,26,75,81,666
384,Trevon Bluiett,JR,2016-17,F,Xavier,Big East,36,1263,212,484,.438,121,239,91,245,.371,150,199,.754,26,178,204,75,32,4,78,86,665
385,Marcus Evans,SO,2016-17,G,Rice,CUSA,35,1110,197,464,.425,111,235,86,229,.376,185,235,.787,14,101,115,131,40,5,128,92,665
386,Jairus Lyles,SR,2017-18,G,Maryland-Baltimore County,AEC,33,1152,225,512,.439,147,312,78,200,.390,137,173,.792,23,160,183,117,68,6,103,65,665
387,Semi Ojeleye,JR,2016-17,F,Southern Methodist,AAC,35,1195,210,431,.487,137,259,73,172,.424,172,219,.785,80,160,240,53,15,14,50,62,665
390,Donte Clark,SR,2017-18,G,Texas Southern,SWAC,36,1252,203,506,.401,161,357,42,149,.282,216,279,.774,39,148,187,93,39,12,102,113,664
391,QJ Peterson,FR,2013-14,G,Virginia Military Institute,Big South,35,1152,218,549,.397,140,305,78,244,.320,150,198,.758,63,133,196,72,59,12,76,81,664
392,Jonny Flynn,SO,2008-09,G,Syracuse,Big East,38,1418,219,476,.460,174,334,45,142,.317,180,229,.786,22,82,104,254,54,6,129,55,663
393,Jhivvan Jackson,SO,2018-19,G,Texas-San Antonio,CUSA,29,894,222,575,.386,118,279,104,296,.351,115,136,.846,13,105,118,71,35,2,68,80,663
394,James Kelly,SR,2015-16,F,Marshall,CUSA,33,1009,260,479,.543,211,320,49,159,.308,94,126,.746,61,263,324,38,44,36,77,94,663
395,Zach Lofton,SR,2017-18,G,New Mexico State,WAC,33,1054,217,476,.456,130,247,87,229,.380,142,184,.772,37,129,166,56,35,4,71,67,663
396,Roberto Nelson,SR,2013-14,G,Oregon State,Pac-12,32,1052,200,447,.447,143,304,57,143,.399,206,250,.824,35,73,108,115,31,1,98,70,663
397,Demetris Nichols,SR,2006-07,F,Syracuse,Big East,35,1217,225,503,.447,125,263,100,240,.417,113,133,.850,50,140,190,54,49,37,77,73,663
398,Saah Nimley,SR,2014-15,G,Charleston Southern,Big South,31,1106,183,477,.384,73,170,110,307,.358,187,228,.820,17,110,127,126,28,1,85,68,663
399,Sindarius Thornwell,SR,2016-17,G,South Carolina,SEC,31,1051,195,439,.444,137,291,58,148,.392,215,259,.830,77,144,221,86,66,30,76,71,663
400,Dionte Christmas,SR,2008-09,G,Temple,A-10,34,1191,218,527,.414,111,223,107,304,.352,119,158,.753,36,161,197,98,51,5,98,85,662
401,Erik Kangas,SR,2008-09,G,Oakland,Summit,35,1259,222,505,.440,87,181,135,324,.417,83,94,.883,23,80,103,61,38,6,67,50,662
402,Lamond Murray,SR,2016-17,G,Pepperdine,WCC,31,1060,251,528,.475,200,394,51,134,.381,109,140,.779,36,140,176,40,35,12,81,64,662
403,Warren Niles,SR,2012-13,G,Oral Roberts,Southland,35,1277,222,507,.438,126,264,96,243,.395,122,154,.792,24,121,145,55,41,6,69,69,662
404,Artsiom Parakhouski,SR,2009-10,C,Radford,Big South,31,1076,250,430,.581,247,418,3,12,.250,159,283,.562,160,254,414,33,19,65,75,69,662
405,Sherron Collins,JR,2008-09,G,Kansas,Big 12,35,1229,226,521,.434,149,316,77,205,.376,132,166,.795,19,82,101,174,39,0,115,67,661
406,Justin Harper,SR,2010-11,F,Richmond,A-10,37,1178,245,459,.534,168,287,77,172,.448,94,118,.797,62,194,256,43,23,46,56,82,661
407,Reggie Larry,SR,2007-08,F,Boise State,WAC,34,1169,244,455,.536,207,369,37,86,.430,136,213,.638,84,229,313,62,48,35,90,67,661
408,John Shurna,SR,2011-12,F,Northwestern,Big Ten,33,1232,228,492,.463,133,276,95,216,.440,110,146,.753,48,130,178,92,41,54,52,56,661
409,Rodney Glasgow,SR,2013-14,G,Virginia Military Institute,Big South,35,1291,232,483,.480,146,266,86,217,.396,110,126,.873,32,107,139,205,46,0,62,61,660
412,Jelani Hewitt,JR,2013-14,G,Georgia Southern,Southern,34,1152,211,520,.406,126,284,85,236,.360,153,184,.832,31,120,151,104,75,5,103,78,660
413,Maurice Kemp,SR,2012-13,F,East Carolina,CUSA,35,1202,231,457,.505,215,399,16,58,.276,182,241,.755,87,193,280,85,61,39,67,80,660
414,J.J. Mann,SR,2013-14,G,Belmont,OVC,36,1266,218,474,.460,129,246,89,228,.390,135,155,.871,15,157,172,92,77,3,61,51,660
415,Nolan Smith,JR,2009-10,G,Duke,ACC,38,1349,239,542,.441,179,389,60,153,.392,122,159,.767,35,71,106,114,47,9,70,67,660
416,Alex Young,SO,2009-10,G,IUPUI,Summit,36,1136,242,496,.488,170,314,72,182,.396,104,155,.671,49,114,163,43,54,22,79,103,660
417,Eugene German,SO,2017-18,G,Northern Illinois,MAC,32,991,243,516,.471,181,333,62,183,.339,111,145,.766,13,110,123,54,28,5,66,53,659
418,Marcelus Kemp,SR,2007-08,G,Nevada,WAC,33,1058,222,494,.449,152,310,70,184,.380,145,168,.863,43,136,179,109,23,10,81,63,659
419,Colbey Ross,SO,2018-19,G,Pepperdine,WCC,34,1187,179,410,.437,116,251,63,159,.396,238,279,.853,12,88,100,239,41,5,147,93,659
420,Marcus Thornton,SR,2014-15,G,William & Mary,CAA,33,1210,215,472,.456,113,218,102,254,.402,127,153,.830,9,83,92,95,21,4,77,36,659
421,Andrew Goudelock,JR,2009-10,G,College of Charleston,Southern,34,1210,250,554,.451,153,307,97,247,.393,61,74,.824,25,123,148,131,38,13,68,58,658
422,Jonathan Wade,SR,2016-17,G,Norfolk State,MEAC,34,1187,217,448,.484,156,289,61,159,.384,163,218,.748,53,178,231,63,22,3,110,73,658
423,Jarron Cumberland,JR,2018-19,G,Cincinnati,AAC,35,1136,207,512,.404,127,306,80,206,.388,163,211,.773,40,115,155,127,40,14,96,80,657
424,Tyler Hall,SR,2018-19,G,Montana State,Big Sky,32,1071,233,521,.447,117,213,116,308,.377,75,90,.833,21,130,151,89,35,9,68,61,657
425,Aaron Jackson,SR,2008-09,G,Duquesne,A-10,34,1249,229,413,.554,182,297,47,116,.405,152,188,.809,61,125,186,194,56,3,103,63,657
426,Jarrius Jackson,JR,2005-06,G,Texas Tech,Big 12,32,1228,216,496,.435,143,333,73,163,.448,152,187,.813,21,109,130,93,53,2,67,41,657
427,Kevin Jones,SR,2011-12,F,West Virginia,Big East,33,1265,260,511,.509,226,383,34,128,.266,103,132,.780,141,219,360,41,23,34,42,41,657
428,Brandon Knight,FR,2010-11,G,Kentucky,SEC,38,1363,217,513,.423,130,282,87,231,.377,136,171,.795,25,128,153,159,25,8,120,83,657
429,Jahlil Okafor,FR,2014-15,C,Duke,ACC,38,1143,279,420,.664,279,420,0,0,,99,194,.510,134,188,322,49,29,54,95,81,657
430,Maurice Ager,SR,2005-06,G,Michigan State,Big Ten,34,1170,226,495,.457,143,274,83,221,.376,121,159,.761,24,115,139,84,23,11,87,81,656
431,Peyton Aldridge,JR,2016-17,F,Davidson,A-10,32,1180,233,471,.495,163,300,70,171,.409,120,144,.833,54,209,263,70,28,28,53,65,656
432,Jordan Caroline,JR,2017-18,F,Nevada,MWC,37,1290,221,466,.474,185,355,36,111,.324,178,251,.709,98,221,319,82,26,6,71,87,656
433,Ricky Harris,SO,2007-08,G,Massachusetts,A-10,36,1174,209,488,.428,105,210,104,278,.374,134,178,.753,19,71,90,63,56,5,73,74,656
434,Donovan Morris,JR,2007-08,G,Cal State Long Beach,Big West,31,1164,202,438,.461,127,258,75,180,.417,177,209,.847,28,133,161,72,26,10,105,39,656
435,Kendrick Ray,SR,2016-17,G,Kennesaw State,A-Sun,31,1049,244,543,.449,158,325,86,218,.394,82,104,.788,30,84,114,97,22,10,81,75,656
436,Colt Ryan,JR,2011-12,G,Evansville,MVC,32,1161,199,450,.442,125,281,74,169,.438,184,218,.844,14,120,134,105,60,7,78,85,656
437,Devon Saddler,JR,2012-13,G,Delaware,CAA,33,1246,216,505,.428,160,339,56,166,.337,168,205,.820,28,121,149,91,32,6,107,68,656
438,Robert Gray,SR,2017-18,G,Houston,AAC,34,1084,218,488,.447,157,318,61,170,.359,158,197,.802,23,102,125,148,38,4,79,53,655
439,Zeke Upshaw,SR,2013-14,G,Hofstra,CAA,33,1206,197,489,.403,106,228,91,261,.349,170,225,.756,33,104,137,61,25,7,94,70,655
440,Jameel Warney,SR,2015-16,F,Stony Brook,AEC,33,1086,272,432,.630,272,432,0,0,,111,178,.624,148,209,357,52,31,98,44,71,655
441,C.J. Burks,SR,2018-19,G,Marshall,CUSA,37,1240,247,517,.478,181,332,66,185,.357,94,122,.770,22,122,144,109,66,6,111,85,654
442,Da'Sean Butler,SR,2009-10,F,West Virginia,Big East,38,1360,208,503,.414,138,305,70,198,.354,168,213,.789,61,176,237,119,37,15,68,82,654
443,Marcus Foster,SR,2017-18,G,Creighton,Big East,33,1044,246,509,.483,151,279,95,230,.413,67,90,.744,22,107,129,89,34,4,71,56,654
444,Alex Hamilton,SR,2015-16,G,Louisiana Tech,CUSA,33,1166,212,427,.496,178,313,34,114,.298,196,277,.708,34,155,189,205,65,16,104,54,654
445,Jeremy Hazell,JR,2009-10,G,Seton Hall,Big East,32,1014,220,520,.423,122,230,98,290,.338,116,153,.758,36,75,111,47,47,5,39,54,654
446,John Holland,SR,2010-11,F,Boston University,AEC,34,1153,203,526,.386,127,296,76,230,.330,172,200,.860,44,152,196,54,47,11,73,79,654
447,Caleb Martin,SR,2018-19,F,Nevada,MWC,34,1161,201,492,.409,94,175,107,317,.338,145,198,.732,30,145,175,96,49,26,63,83,654
448,Marcus Morris,JR,2010-11,F,Kansas,Big 12,38,1076,240,421,.570,214,345,26,76,.342,148,215,.688,99,191,290,62,32,24,67,97,654
449,Luke Harangody,SR,2009-10,F,Notre Dame,Big East,30,989,244,507,.481,219,426,25,81,.309,140,178,.787,67,206,273,47,14,20,54,70,653
450,Tim Kempton,SR,2016-17,C,Lehigh,Patriot,32,1012,231,422,.547,208,366,23,56,.411,168,221,.760,62,271,333,36,29,41,99,99,653
451,Wendell McKines,SR,2011-12,F,New Mexico State,WAC,35,1179,233,505,.461,182,360,51,145,.352,136,179,.760,118,256,374,54,27,13,70,80,653
454,Isaiah Miles,SR,2015-16,F,Saint Joseph's,A-10,36,1239,223,426,.523,158,257,65,169,.385,142,160,.888,84,208,292,31,21,36,41,102,653
455,Sean Singletary,SR,2007-08,G,Virginia,ACC,33,1122,203,476,.426,145,318,58,158,.367,189,222,.851,26,101,127,202,60,1,128,88,653
456,Greg Sprink,SR,2007-08,G,Navy,Patriot,30,1036,189,523,.361,113,269,76,254,.299,199,232,.858,44,146,190,86,39,5,103,105,653
457,Alex Young,SR,2011-12,G,IUPUI,Summit,32,1050,219,516,.424,160,342,59,174,.339,156,191,.817,59,130,189,69,50,32,78,80,653
458,Michael Deloach,SR,2009-10,G,Norfolk State,MEAC,30,1077,238,474,.502,202,359,36,115,.313,140,208,.673,27,106,133,100,79,3,123,92,652
459,Nick Fazekas,SR,2006-07,F,Nevada,WAC,32,969,248,437,.568,220,372,28,65,.431,128,151,.848,95,259,354,56,24,48,64,74,652
460,Terrell Gomez,SO,2018-19,G,Cal State Northridge,Big West,34,1282,214,476,.450,97,197,117,279,.419,107,122,.877,12,58,70,96,36,0,60,45,652
461,Troy Huff,SR,2013-14,G,North Dakota,Big Sky,34,993,210,467,.450,168,328,42,139,.302,190,250,.760,96,135,231,41,79,10,64,57,652
462,Garrison Mathews,SO,2016-17,G,Lipscomb,A-Sun,32,1002,202,441,.458,113,188,89,253,.352,159,219,.726,39,140,179,73,27,6,74,83,652
463,Donald Sims,SR,2010-11,G,Appalachian State,Southern,31,1174,198,447,.443,120,227,78,220,.355,178,206,.864,11,105,116,112,53,5,86,47,652
464,Ben Smith,SR,2009-10,G,Jacksonville,A-Sun,33,1237,187,458,.408,106,232,81,226,.358,197,253,.779,23,82,105,120,66,4,66,57,652
465,Reed Timmer,SR,2017-18,G,Drake,MVC,34,1134,188,422,.445,95,197,93,225,.413,183,212,.863,18,103,121,79,21,3,65,57,652
466,Shizz Alston,SR,2018-19,G,Temple,AAC,33,1214,207,511,.405,108,228,99,283,.350,138,152,.908,17,74,91,166,49,5,84,63,651
467,Ge'Lawn Guyn,SR,2015-16,G,East Tennessee State,Southern,35,1141,221,510,.433,127,287,94,223,.422,115,153,.752,21,120,141,65,39,27,68,74,651
468,Nathan Knight,JR,2018-19,F,William & Mary,CAA,31,949,236,408,.578,226,367,10,41,.244,169,231,.732,83,183,266,110,13,70,84,93,651
469,Elton Nesbitt,SR,2005-06,G,Georgia Southern,Southern,30,960,211,498,.424,108,234,103,264,.390,126,157,.803,22,83,105,89,60,3,69,82,651
470,Jerome Randle,SR,2009-10,G,University of California,Pac-10,35,1224,210,460,.457,118,232,92,228,.404,139,149,.933,14,59,73,150,26,0,123,52,651
471,Loren Stokes,SR,2006-07,G,Hofstra,CAA,32,1250,230,484,.475,203,406,27,78,.346,164,242,.678,38,142,180,98,37,10,85,65,651
472,Jermaine Marrow,SO,2017-18,G,Hampton,MEAC,34,1175,228,573,.398,187,434,41,139,.295,153,192,.797,31,139,170,184,43,1,117,88,650
473,Martaveous McKnight,JR,2017-18,G,Arkansas-Pine Bluff,SWAC,35,1134,217,480,.452,153,298,64,182,.352,152,210,.724,16,134,150,124,68,5,92,31,650
476,Shamorie Ponds,JR,2018-19,G,St. John's (NY),Big East,33,1159,216,477,.453,151,293,65,184,.353,153,183,.836,32,104,136,169,87,9,65,66,650
477,Demetric Bennett,SR,2007-08,G,South Alabama,Sun Belt,33,1147,213,443,.481,123,221,90,222,.405,133,159,.836,44,148,192,84,42,2,81,41,649
478,Kyle Vinales,SO,2012-13,G,Central Connecticut State,NEC,30,1147,229,557,.411,149,338,80,219,.365,111,138,.804,8,53,61,113,42,4,100,60,649
479,Chris Warren,SR,2010-11,G,Mississippi,SEC,34,1185,193,479,.403,98,200,95,279,.341,168,181,.928,7,69,76,128,23,3,72,61,649
480,Alex Young,JR,2010-11,G,IUPUI,Summit,33,1208,244,513,.476,204,393,40,120,.333,121,165,.733,69,142,211,78,45,26,113,88,649
481,Harrison Barnes,SO,2011-12,F,North Carolina,ACC,38,1111,229,521,.440,180,384,49,137,.358,141,195,.723,74,124,198,43,41,13,74,68,648
482,T.J. Cline,SR,2016-17,F,Richmond,A-10,35,1137,243,470,.517,195,318,48,152,.316,114,166,.687,30,242,272,197,33,8,103,88,648
483,Randy Culpepper,SO,2008-09,G,Texas-El Paso,CUSA,37,1119,211,515,.410,122,258,89,257,.346,137,184,.745,30,79,109,67,67,11,84,104,648
484,K.T. Harrell,SR,2014-15,G,Auburn,SEC,35,1156,194,428,.453,96,202,98,226,.434,162,199,.814,32,72,104,52,33,2,86,80,648
485,Paul Millsap,JR,2005-06,F,Louisiana Tech,WAC,33,1126,258,452,.571,253,438,5,14,.357,127,204,.623,197,241,438,36,62,76,83,101,648
486,Andrew Rowsey,FR,2013-14,G,North Carolina-Asheville,Big South,32,1156,202,471,.429,96,209,106,262,.405,138,165,.836,14,104,118,94,42,3,102,63,648
487,Jeff Short,JR,2014-15,G,Norfolk State,MEAC,34,1153,212,426,.498,143,251,69,175,.394,155,189,.820,24,118,142,66,32,14,96,63,648
488,Ike Smith,SO,2016-17,G,Georgia Southern,Sun Belt,33,1005,230,462,.498,169,308,61,154,.396,127,195,.651,35,137,172,56,47,21,72,74,648
489,A.D. Vassallo,SR,2008-09,G,Virginia Tech,ACC,34,1247,232,516,.450,149,290,83,226,.367,101,121,.835,47,164,211,88,28,29,85,74,648
490,DaShaun Wood,SR,2006-07,G,Wright State,Horizon,33,1195,223,513,.435,164,355,59,158,.373,143,162,.883,35,132,167,131,64,6,84,59,648
491,Michael Young,SR,2016-17,F,Pittsburgh,ACC,33,1097,217,479,.453,175,356,42,123,.341,172,221,.778,53,170,223,90,19,25,70,59,648
492,Josh Akognon,JR,2007-08,G,Cal State Fullerton,Big West,32,1013,212,472,.449,96,177,116,295,.393,107,119,.899,18,89,107,48,44,4,55,71,647
493,Mario Boggan,SR,2006-07,F,Oklahoma State,Big 12,34,1109,242,448,.540,229,389,13,59,.220,150,197,.761,88,169,257,47,36,27,86,100,647
494,Jahii Carson,FR,2012-13,G,Arizona State,Pac-12,35,1303,231,488,.473,198,385,33,103,.320,152,207,.734,16,112,128,177,41,2,124,89,647
495,Jordan Downing,JR,2013-14,G,Presbyterian,Big South,32,1191,235,541,.434,155,323,80,218,.367,97,119,.815,21,123,144,60,32,12,72,67,647
498,Wayne Ellington,SO,2007-08,G,North Carolina,ACC,39,1214,237,507,.467,159,312,78,195,.400,95,115,.826,41,133,174,78,44,7,66,62,647
499,Michael Gbinije,SR,2015-16,F,Syracuse,ACC,37,1403,225,488,.461,134,255,91,233,.391,106,160,.663,40,111,151,159,70,13,105,98,647
500,Shamorie Ponds,SO,2017-18,G,St. John's (NY),Big East,30,1110,225,536,.420,178,350,47,186,.253,150,175,.857,36,115,151,142,70,3,82,53,647
501,Jared Sullinger,SO,2011-12,F,Ohio State,Big Ten,37,1123,228,439,.519,212,399,16,40,.400,175,228,.768,116,224,340,46,43,39,71,109,647
502,Tyshawn Taylor,SR,2011-12,G,Kansas,Big 12,39,1303,226,474,.477,168,322,58,152,.382,137,199,.688,8,83,91,186,52,6,138,77,647
503,Greivis Vasquez,SR,2009-10,G,Maryland,ACC,33,1120,220,513,.429,151,321,69,192,.359,138,161,.857,38,115,153,208,56,12,111,69,647
504,Nick Young,JR,2006-07,F,Southern California,Pac-10,37,1227,239,455,.525,195,355,44,100,.440,125,159,.786,44,127,171,50,27,10,90,92,647
505,Antoine Agudio,JR,2006-07,G,Hofstra,CAA,32,1256,219,476,.460,119,245,100,231,.433,108,156,.692,34,95,129,78,36,4,73,58,646
506,David Holston,JR,2007-08,G,Chicago State,Ind,28,932,202,470,.430,72,148,130,322,.404,112,132,.848,25,61,86,142,58,2,109,61,646
507,Caleb Swanigan,SO,2016-17,F,Purdue,Big Ten,35,1139,222,421,.527,184,336,38,85,.447,164,210,.781,96,340,436,107,15,28,118,97,646
508,Jermaine Taylor,JR,2007-08,G,Central Florida,CUSA,31,1037,231,501,.461,152,286,79,215,.367,105,132,.795,53,94,147,52,35,9,78,66,646
509,Ed Tyson,JR,2007-08,G,Maryland-Eastern Shore,MEAC,32,1176,219,585,.374,146,359,73,226,.323,135,177,.763,57,49,106,46,54,1,102,92,646
510,Keaton Wallace,SO,2018-19,G,Texas-San Antonio,CUSA,32,1117,215,509,.422,94,192,121,317,.382,95,111,.856,25,136,161,76,42,22,69,72,646
511,Craig Brackins,SO,2008-09,F,Iowa State,Big 12,32,1041,243,512,.475,222,438,21,74,.284,138,198,.697,55,248,303,43,17,30,74,67,645
512,Jared Cunningham,JR,2011-12,G,Oregon State,Pac-12,36,1245,198,440,.450,148,292,50,148,.338,199,270,.737,36,102,138,101,91,15,102,86,645
513,Chris Lofton,JR,2006-07,G,Tennessee,SEC,31,917,205,428,.479,99,175,106,253,.419,129,159,.811,34,61,95,54,45,4,51,49,645
514,Andrew Nicholson,JR,2010-11,F,St. Bonaventure,A-10,31,1049,237,415,.571,231,392,6,23,.261,165,232,.711,52,173,225,32,17,45,99,92,645
515,Jerome Hill,JR,2014-15,F,Gardner-Webb,Big South,34,1126,211,446,.473,205,408,6,38,.158,216,344,.628,118,227,345,75,18,23,101,76,644
516,Gerald Brown,JR,2006-07,G,Loyola (MD),MAAC,29,1018,205,465,.441,147,296,58,169,.343,175,234,.748,37,107,144,78,54,13,119,100,643
517,Deonte Burton,SR,2013-14,G,Nevada,MWC,32,1236,215,456,.471,166,300,49,156,.314,164,221,.742,12,125,137,142,48,17,65,71,643
520,Cameron Jones,SR,2010-11,G,Northern Arizona,Big Sky,32,1077,250,547,.457,213,456,37,91,.407,106,133,.797,31,116,147,101,28,3,72,63,643
521,Carl Landry,JR,2006-07,F,Purdue,Big Ten,34,1035,219,367,.597,215,348,4,19,.211,201,277,.726,101,148,249,42,40,32,102,99,643
522,Joe Young,JR,2013-14,G,Oregon,Pac-12,34,1059,206,429,.480,130,246,76,183,.415,155,176,.881,26,70,96,66,44,1,39,47,643
523,Jerrick Harding,JR,2018-19,G,Weber State,Big Sky,30,1016,212,450,.471,148,275,64,175,.366,154,177,.870,15,86,101,42,50,11,62,67,642
524,Quinton Hooker,JR,2015-16,G,North Dakota,Big Sky,32,1136,211,433,.487,160,300,51,133,.383,169,197,.858,37,119,156,112,60,8,58,72,642
525,John Konchar,SR,2018-19,G,Purdue-Fort Wayne,Summit,33,1131,231,423,.546,178,284,53,139,.381,127,178,.713,73,209,282,179,65,31,91,69,642
526,Shawn Long,SR,2015-16,F,Louisiana,Sun Belt,34,1042,232,443,.524,214,376,18,67,.269,160,235,.681,137,274,411,47,24,61,91,95,642
527,Damon Lynn,JR,2015-16,G,NJIT,A-Sun,35,1323,196,524,.374,80,174,116,350,.331,134,161,.832,11,95,106,114,56,2,71,44,642
528,T.J. Williams,SR,2016-17,G,Northeastern,CAA,30,1145,202,436,.463,166,328,36,108,.333,202,265,.762,23,118,141,158,31,4,101,67,642
529,Perry Ellis,SR,2015-16,F,Kansas,Big 12,38,1150,237,446,.531,209,382,28,64,.438,139,177,.785,67,155,222,49,18,19,56,64,641
530,Wesley Matthews,SR,2008-09,G,Marquette,Big East,35,1191,193,406,.475,151,292,42,114,.368,213,257,.829,46,155,201,86,43,18,82,76,641
531,Jalan West,JR,2014-15,G,Northwestern State,Southland,32,1104,193,423,.456,107,219,86,204,.422,169,196,.862,18,122,140,246,66,11,90,63,641
532,Jarrell Brantley,SR,2018-19,F,College of Charleston,CAA,33,1121,237,458,.517,199,342,38,116,.328,128,163,.785,57,220,277,80,46,29,85,89,640
533,Jared Brownridge,JR,2015-16,G,Santa Clara,WCC,31,1110,195,491,.397,104,255,91,236,.386,159,191,.832,11,87,98,72,22,6,58,67,640
534,Jevon Carter,SR,2017-18,G,West Virginia,Big 12,37,1313,215,509,.422,138,313,77,196,.393,133,155,.858,29,143,172,246,112,13,98,111,640
535,Tyler Cavanaugh,SR,2016-17,F,George Washington,A-10,35,1126,200,446,.448,133,282,67,164,.409,173,204,.848,87,207,294,71,19,14,93,98,640
536,J.J. Frazier,SR,2016-17,G,Georgia,SEC,34,1178,199,490,.406,144,309,55,181,.304,187,211,.886,12,117,129,140,63,4,80,81,640
537,Justin Hurtt,SR,2010-11,G,Tulsa,CUSA,32,1079,206,494,.417,120,260,86,234,.368,142,175,.811,16,105,121,76,16,7,88,53,640
538,Nigel Williams-Goss,JR,2016-17,G,Gonzaga,WCC,38,1248,220,453,.486,177,336,43,117,.368,157,181,.867,22,205,227,179,64,3,81,60,640
539,Bonzie Colson,JR,2016-17,F,Notre Dame,ACC,36,1156,236,449,.526,210,389,26,60,.433,141,180,.783,104,258,362,56,40,50,44,81,639
540,Papa Dia,SR,2010-11,F,Southern Methodist,CUSA,35,1177,243,421,.577,230,391,13,30,.433,140,186,.753,104,231,335,63,23,77,125,109,639
541,Darryl Proctor,SR,2008-09,F,Maryland-Baltimore County,AEC,32,1269,254,544,.467,252,530,2,14,.143,129,182,.709,83,197,280,63,44,21,70,82,639
542,Clifford Reed,JR,2010-11,G,Bethune-Cookman,MEAC,34,1315,203,522,.389,149,357,54,165,.327,179,219,.817,27,103,130,163,55,1,102,87,639
543,D.J. Rivera,JR,2008-09,F,Binghamton,AEC,32,1134,230,486,.473,183,337,47,149,.315,132,208,.635,65,143,208,34,57,13,56,86,639
544,James Anderson,SO,2008-09,G,Oklahoma State,Big 12,35,1171,209,434,.482,125,228,84,206,.408,136,164,.829,76,122,198,48,40,24,69,85,638
545,Tyler Cavanaugh,JR,2015-16,F,George Washington,A-10,38,1157,209,414,.505,156,287,53,127,.417,167,202,.827,76,213,289,46,21,10,79,95,638
546,David Efianayi,SR,2018-19,G,Gardner-Webb,Big South,35,1169,201,413,.487,130,244,71,169,.420,165,222,.743,18,110,128,100,39,26,84,74,638
547,Marcus Foster,JR,2016-17,G,Creighton,Big East,35,1081,245,532,.461,172,318,73,214,.341,75,107,.701,9,92,101,84,21,2,78,69,638
548,Robert Gray,JR,2016-17,G,Houston,AAC,31,1002,233,493,.473,170,328,63,165,.382,109,134,.813,33,83,116,91,37,5,70,57,638
549,Max Landis,SR,2015-16,G,Purdue-Fort Wayne,Summit,33,1228,196,433,.453,71,159,125,274,.456,121,149,.812,5,65,70,121,30,1,72,44,638
550,Kyle Wiltjer,JR,2014-15,F,Gonzaga,WCC,38,1049,242,448,.540,174,302,68,146,.466,86,109,.789,51,184,235,71,18,25,43,62,638
551,Bryce Brown,SR,2018-19,G,Auburn,SEC,40,1281,204,467,.437,63,123,141,344,.410,88,109,.807,18,65,83,77,44,2,66,56,637
552,Glenn Cosey,SR,2013-14,G,Eastern Kentucky,OVC,34,1234,187,435,.430,72,165,115,270,.426,148,176,.841,20,89,109,142,42,2,63,59,637
553,Brandon Davies,SR,2012-13,F,Brigham Young,WCC,36,1054,229,439,.522,224,425,5,14,.357,174,255,.682,74,213,287,88,48,35,92,111,637
554,Malcolm Delaney,SR,2010-11,G,Virginia Tech,ACC,34,1300,186,443,.420,102,237,84,206,.408,181,213,.850,27,92,119,137,56,6,103,89,637
555,Jakeenan Gant,SR,2018-19,F,Louisiana,Sun Belt,31,1003,246,453,.543,204,341,42,112,.375,103,131,.786,98,171,269,39,25,82,64,85,637
556,Adam Haluska,SR,2006-07,G,Iowa,Big Ten,31,1070,190,466,.408,100,218,90,248,.363,167,192,.870,27,117,144,80,42,8,53,54,637
557,Brandon Heath,SR,2006-07,G,San Diego State,MWC,33,1218,225,534,.421,138,287,87,247,.352,100,134,.746,29,98,127,120,64,2,104,54,637
558,Egor Koulechov,JR,2016-17,G,Rice,CUSA,35,1201,208,440,.473,127,269,81,171,.474,140,171,.819,65,247,312,75,29,11,71,70,637
559,Matt Mooney,JR,2017-18,G,South Dakota,Summit,34,1040,227,510,.445,151,294,76,216,.352,107,129,.829,22,116,138,105,67,4,82,67,637
562,Mike Moore,SR,2011-12,G,Hofstra,CAA,32,1108,200,477,.419,119,270,81,207,.391,156,191,.817,23,123,146,66,55,2,94,71,637
563,Mike Muscala,SR,2012-13,F,Bucknell,Patriot,34,1079,227,446,.509,223,430,4,16,.250,179,227,.789,98,280,378,78,17,80,58,74,637
564,Kevin Pittsnogle,SR,2005-06,C,West Virginia,Big East,33,1187,231,485,.476,140,258,91,227,.401,84,98,.857,53,128,181,40,31,39,46,57,637
565,Marial Shayok,SR,2018-19,G,Iowa State,Big 12,34,1118,229,462,.496,158,278,71,184,.386,108,123,.878,47,120,167,67,32,8,91,70,637
566,Lamar Stevens,JR,2018-19,F,Penn State,Big Ten,32,1180,230,545,.422,210,454,20,91,.220,157,204,.770,53,192,245,66,22,26,89,83,637
567,J.P. Batista,SR,2005-06,C,Gonzaga,WCC,33,1077,234,397,.589,231,389,3,8,.375,165,198,.833,98,212,310,46,30,28,80,82,636
568,Elijah Bryant,JR,2017-18,G,Brigham Young,WCC,35,1215,202,409,.494,117,204,85,205,.415,147,173,.850,16,206,222,81,44,19,80,83,636
569,Rodney Carney,SR,2005-06,F,Memphis,CUSA,37,1027,220,505,.436,118,244,102,261,.391,94,132,.712,57,101,158,47,49,25,54,84,636
570,Patrick Cole,SR,2016-17,G,North Carolina Central,MEAC,33,1166,203,529,.384,137,335,66,194,.340,164,217,.756,39,191,230,184,31,8,124,79,636
571,Peter Jok,SR,2016-17,G,Iowa,Big Ten,32,983,199,467,.426,115,246,84,221,.380,154,169,.911,30,146,176,84,34,3,81,70,636
572,Dior Lowhorn,SO,2007-08,F,San Francisco,WCC,31,1135,252,491,.513,243,456,9,35,.257,123,174,.707,89,140,229,22,14,28,93,51,636
573,C.J. Massinburg,SR,2018-19,G,Buffalo,MAC,35,1123,199,429,.464,106,196,93,233,.399,145,186,.780,76,152,228,104,42,10,47,61,636
574,Yante Maten,SR,2017-18,F,Georgia,SEC,33,1131,207,446,.464,178,361,29,85,.341,193,241,.801,116,167,283,51,15,49,67,72,636
575,Talor Battle,SO,2008-09,G,Penn State,Big Ten,38,1422,198,493,.402,106,222,92,271,.339,147,210,.700,36,167,203,189,45,3,92,79,635
576,Dillon Brooks,SO,2015-16,F,Oregon,Pac-12,38,1247,231,492,.470,183,350,48,142,.338,125,155,.806,77,129,206,119,40,15,89,112,635
577,Frank Gaines,JR,2011-12,G,Purdue-Fort Wayne,Summit,30,962,207,465,.445,158,323,49,142,.345,172,230,.748,39,137,176,36,41,18,77,90,635
578,Curtis Jerrells,SR,2008-09,G,Baylor,Big 12,39,1351,197,461,.427,121,254,76,207,.367,165,214,.771,32,145,177,192,60,12,119,76,635
579,Christian Keeling,JR,2018-19,G,Charleston Southern,Big South,34,1096,214,460,.465,133,247,81,213,.380,126,162,.778,29,206,235,94,43,23,91,68,635
580,Zane Martin,SO,2017-18,G,Towson,CAA,32,966,226,493,.458,155,306,71,187,.380,112,161,.696,18,95,113,85,25,6,76,66,635
581,Drew McDonald,SR,2018-19,F,Northern Kentucky,Horizon,34,1040,211,447,.472,144,277,67,170,.394,146,183,.798,68,251,319,95,17,12,77,65,635
584,Drew Neitzel,JR,2006-07,G,Michigan State,Big Ten,35,1249,199,467,.426,85,190,114,277,.412,123,140,.879,3,96,99,151,29,9,82,42,635
585,Jared Sullinger,FR,2010-11,F,Ohio State,Big Ten,37,1172,222,410,.541,219,398,3,12,.250,188,267,.704,131,246,377,43,37,20,59,90,635
586,Francis Alonso,SR,2018-19,G,North Carolina-Greensboro,Southern,36,1033,195,465,.419,97,201,98,264,.371,146,166,.880,18,66,84,89,37,6,92,78,634
587,Gary Blackston,JR,2017-18,G,Prairie View,SWAC,33,1064,217,494,.439,173,371,44,123,.358,156,217,.719,48,128,176,116,51,3,100,110,634
588,Leemire Goldwire,SR,2007-08,G,Charlotte,A-10,34,1130,194,520,.373,66,149,128,371,.345,118,146,.808,37,111,148,58,70,3,83,91,634
589,Rob McKiver,JR,2006-07,G,Houston,CUSA,33,1236,201,532,.378,85,189,116,343,.338,116,160,.725,9,97,106,112,44,1,99,69,634
590,Matt Mooney,SO,2016-17,G,South Dakota,Summit,34,1059,222,483,.460,146,276,76,207,.367,114,159,.717,14,138,152,71,75,5,86,65,634
591,Nick Barbour,SR,2011-12,G,High Point,Big South,31,1014,185,415,.446,77,192,108,223,.484,155,187,.829,16,62,78,42,34,11,53,65,633
592,Anatoly Bose,JR,2009-10,G,Nicholls State,Southland,30,1062,194,442,.439,108,218,86,224,.384,159,214,.743,43,136,179,61,34,8,83,62,633
593,John Cantrell,SR,2008-09,G,Chicago State,Ind,32,1120,245,483,.507,214,396,31,87,.356,112,158,.709,65,97,162,69,72,10,62,63,633
594,Keenan Evans,SR,2017-18,G,Texas Tech,Big 12,36,1063,194,412,.471,146,262,48,150,.320,197,241,.817,12,98,110,116,41,11,70,65,633
595,Stephen McDowell,SR,2008-09,G,Chattanooga,Southern,35,1177,202,464,.435,67,146,135,318,.425,94,118,.797,33,84,117,54,32,0,61,57,633
596,Domantas Sabonis,SO,2015-16,F,Gonzaga,WCC,36,1149,239,391,.611,234,377,5,14,.357,150,195,.769,110,316,426,64,22,31,92,115,633
597,Craig Smith,SR,2005-06,F,Boston College,ACC,36,1305,243,424,.573,242,412,1,12,.083,146,227,.643,112,227,339,109,44,29,89,107,633
598,Xavier Thames,SR,2013-14,G,San Diego State,MWC,36,1126,188,457,.411,127,294,61,163,.374,196,235,.834,21,83,104,116,59,5,51,71,633
599,John Collins,SO,2016-17,F,Wake Forest,ACC,33,878,234,376,.622,234,375,0,1,.000,164,220,.745,124,200,324,17,21,52,60,98,632
600,A.J. English,SR,2015-16,G,Iona,MAAC,28,1005,190,439,.433,96,185,94,254,.370,158,189,.836,15,126,141,174,44,14,101,60,632
601,Tyreke Evans,FR,2008-09,G,Memphis,CUSA,37,1072,230,505,.455,196,381,34,124,.274,138,194,.711,47,151,198,143,77,29,133,89,632
602,Frank Gaines,SR,2012-13,G,Purdue-Fort Wayne,Summit,32,1089,198,457,.433,143,297,55,160,.344,181,245,.739,34,95,129,38,44,16,79,82,632
603,Brandon Goodwin,SR,2017-18,G,Florida Gulf Coast,A-Sun,34,1135,223,474,.470,181,321,42,153,.275,144,192,.750,38,150,188,162,46,4,100,53,632
606,Chris Harris,SR,2009-10,G,Navy,Patriot,30,1047,183,512,.357,95,255,88,257,.342,178,204,.873,8,67,75,56,60,3,88,85,632
607,Collin Sexton,FR,2017-18,G,Alabama,SEC,33,987,196,438,.447,152,307,44,131,.336,196,252,.778,34,90,124,119,28,3,92,81,632
608,Ben Simmons,FR,2015-16,F,Louisiana State,SEC,33,1151,216,386,.560,215,383,1,3,.333,199,297,.670,103,285,388,158,65,27,111,92,632
609,Evan Turner,JR,2009-10,G,Ohio State,Big Ten,31,1108,237,457,.519,217,402,20,55,.364,138,183,.754,62,222,284,185,54,28,136,86,632
610,Sherrod Wright,JR,2012-13,G,George Mason,CAA,38,1228,202,434,.465,155,300,47,134,.351,181,233,.777,66,120,186,56,38,10,99,73,632
611,Will Barton,SO,2011-12,G,Memphis,CUSA,35,1236,230,452,.509,193,345,37,107,.346,134,179,.749,70,209,279,102,50,25,75,74,631
612,Larry Blair,SR,2006-07,G,Liberty,Big South,31,1023,237,538,.441,185,366,52,172,.302,105,124,.847,26,104,130,102,58,6,84,69,631
613,David Brown,SR,2013-14,G,Western Michigan,MAC,33,1123,176,428,.411,96,181,80,247,.324,199,258,.771,19,98,117,61,47,5,92,93,631
614,Eugene German,JR,2018-19,G,Northern Illinois,MAC,31,1012,228,465,.490,141,255,87,210,.414,88,128,.688,17,143,160,89,38,5,74,61,631
615,Tu Holloway,JR,2010-11,G,Xavier,A-10,32,1228,168,396,.424,108,222,60,174,.345,235,270,.870,18,141,159,174,46,2,110,61,631
616,Shawn Long,SO,2013-14,F,Louisiana,Sun Belt,34,999,239,458,.522,206,380,33,78,.423,120,178,.674,121,232,353,19,23,91,73,119,631
617,C.J. McCollum,FR,2009-10,G,Lehigh,Patriot,33,1052,203,442,.459,131,271,72,171,.421,153,189,.810,46,119,165,79,43,7,66,48,631
618,Kevin Palmer,SR,2009-10,G,Texas A&M-Corpus Christi,Southland,32,1053,203,438,.463,152,279,51,159,.321,174,229,.760,55,119,174,88,77,9,139,69,631
619,Chase Budinger,JR,2008-09,F,Arizona,Pac-10,35,1317,219,456,.480,152,288,67,168,.399,125,156,.801,49,168,217,118,50,16,85,65,630
620,Bryce Cotton,JR,2012-13,G,Providence,Big East,32,1209,195,446,.437,97,177,98,269,.364,142,178,.798,23,92,115,92,30,3,47,38,630
621,Jon Davis,SR,2018-19,G,Charlotte,CUSA,29,1076,191,441,.433,118,225,73,216,.338,175,205,.854,11,119,130,107,24,12,121,43,630
622,Matt Morgan,JR,2017-18,G,Cornell,Ivy,28,969,204,415,.492,129,212,75,203,.369,147,180,.817,11,118,129,90,23,9,69,48,630
623,Nik Stauskas,SO,2013-14,G,Michigan,Big Ten,36,1281,185,394,.470,93,186,92,208,.442,168,204,.824,15,90,105,118,20,11,67,47,630
624,DeMarre Carroll,SR,2008-09,F,Missouri,Big 12,38,1064,246,441,.558,230,397,16,44,.364,121,191,.634,92,181,273,82,59,25,56,84,629
625,Brandon Goodwin,JR,2016-17,G,Florida Gulf Coast,A-Sun,34,1073,219,428,.512,164,272,55,156,.353,136,172,.791,28,126,154,139,41,2,72,73,629
628,Demontrae Jefferson,SO,2017-18,G,Texas Southern,SWAC,27,1016,207,493,.420,122,277,85,216,.394,130,158,.823,18,66,84,123,36,0,85,68,629
629,David Jenkins Jr.,SO,2018-19,G,South Dakota State,Summit,32,1059,205,448,.458,93,201,112,247,.453,107,135,.793,14,94,108,49,15,0,84,88,629
630,Charles Jenkins,SO,2008-09,G,Hofstra,CAA,32,1122,203,503,.404,172,404,31,99,.313,192,234,.821,28,125,153,137,46,15,107,84,629
631,Marcelus Kemp,JR,2006-07,G,Nevada,WAC,34,1058,221,478,.462,137,271,84,207,.406,103,128,.805,36,121,157,82,24,7,98,74,629
632,Roddy Peters,SR,2017-18,G,Nicholls State,Southland,32,858,229,445,.515,218,407,11,38,.289,160,210,.762,28,160,188,135,44,6,121,79,629
633,Bobby Portis,SO,2014-15,F,Arkansas,SEC,36,1076,250,466,.536,236,436,14,30,.467,115,156,.737,133,188,321,42,39,50,56,78,629
634,Tyrese Rice,JR,2007-08,G,Boston College,ACC,30,1144,200,462,.433,136,283,64,179,.358,165,195,.846,12,86,98,149,48,6,103,67,629
635,Jordan Washington,SR,2016-17,F,Iona,MAAC,35,760,233,422,.552,232,418,1,4,.250,162,236,.686,83,182,265,22,32,14,78,122,629
636,Quinndary Weatherspoon,SR,2018-19,G,Mississippi State,SEC,34,1157,213,419,.508,158,280,55,139,.396,148,183,.809,45,114,159,96,57,10,99,72,629
637,Jaylen Barford,SR,2017-18,G,Arkansas,SEC,35,1094,224,477,.470,137,276,87,201,.433,93,129,.721,35,102,137,89,35,10,67,88,628
638,Keith Benson,SR,2010-11,C,Oakland,Summit,35,1133,231,422,.547,222,399,9,23,.391,157,244,.643,93,261,354,38,28,125,66,108,628
639,Corey Davis,SR,2018-19,G,Houston,AAC,37,1222,202,481,.420,91,185,111,296,.375,113,130,.869,26,97,123,103,38,3,54,65,628
640,Jerian Grant,SR,2014-15,G,Notre Dame,ACC,38,1408,204,427,.478,154,269,50,158,.316,170,218,.780,13,102,115,253,63,19,82,75,628
641,Preston Medlin,SO,2011-12,G,Utah State,WAC,37,1302,204,411,.496,109,189,95,222,.428,125,156,.801,5,159,164,124,26,5,73,55,628
642,Darryl Partin,SR,2011-12,G,Boston University,AEC,32,1078,218,536,.407,149,315,69,221,.312,123,171,.719,37,88,125,35,35,3,101,55,628
643,Andrew White,SR,2016-17,G,Syracuse,ACC,34,1266,199,451,.441,87,173,112,278,.403,118,141,.837,28,130,158,38,55,12,56,72,628
644,Jonathan Williams,SR,2016-17,G,Toledo,MAC,32,1097,212,479,.443,146,272,66,207,.319,138,169,.817,22,75,97,102,25,4,87,67,628
645,Nisre Zouzoua,SO,2016-17,G,Bryant,NEC,31,1102,208,508,.409,116,257,92,251,.367,120,156,.769,29,100,129,48,45,13,59,83,628
646,DeAndre Bembry,JR,2015-16,F,Saint Joseph's,A-10,36,1341,238,497,.479,204,369,34,128,.266,117,178,.657,51,228,279,161,51,30,73,88,627
647,Brandon Clarke,JR,2018-19,F,Gonzaga,WCC,37,1040,257,374,.687,253,359,4,15,.267,109,157,.694,114,203,317,70,43,117,57,79,627
648,Alex Harris,SR,2007-08,G,UC-Santa Barbara,Big West,31,1005,186,433,.430,112,258,74,175,.423,181,223,.812,31,84,115,53,35,5,81,67,627
649,DeSean Murray,SO,2015-16,F,Presbyterian,Big South,31,902,232,427,.543,232,420,0,7,.000,163,211,.773,74,154,228,53,62,17,95,94,627
650,Brian Roberts,SR,2007-08,G,Dayton,A-10,34,1179,208,437,.476,108,217,100,220,.455,111,129,.860,8,88,96,117,12,4,94,60,627
651,Jeremy Senglin,JR,2015-16,G,Weber State,Big Sky,35,1220,213,437,.487,107,192,106,245,.433,95,154,.617,12,110,122,97,23,3,77,62,627
652,Chaz Williams,SO,2011-12,G,Massachusetts,A-10,37,1291,195,476,.410,133,328,62,148,.419,175,222,.788,36,125,161,231,81,7,126,104,627
653,Jordan Adams,SO,2013-14,G,UCLA,Pac-12,36,1082,208,429,.485,156,283,52,146,.356,158,189,.836,67,125,192,84,95,5,54,78,626
654,George Beamon,JR,2011-12,G,Manhattan,MAAC,33,1055,210,432,.486,149,289,61,143,.427,145,181,.801,53,132,185,65,48,15,89,70,626
655,Isaiah Canaan,JR,2011-12,G,Murray State,OVC,33,1112,187,400,.468,89,185,98,215,.456,154,184,.837,27,87,114,120,45,2,89,56,626
656,Shane Gibson,SR,2012-13,G,Sacred Heart,NEC,29,951,212,475,.446,125,266,87,209,.416,115,132,.871,23,100,123,41,33,9,95,76,626
657,Melvin Johnson,SR,2015-16,G,Virginia Commonwealth,A-10,36,1134,223,535,.417,113,246,110,289,.381,70,86,.814,21,75,96,78,45,2,54,47,626
658,Jacob Pullen,SR,2010-11,G,Kansas State,Big 12,31,1012,191,448,.426,117,254,74,194,.381,170,220,.773,20,70,90,115,49,4,95,55,626
659,Jonathan Rodriguez,SO,2007-08,F,Campbell,A-Sun,30,1051,202,414,.488,188,363,14,51,.275,208,272,.765,93,211,304,75,47,17,109,73,626
660,Mike Smith,SR,2010-11,F,East Tennessee State,A-Sun,35,1194,222,473,.469,175,345,47,128,.367,135,171,.789,60,179,239,66,29,15,81,114,626
661,Ethan Telfair,JR,2015-16,G,Idaho State,Big Sky,31,1108,179,450,.398,116,287,63,163,.387,205,236,.869,27,96,123,167,74,4,112,78,626
662,Olivier Hanlan,JR,2014-15,G,Boston College,ACC,32,1204,225,496,.454,160,312,65,184,.353,110,145,.759,24,111,135,135,41,1,85,68,625
663,Ben Hansbrough,SR,2010-11,G,Notre Dame,Big East,34,1202,194,405,.479,107,205,87,200,.435,150,184,.815,25,106,131,145,41,4,81,88,625
664,Luke Maye,JR,2017-18,F,North Carolina,ACC,37,1193,251,516,.486,201,400,50,116,.431,73,117,.624,113,260,373,88,36,38,69,92,625
665,David Nichols,SO,2016-17,G,Albany (NY),AEC,35,1182,248,560,.443,197,416,51,144,.354,78,94,.830,14,107,121,111,43,3,93,97,625
666,D'Marcus Simonds,JR,2018-19,G,Georgia State,Sun Belt,34,1214,219,530,.413,162,328,57,202,.282,130,197,.660,25,144,169,123,43,33,125,80,625
667,Kyle Singler,SR,2010-11,F,Duke,ACC,37,1286,219,509,.430,157,316,62,193,.321,125,155,.806,88,165,253,60,34,12,70,98,625
670,Justin Tillman,SR,2017-18,F,Virginia Commonwealth,A-10,33,1012,248,445,.557,221,363,27,82,.329,102,156,.654,109,218,327,15,11,34,56,78,625
671,Lawrence Alexander,SR,2014-15,G,North Dakota State,Summit,33,1271,203,472,.430,99,236,104,236,.441,114,141,.809,14,136,150,56,29,7,65,45,624
672,Kevin Anderson,JR,2009-10,G,Richmond,A-10,35,1300,231,505,.457,193,393,38,112,.339,124,152,.816,22,96,118,93,61,12,83,58,624
673,Martin Breunig,SR,2015-16,F,Montana,Big Sky,33,1005,228,367,.621,225,357,3,10,.300,165,233,.708,97,201,298,48,22,37,73,110,624
674,Yoeli Childs,SO,2017-18,F,Brigham Young,WCC,35,1191,246,455,.541,231,407,15,48,.313,117,182,.643,70,231,301,77,30,63,76,79,624
675,Brandon Ingram,FR,2015-16,G,Duke,ACC,36,1246,214,484,.442,134,289,80,195,.410,116,170,.682,67,177,244,72,41,49,72,74,624
676,John Jenkins,SO,2010-11,G,Vanderbilt,SEC,32,1105,190,411,.462,90,166,100,245,.408,144,161,.894,17,78,95,39,24,11,52,44,624
677,Denzel Livingston,SR,2014-15,G,Incarnate Word,Southland,29,1071,190,418,.455,144,284,46,134,.343,198,246,.805,43,129,172,85,74,38,80,86,624
678,Jason Thompson,JR,2006-07,C,Rider,MAAC,31,1057,221,425,.520,215,403,6,22,.273,176,243,.724,92,220,312,65,23,67,93,102,624
679,Tres Tinkle,JR,2018-19,F,Oregon State,Pac-12,30,1094,215,445,.483,162,284,53,161,.329,141,183,.770,60,183,243,115,52,16,89,63,624
680,Jarrod Uthoff,SR,2015-16,F,Iowa,Big Ten,33,1016,218,487,.448,152,314,66,173,.382,122,150,.813,48,161,209,36,32,86,38,51,624
681,Kyle Allman,JR,2017-18,G,Cal State Fullerton,Big West,32,1053,198,405,.489,153,300,45,105,.429,182,244,.746,11,100,111,75,36,6,74,68,623
682,LaVell Boyd,SR,2016-17,G,Kansas City,WAC,35,1086,189,461,.410,102,245,87,216,.403,158,190,.832,19,123,142,136,37,1,89,95,623
683,Joe Chealey,JR,2016-17,G,College of Charleston,CAA,35,1184,175,405,.432,110,239,65,166,.392,208,253,.822,16,107,123,113,35,1,60,82,623
684,Jordan Howard,JR,2016-17,G,Central Arkansas,Southland,32,1098,189,439,.431,88,212,101,227,.445,144,162,.889,9,107,116,93,36,2,80,34,623
685,Darius Johnson-Odom,SR,2011-12,G,Marquette,Big East,34,1120,210,470,.447,133,270,77,200,.385,126,165,.764,22,97,119,93,32,4,80,68,623
686,Carrington Love,SR,2015-16,G,Green Bay,Horizon,36,1174,204,485,.421,119,240,85,245,.347,130,218,.596,20,78,98,129,94,10,61,68,623
687,Deishuan Booker,SR,2018-19,G,Cal State Long Beach,Big West,33,1060,165,363,.455,123,247,42,116,.362,250,274,.912,15,99,114,144,43,4,130,78,622
688,Obi Emegano,JR,2014-15,G,Oral Roberts,Summit,34,1168,194,434,.447,165,359,29,75,.387,205,260,.788,26,134,160,76,57,6,87,70,622
689,Zeek Woodley,JR,2015-16,G,Northwestern State,Southland,28,925,216,407,.531,159,267,57,140,.407,133,150,.887,47,98,145,44,27,16,55,67,622
692,Cameron Young,SR,2017-18,G,Quinnipiac,MAAC,33,1124,187,443,.422,123,232,64,211,.303,184,244,.754,61,165,226,91,43,10,93,85,622
693,Aaron Brooks,SR,2006-07,G,Oregon,Pac-10,35,1289,213,463,.460,133,265,80,198,.404,115,136,.846,31,118,149,149,48,6,89,88,621
694,Jordan Hill,JR,2008-09,F,Arizona,Pac-10,34,1213,252,469,.537,252,469,0,0,,117,179,.654,143,232,375,50,30,58,97,102,621
695,Jon Leuer,SR,2010-11,F,Wisconsin,Big Ten,34,1139,227,483,.470,173,337,54,146,.370,113,134,.843,57,189,246,56,17,30,54,75,621
696,Derrick Marks,SR,2014-15,G,Boise State,MWC,32,998,231,468,.494,163,312,68,156,.436,91,118,.771,16,102,118,96,59,14,68,72,621
697,Jacorey Williams,SR,2016-17,F,Middle Tennessee,CUSA,36,1069,258,484,.533,256,469,2,15,.133,103,148,.696,63,201,264,56,32,17,60,72,621
698,Tyler Zeller,SR,2011-12,F,North Carolina,ACC,38,1070,220,398,.553,220,398,0,0,,181,224,.808,146,219,365,36,34,58,73,102,621
699,Aubrey Coleman,JR,2008-09,G,Houston,CUSA,32,1049,218,512,.426,208,464,10,48,.208,174,228,.763,85,177,262,77,75,0,79,78,620
700,Jordan Davis,JR,2017-18,G,Northern Colorado,Big Sky,38,1103,236,458,.515,220,391,16,67,.239,132,207,.638,40,143,183,121,36,15,118,104,620
701,Donte Greene,FR,2007-08,F,Syracuse,Big East,35,1253,218,521,.418,128,260,90,261,.345,94,133,.707,60,191,251,71,45,57,91,101,620
702,Jakob Poeltl,SO,2015-16,F,Utah,Pac-12,36,1093,228,353,.646,228,353,0,0,,164,238,.689,102,225,327,70,21,56,74,83,620
703,Jamar Wilson,SR,2006-07,G,Albany (NY),AEC,33,1199,209,460,.454,163,343,46,117,.393,156,209,.746,52,153,205,159,40,12,119,70,620
704,Jaylen Adams,JR,2016-17,G,St. Bonaventure,A-10,30,1123,168,401,.419,91,185,77,216,.356,206,251,.821,18,94,112,195,62,5,103,84,619
705,Khalil Ahmad,SR,2018-19,G,Cal State Fullerton,Big West,34,1069,207,475,.436,151,299,56,176,.318,149,183,.814,19,116,135,43,55,6,69,85,619
706,Marcus Denmon,SR,2011-12,G,Missouri,Big 12,35,1212,200,435,.460,101,192,99,243,.407,120,134,.896,35,141,176,74,54,1,41,34,619
707,Chandler Hutchison,SR,2017-18,G,Boise State,MWC,31,961,205,432,.475,159,304,46,128,.359,163,224,.728,27,211,238,107,46,8,104,74,619
708,Mike Rose,SR,2008-09,G,Eastern Kentucky,OVC,31,1133,208,441,.472,109,235,99,206,.481,104,137,.759,63,101,164,79,53,3,74,45,619
709,John Shurna,SO,2009-10,F,Northwestern,Big Ten,34,1238,217,473,.459,139,253,78,220,.355,107,138,.775,58,158,216,88,28,32,67,74,619
710,Deshaun Thomas,SO,2011-12,F,Ohio State,Big Ten,39,1225,243,467,.520,193,322,50,145,.345,83,110,.755,100,109,209,35,15,9,47,65,619
711,Justin Turner,SO,2018-19,G,Bowling Green State,MAC,34,1094,229,489,.468,168,325,61,164,.372,100,141,.709,28,99,127,105,47,8,63,58,619
714,Arron Afflalo,SO,2005-06,G,UCLA,Pac-10,39,1303,203,439,.462,120,212,83,227,.366,129,160,.806,32,132,164,69,24,5,79,83,618
715,Nathan Boothe,SR,2015-16,C,Toledo,MAC,32,1007,241,486,.496,208,398,33,88,.375,103,125,.824,60,227,287,105,21,33,71,83,618
716,Anatoly Bose,SR,2010-11,G,Nicholls State,Southland,28,955,178,452,.394,111,246,67,206,.325,195,246,.793,34,130,164,62,38,5,95,67,618
717,Nick Calathes,SO,2008-09,G,Florida,SEC,36,1200,205,425,.482,132,238,73,187,.390,135,191,.707,31,161,192,231,68,6,119,69,618
718,Zac Cuthbertson,SR,2018-19,F,Coastal Carolina,Sun Belt,34,1091,200,410,.488,156,290,44,120,.367,174,228,.763,75,202,277,80,32,15,80,103,618
719,Josh Hart,JR,2015-16,G,Villanova,Big East,40,1255,230,448,.513,175,294,55,154,.357,103,137,.752,74,196,270,77,46,10,66,87,618
720,Reggie Jackson,JR,2010-11,G,Boston College,ACC,34,1161,219,435,.503,148,266,71,169,.420,109,137,.796,35,111,146,152,36,18,81,58,618
721,Nick Johnson,JR,2013-14,G,Arizona,Pac-12,38,1257,205,474,.432,143,305,62,169,.367,146,187,.781,31,123,154,107,43,25,64,76,618
722,Geoff Payne,JR,2007-08,F,Southern Utah,Summit,30,1070,219,386,.567,219,382,0,4,.000,180,261,.690,81,123,204,70,54,13,91,80,618
723,Isaiah Whitehead,SO,2015-16,G,Seton Hall,Big East,34,1098,194,512,.379,113,290,81,222,.365,149,196,.760,18,104,122,173,40,49,119,78,618
724,Anthony Beane,SR,2015-16,G,Southern Illinois,MVC,32,1097,208,481,.432,136,287,72,194,.371,129,168,.768,22,101,123,57,36,0,86,88,617
725,Joel Berry,SR,2017-18,G,North Carolina,ACC,36,1193,208,525,.396,115,255,93,270,.344,108,121,.893,20,107,127,116,42,12,68,58,617
726,John Brown,JR,2014-15,F,High Point,Big South,32,995,242,440,.550,242,434,0,6,.000,133,176,.756,101,91,192,39,39,33,53,66,617
727,Zach Cooks,SO,2018-19,G,NJIT,A-Sun,35,1304,216,479,.451,143,270,73,209,.349,112,153,.732,22,147,169,73,88,2,76,68,617
728,Josh Davis,JR,2012-13,F,Tulane,CUSA,35,1250,207,421,.492,206,419,1,2,.500,202,282,.716,143,231,374,61,28,30,92,87,617
729,Damian Lillard,SO,2009-10,G,Weber State,Big Sky,31,1062,185,429,.431,101,215,84,214,.393,163,191,.853,11,114,125,112,35,4,74,58,617
730,Ray McCallum,JR,2012-13,G,Detroit Mercy,Horizon,33,1208,214,436,.491,172,306,42,130,.323,147,205,.717,43,124,167,147,64,20,68,66,617
731,Jack McClinton,SR,2008-09,G,Miami (FL),ACC,32,1030,200,445,.449,99,222,101,223,.453,116,131,.885,18,81,99,91,24,1,84,52,617
732,Tim Smith,SR,2005-06,G,East Tennessee State,A-Sun,28,1056,238,530,.449,197,405,41,125,.328,100,137,.730,33,94,127,126,95,1,137,45,617
733,Jordan Taylor,JR,2010-11,G,Wisconsin,Big Ten,34,1241,194,448,.433,119,273,75,175,.429,154,185,.832,32,107,139,161,25,5,42,80,617
736,Desmond Williams,SR,2017-18,F,Florida A&M,MEAC,34,1212,221,504,.438,210,463,11,41,.268,164,222,.739,60,148,208,64,40,25,100,78,617
737,Jeremy Wise,SO,2007-08,G,Southern Mississippi,CUSA,33,1138,189,449,.421,148,320,41,129,.318,198,242,.818,15,86,101,137,39,13,112,96,617
738,Ky Bowman,SO,2017-18,G,Boston College,ACC,35,1337,220,521,.422,140,300,80,221,.362,96,119,.807,29,210,239,165,51,12,112,90,616
739,Brandon Ewing,SO,2006-07,G,Wyoming,MWC,31,1146,186,423,.440,136,256,50,167,.299,194,241,.805,24,76,100,95,41,2,83,87,616
740,Reggie Hamilton,JR,2010-11,G,Oakland,Summit,35,1008,207,423,.489,125,202,82,221,.371,120,143,.839,27,59,86,187,46,7,127,85,616
741,Lazar Hayward,SR,2009-10,F,Marquette,Big East,34,1097,222,514,.432,157,328,65,186,.349,107,127,.843,72,184,256,52,64,18,67,115,616
742,Quinton Hooker,SR,2016-17,G,North Dakota,Big Sky,32,1156,202,432,.468,118,243,84,189,.444,128,148,.865,24,123,147,115,56,5,56,69,616
743,Matt Mobley,SR,2017-18,G,St. Bonaventure,A-10,34,1277,187,447,.418,82,165,105,282,.372,137,159,.862,20,149,169,83,38,4,82,87,616
744,Yemi Nicholson,SR,2005-06,C,Denver,Sun Belt,31,1039,238,395,.603,238,395,0,0,,140,187,.749,89,250,339,28,29,88,66,77,616
745,Lamar Patterson,SR,2013-14,G,Pittsburgh,ACC,36,1174,202,458,.441,122,252,80,206,.388,132,175,.754,35,140,175,154,51,12,93,73,616
746,Erik Thomas,SR,2016-17,F,New Orleans,Southland,32,1043,223,379,.588,219,362,4,17,.235,166,212,.783,95,155,250,73,47,11,88,68,616
747,John Wall,FR,2009-10,G,Kentucky,SEC,37,1288,202,438,.461,165,324,37,114,.325,175,232,.754,30,129,159,241,66,19,149,72,616
748,Thomas Wilder,JR,2016-17,G,Western Michigan,MAC,32,1014,197,430,.458,134,288,63,142,.444,159,191,.832,14,123,137,121,42,12,64,78,616
749,Will Daniels,SR,2007-08,F,Rhode Island,A-10,33,941,228,455,.501,183,330,45,125,.360,114,165,.691,68,148,216,36,32,31,80,101,615
750,Malcolm Delaney,SO,2008-09,G,Virginia Tech,ACC,34,1255,160,416,.385,90,218,70,198,.354,225,259,.869,34,102,136,152,50,11,97,87,615
751,Chavis Holmes,SO,2006-07,G,Virginia Military Institute,Big South,32,806,188,460,.409,80,183,108,277,.390,131,176,.744,50,55,105,67,90,9,81,95,615
752,Anthony Johnson,SR,2009-10,G,Montana,Big Sky,32,1116,184,374,.492,139,273,45,101,.446,202,231,.874,22,80,102,95,24,4,89,52,615
753,Camron Justice,JR,2018-19,G,IUPUI,Horizon,33,1077,195,459,.425,105,203,90,256,.352,135,158,.854,11,95,106,95,43,1,84,72,615
754,Mason Plumlee,SR,2012-13,F,Duke,ACC,36,1248,221,369,.599,221,369,0,0,,173,254,.681,98,260,358,70,36,52,103,92,615
755,Terry Rozier,SO,2014-15,G,Louisville,ACC,36,1260,214,521,.411,166,364,48,157,.306,139,176,.790,43,157,200,108,72,6,79,62,615
756,Rakim Sanders,SR,2011-12,F,Fairfield,MAAC,37,1195,235,470,.500,191,329,44,141,.312,101,159,.635,102,201,303,92,52,13,122,97,615
757,Anthony Smith,SR,2008-09,G,Liberty,Big South,35,1270,217,436,.498,142,234,75,202,.371,106,161,.658,40,189,229,75,43,7,78,73,615
758,Thomas Walkup,SR,2015-16,G,Stephen F. Austin,Southland,34,1002,217,369,.588,207,330,10,39,.256,171,209,.818,79,154,233,153,71,16,58,93,615
759,Derrick White,SR,2016-17,G,Colorado,Pac-12,34,1116,205,404,.507,148,260,57,144,.396,148,182,.813,35,104,139,148,42,49,81,72,615
760,Jahii Carson,SO,2013-14,G,Arizona State,Pac-12,33,1168,211,487,.433,175,395,36,92,.391,156,217,.719,24,109,133,153,23,2,116,72,614
761,Jae Crowder,SR,2011-12,F,Marquette,Big East,35,1153,217,436,.498,156,259,61,177,.345,119,162,.735,70,224,294,73,88,35,44,93,614
762,Devan Downey,JR,2008-09,G,South Carolina,SEC,31,1019,231,527,.438,179,377,52,150,.347,100,134,.746,19,68,87,140,89,4,108,65,614
763,LaceDarius Dunn,SO,2008-09,G,Baylor,Big 12,39,1119,194,438,.443,85,157,109,281,.388,117,142,.824,50,140,190,24,42,6,70,109,614
764,Torian Graham,SR,2016-17,G,Arizona State,Pac-12,33,1147,230,513,.448,122,234,108,279,.387,46,56,.821,19,120,139,39,31,11,44,51,614
765,Malcolm Hill,JR,2015-16,G,Illinois,Big Ten,34,1195,192,440,.436,155,322,37,118,.314,193,235,.821,43,180,223,112,42,15,75,88,614
766,DeAndre Kane,SR,2013-14,G,Iowa State,Big 12,36,1240,208,431,.483,165,323,43,108,.398,155,244,.635,49,196,245,213,44,10,104,79,614
767,Acie Law,SR,2006-07,G,Texas A&M,Big 12,34,1153,216,432,.500,178,349,38,83,.458,144,185,.778,8,105,113,169,39,1,88,83,614
768,Dedric Lawson,SO,2016-17,F,Memphis,AAC,32,1104,216,469,.461,186,358,30,111,.270,152,205,.741,92,225,317,105,41,68,76,81,614
769,K.J. McDaniels,JR,2013-14,F,Clemson,ACC,36,1212,209,455,.459,167,317,42,138,.304,154,183,.842,86,169,255,57,41,100,83,80,614
770,Courtney Pigram,SO,2006-07,G,East Tennessee State,A-Sun,34,1141,218,535,.407,132,297,86,238,.361,92,135,.681,29,106,135,127,89,3,109,65,614
771,Keifer Sykes,SR,2014-15,G,Green Bay,Horizon,33,1156,213,471,.452,167,323,46,148,.311,142,182,.780,25,123,148,129,55,5,71,72,614
772,Kevin Anderson,SR,2010-11,G,Richmond,A-10,37,1339,211,494,.427,140,320,71,174,.408,120,160,.750,15,87,102,122,53,4,72,56,613
773,Gerald Brown,SR,2007-08,G,Loyola (MD),MAAC,33,1037,178,453,.393,111,262,67,191,.351,190,240,.792,48,111,159,63,52,5,96,117,613
774,Denis Clemente,SR,2009-10,G,Kansas State,Big 12,37,1284,213,526,.405,125,268,88,258,.341,99,133,.744,24,64,88,154,40,4,72,78,613
775,Jawun Evans,SO,2016-17,G,Oklahoma State,Big 12,32,936,211,482,.438,175,387,36,95,.379,155,191,.812,24,86,110,204,57,4,90,74,613
778,Jared Harper,JR,2018-19,G,Auburn,SEC,40,1318,183,459,.399,85,194,98,265,.370,149,180,.828,12,87,99,231,45,2,94,70,613
779,Ricky Harris,SR,2009-10,G,Massachusetts,A-10,31,966,216,506,.427,148,281,68,225,.302,113,155,.729,25,82,107,91,40,3,113,71,613
780,Desmar Jackson,SR,2013-14,G,Southern Illinois,MVC,33,1087,212,455,.466,190,373,22,82,.268,167,214,.780,50,133,183,68,80,14,98,92,613
781,Fletcher Magee,SO,2016-17,G,Wofford,Southern,33,1099,196,448,.438,84,183,112,265,.423,109,122,.893,10,100,110,61,24,5,55,44,613
782,Mikh McKinney,SR,2014-15,G,Sacramento State,Big Sky,32,1183,219,432,.507,154,281,65,151,.430,110,137,.803,16,75,91,156,78,4,68,57,613
783,Vlad Moldoveanu,SR,2010-11,F,American,Patriot,30,1011,197,450,.438,137,287,60,163,.368,159,191,.832,49,144,193,59,11,14,57,69,613
784,Brock Motum,JR,2011-12,F,Washington State,Pac-12,34,1072,220,397,.554,191,324,29,73,.397,144,195,.738,62,154,216,54,19,14,103,75,613
785,Ahmad Nivins,SR,2008-09,F,Saint Joseph's,A-10,32,1259,205,335,.612,205,334,0,1,.000,203,258,.787,126,252,378,32,26,56,87,70,613
786,Derek Raivio,SR,2006-07,G,Gonzaga,WCC,34,1233,190,419,.453,105,211,85,208,.409,148,154,.961,22,84,106,89,50,1,61,56,613
787,Grant Riller,SO,2017-18,G,College of Charleston,CAA,33,1110,230,422,.545,174,280,56,142,.394,97,133,.729,13,78,91,67,42,14,64,69,613
788,Greivis Vasquez,JR,2008-09,G,Maryland,ACC,35,1210,218,538,.405,152,336,66,202,.327,111,128,.867,37,152,189,176,49,13,98,76,613
789,Brett Winkelman,SR,2008-09,F,North Dakota State,Summit,33,1088,220,438,.502,178,332,42,106,.396,131,162,.809,71,178,249,58,48,12,60,62,613
790,Antoine Agudio,SR,2007-08,G,Hofstra,CAA,27,1056,207,480,.431,123,275,84,205,.410,114,147,.776,15,91,106,77,31,0,96,49,612
791,Morris Almond,JR,2005-06,G,Rice,CUSA,28,905,224,448,.500,176,340,48,108,.444,116,146,.795,49,65,114,32,39,19,80,66,612
792,Jordan Clarkson,JR,2013-14,G,Missouri,SEC,35,1228,209,467,.448,177,353,32,114,.281,162,195,.831,28,106,134,118,38,6,93,76,612
793,Dante Cunningham,SR,2008-09,F,Villanova,Big East,38,1199,244,465,.525,244,463,0,2,.000,124,178,.697,99,185,284,47,47,47,82,103,612
794,Seth Curry,SR,2012-13,G,Duke,ACC,35,1130,197,424,.465,102,207,95,217,.438,123,152,.809,20,69,89,54,30,6,42,60,612
795,Brandon Ewing,SR,2008-09,G,Wyoming,MWC,33,1264,165,373,.442,116,227,49,146,.336,233,280,.832,15,95,110,166,32,5,88,73,612
796,Max Heidegger,SO,2017-18,G,UC-Santa Barbara,Big West,32,1053,195,451,.432,100,216,95,235,.404,127,166,.765,11,68,79,79,19,2,50,69,612
797,Stephen Maxwell,JR,2013-14,F,Cal State Northridge,Big West,35,1210,216,395,.547,216,395,0,0,,180,239,.753,129,180,309,20,26,3,80,87,612
800,E'Twaun Moore,SR,2010-11,G,Purdue,Big Ten,34,1152,221,494,.447,151,319,70,175,.400,100,141,.709,51,124,175,108,41,18,61,71,612
801,Charles Odum,SR,2011-12,G,Portland State,Big Sky,32,1005,192,363,.529,154,251,38,112,.339,190,228,.833,26,98,124,82,29,7,94,72,612
802,Akeem Richmond,SR,2013-14,G,East Carolina,CUSA,34,1199,181,451,.401,26,59,155,392,.395,95,112,.848,20,75,95,54,45,1,57,40,612
803,Jordon Varnado,SO,2016-17,F,Troy,Sun Belt,37,1068,233,442,.527,205,365,28,77,.364,118,168,.702,76,188,264,50,19,51,70,100,612
804,A.J. Abrams,JR,2007-08,G,Texas,Big 12,37,1328,219,516,.424,101,207,118,309,.382,55,68,.809,18,89,107,55,59,2,31,69,611
805,Larry Austin,SR,2018-19,G,Central Michigan,MAC,35,1191,235,473,.497,230,454,5,19,.263,136,248,.548,77,142,219,209,78,5,124,93,611
806,Joe Chealey,SR,2017-18,G,College of Charleston,CAA,34,1202,169,430,.393,107,252,62,178,.348,211,246,.858,22,136,158,122,29,4,59,78,611
807,Alex Harris,JR,2006-07,G,UC-Santa Barbara,Big West,29,1018,191,401,.476,120,246,71,155,.458,158,201,.786,36,104,140,61,26,3,77,56,611
808,Damion James,SR,2009-10,F,Texas,Big 12,34,1029,210,419,.501,174,325,36,94,.383,155,230,.674,107,243,350,33,57,40,69,100,611
809,Orlando Johnson,SR,2011-12,G,UC-Santa Barbara,Big West,31,1067,207,459,.451,137,295,70,164,.427,127,182,.698,52,127,179,91,34,23,76,57,611
810,C.J. Massinburg,JR,2017-18,G,Buffalo,MAC,36,1223,196,419,.468,107,199,89,220,.405,130,175,.743,80,184,264,87,40,16,58,75,611
811,Javon McCrea,JR,2012-13,F,Buffalo,MAC,34,1019,240,431,.557,240,430,0,1,.000,131,185,.708,110,157,267,69,45,89,99,101,611
812,Jamie Skeen,SR,2010-11,F,Virginia Commonwealth,CAA,39,1245,198,382,.518,162,296,36,86,.419,179,249,.719,93,193,286,62,23,40,66,77,611
813,J.J. Barea,SR,2005-06,G,Northeastern,CAA,29,974,209,522,.400,143,295,66,227,.291,126,165,.764,31,98,129,244,37,0,136,81,610
814,Gerald Henderson,JR,2008-09,G,Duke,ACC,37,1098,213,473,.450,172,351,41,122,.336,143,188,.761,46,137,183,91,46,28,80,63,610
815,Buddy Hield,JR,2014-15,G,Oklahoma,Big 12,35,1135,205,498,.412,112,239,93,259,.359,107,130,.823,56,134,190,67,47,8,68,61,610
816,Cory Higgins,SR,2010-11,G,Colorado,Big 12,38,1222,200,461,.434,164,355,36,106,.340,174,201,.866,31,93,124,94,37,14,80,82,610
817,Admiral Schofield,SR,2018-19,G,Tennessee,SEC,37,1175,238,502,.474,164,325,74,177,.418,60,86,.698,43,184,227,75,33,17,70,94,610
818,Rayjon Tucker,JR,2018-19,G,Little Rock,Sun Belt,30,1097,187,381,.491,115,206,72,175,.411,164,211,.777,23,179,202,53,33,11,78,68,610
819,Elliot Williams,SO,2009-10,G,Memphis,CUSA,34,1133,178,388,.459,118,224,60,164,.366,194,256,.758,25,110,135,128,45,4,100,69,610
822,Ehab Amin,JR,2016-17,G,Texas A&M-Corpus Christi,Southland,36,1213,225,487,.462,182,338,43,149,.289,116,162,.716,71,166,237,105,124,13,99,102,609
823,Charlie Brown,SO,2018-19,F,Saint Joseph's,A-10,32,1139,205,477,.430,142,300,63,177,.356,136,161,.845,66,131,197,48,34,25,59,83,609
824,Derrick Colter,SR,2015-16,G,Duquesne,A-10,34,1220,193,479,.403,113,246,80,233,.343,143,173,.827,17,105,122,156,34,7,108,67,609
825,Nick Faust,SR,2015-16,G,Cal State Long Beach,Big West,35,1082,205,471,.435,119,236,86,235,.366,113,165,.685,50,162,212,78,51,17,81,90,609
826,Shelvin Mack,JR,2010-11,G,Butler,Horizon,38,1219,201,493,.408,114,247,87,246,.354,120,156,.769,27,143,170,131,30,3,93,66,609
827,Patrick Patterson,SO,2008-09,F,Kentucky,SEC,34,1147,240,398,.603,240,397,0,1,.000,129,168,.768,92,224,316,67,21,70,66,76,609
828,Jamine Peterson,SO,2009-10,F,Providence,Big East,31,941,233,500,.466,182,352,51,148,.345,92,164,.561,135,180,315,36,39,26,57,80,609
829,Marcus Posley,SR,2015-16,G,St. Bonaventure,A-10,31,1154,197,471,.418,115,243,82,228,.360,133,165,.806,21,85,106,113,39,3,75,76,609
830,Ronshad Shabazz,JR,2017-18,G,Appalachian State,Sun Belt,33,1079,206,515,.400,126,282,80,233,.343,117,170,.688,19,64,83,100,36,2,79,58,609
831,Kyle Singler,SO,2008-09,F,Duke,ACC,37,1193,208,472,.441,139,292,69,180,.383,124,174,.713,112,172,284,89,57,38,92,99,609
832,Sean Singletary,JR,2006-07,G,Virginia,ACC,32,1064,170,425,.400,91,222,79,203,.389,190,218,.872,36,111,147,151,38,1,100,81,609
833,Klay Thompson,SO,2009-10,G,Washington State,Pac-10,31,1096,200,485,.412,124,276,76,209,.364,133,166,.801,37,122,159,70,44,22,104,75,609
834,Arron Afflalo,JR,2006-07,G,UCLA,Pac-10,36,1186,210,456,.461,123,224,87,232,.375,101,126,.802,15,84,99,70,22,8,64,66,608
835,Mark Alstork,JR,2016-17,G,Wright State,Horizon,32,965,181,452,.400,111,271,70,181,.387,176,208,.846,26,124,150,112,25,19,136,92,608
836,Jarekious Bradley,JR,2013-14,G,Southeast Missouri State,OVC,32,1003,218,438,.498,143,237,75,201,.373,97,125,.776,48,153,201,52,38,30,57,95,608
837,C.J. Bryce,SO,2016-17,G,North Carolina-Wilmington,CAA,35,1199,231,477,.484,189,350,42,127,.331,104,153,.680,60,129,189,104,33,7,66,80,608
838,Reger Dowell,SR,2013-14,G,Texas-Arlington,Sun Belt,30,928,194,479,.405,98,208,96,271,.354,124,162,.765,8,67,75,66,21,2,74,74,608
839,Matt Howard,SR,2010-11,F,Butler,Horizon,37,1148,188,399,.471,135,266,53,133,.398,179,226,.792,98,187,285,53,41,23,62,108,608
840,Cameron Johnson,SR,2018-19,G,North Carolina,ACC,36,1076,211,417,.506,115,207,96,210,.457,90,110,.818,66,142,208,86,43,10,54,53,608
841,Micah Mason,SR,2015-16,G,Duquesne,A-10,33,1177,207,441,.469,89,162,118,279,.423,76,91,.835,7,94,101,148,31,2,69,63,608
844,Cameron Morse,SO,2015-16,G,Youngstown State,Horizon,30,1006,201,427,.471,137,272,64,155,.413,142,175,.811,10,72,82,92,46,2,52,47,608
845,Josh Robinson,SO,2015-16,G,Austin Peay,OVC,36,1228,185,461,.401,113,250,72,211,.341,166,199,.834,14,98,112,92,36,0,97,49,608
846,Keifer Sykes,JR,2013-14,G,Green Bay,Horizon,30,1029,195,416,.469,165,319,30,97,.309,188,232,.810,22,111,133,147,37,0,64,52,608
847,Marcus Thornton,JR,2007-08,G,Louisiana State,SEC,31,1043,212,486,.436,122,247,90,239,.377,94,115,.817,63,111,174,42,43,10,68,62,608
848,Ben Uzoh,SO,2007-08,G,Tulsa,CUSA,39,1258,208,426,.488,153,269,55,157,.350,137,170,.806,64,148,212,88,39,29,92,62,608
849,Devin Watson,SO,2015-16,G,San Francisco,WCC,30,1041,192,459,.418,127,273,65,186,.349,159,217,.733,9,65,74,146,27,0,89,53,608
850,Joe Alexander,JR,2007-08,G,West Virginia,Big East,36,1137,219,474,.462,208,433,11,41,.268,158,194,.814,68,163,231,88,26,54,80,103,607
851,DeMario Anderson,SR,2007-08,G,Quinnipiac,NEC,28,924,220,492,.447,185,398,35,94,.372,132,164,.805,29,152,181,91,43,12,116,82,607
852,Keith Benson,JR,2009-10,C,Oakland,Summit,35,1095,208,390,.533,206,385,2,5,.400,189,261,.724,111,256,367,28,15,117,58,104,607
853,Marqus Blakely,SR,2009-10,F,Vermont,AEC,35,1180,202,373,.542,201,358,1,15,.067,202,303,.667,113,214,327,129,85,67,121,89,607
854,Allen Crabbe,JR,2012-13,G,University of California,Pac-12,33,1195,215,468,.459,151,284,64,184,.348,113,139,.813,33,167,200,87,37,23,83,69,607
855,JamesOn Curry,JR,2006-07,G,Oklahoma State,Big 12,35,1295,202,447,.452,114,233,88,214,.411,115,145,.793,15,96,111,131,41,11,109,74,607
856,Yogi Ferrell,SR,2015-16,G,Indiana,Big Ten,35,1215,196,428,.458,117,240,79,188,.420,136,164,.829,34,99,133,195,38,1,88,58,607
857,Brandon Heath,JR,2005-06,G,San Diego State,MWC,33,1164,204,481,.424,106,241,98,240,.408,101,119,.849,21,90,111,114,49,1,119,54,607
858,Garrison Carr,JR,2007-08,G,American,Patriot,33,1187,190,448,.424,55,149,135,299,.452,91,102,.892,22,89,111,57,23,1,73,61,606
859,Adrien Coleman,JR,2012-13,G,Bethune-Cookman,MEAC,34,1220,233,432,.539,225,397,8,35,.229,132,262,.504,107,144,251,100,46,15,99,85,606
860,Juan'ya Green,SR,2015-16,G,Hofstra,CAA,34,1282,173,435,.398,105,247,68,188,.362,192,240,.800,25,123,148,243,56,17,101,78,606
861,Ken Horton,JR,2010-11,F,Central Connecticut State,NEC,31,1096,214,435,.492,155,278,59,157,.376,119,137,.869,92,183,275,60,44,50,51,74,606
862,Justin James,JR,2017-18,G,Wyoming,MWC,32,996,210,445,.472,170,315,40,130,.308,146,201,.726,19,172,191,98,36,16,81,81,606
863,Tyler Ulis,SO,2015-16,G,Kentucky,SEC,35,1288,192,442,.434,137,282,55,160,.344,167,195,.856,19,86,105,246,51,4,69,64,606
864,Joel Wright,JR,2012-13,F,Texas State,WAC,34,911,194,423,.459,177,370,17,53,.321,201,261,.770,90,143,233,57,44,20,123,132,606
865,Brandon Costner,FR,2006-07,F,North Carolina State,ACC,36,1239,193,407,.474,132,246,61,161,.379,158,219,.721,55,209,264,64,29,26,112,103,605
866,Melvin Ejim,SR,2013-14,F,Iowa State,Big 12,34,1093,220,436,.505,176,309,44,127,.346,121,159,.761,88,197,285,62,40,23,78,111,605
867,Kenneth Faried,SR,2010-11,F,Morehead State,OVC,35,1216,233,374,.623,233,374,0,0,,139,241,.577,200,308,508,37,67,82,92,108,605
868,James Harden,FR,2007-08,G,Arizona State,Pac-10,34,1158,196,372,.527,152,264,44,108,.407,169,224,.754,44,135,179,110,73,19,89,72,605
869,Kyle Hines,JR,2006-07,F,North Carolina-Greensboro,Southern,29,928,233,420,.555,232,414,1,6,.167,138,230,.600,99,161,260,26,40,64,74,83,605
870,Quincy McKnight,SO,2016-17,G,Sacred Heart,NEC,32,1040,203,473,.429,176,389,27,84,.321,172,222,.775,26,130,156,95,52,5,148,94,605
871,Paul Miller,SR,2017-18,G,North Dakota State,Summit,31,1048,208,461,.451,141,264,67,197,.340,122,146,.836,15,165,180,105,31,10,95,50,605
872,Jamal Olasewere,SR,2012-13,F,Long Island University,NEC,32,969,200,389,.514,180,327,20,62,.323,185,267,.693,66,208,274,43,48,20,110,108,605
873,Tookie Brown,JR,2017-18,G,Georgia Southern,Sun Belt,32,1035,189,355,.532,140,251,49,104,.471,177,235,.753,20,110,130,137,56,10,80,79,604
874,Raiquan Clark,JR,2017-18,G,Long Island University,NEC,35,1127,207,372,.556,200,343,7,29,.241,183,244,.750,74,171,245,53,40,14,143,111,604
875,Raiquan Clark,SR,2018-19,G,Long Island University,NEC,32,1034,220,437,.503,200,355,20,82,.244,144,206,.699,62,154,216,63,40,21,142,100,604
876,Michael Glover,SR,2011-12,F,Iona,MAAC,33,1109,239,375,.637,239,375,0,0,,126,194,.649,106,191,297,32,33,38,88,97,604
877,Ryan Harrow,JR,2013-14,G,Georgia State,Sun Belt,34,1152,222,498,.446,192,394,30,104,.288,130,155,.839,23,66,89,144,43,2,57,43,604
878,Xavier Hill-Mais,JR,2018-19,F,Oakland,Horizon,33,1025,235,439,.535,201,338,34,101,.337,100,143,.699,73,164,237,81,21,26,96,90,604
879,R.J. Hunter,SO,2013-14,G,Georgia State,Sun Belt,33,1106,181,408,.444,81,155,100,253,.395,142,161,.882,11,140,151,57,63,31,39,77,604
880,Dior Lowhorn,JR,2008-09,F,San Francisco,WCC,30,970,231,478,.483,193,390,38,88,.432,104,153,.680,67,140,207,23,16,17,45,59,604
881,Jairus Lyles,JR,2016-17,G,Maryland-Baltimore County,AEC,32,1107,210,475,.442,165,334,45,141,.319,139,191,.728,42,169,211,83,54,1,71,50,604
882,Darrel Mitchell,SR,2005-06,G,Louisiana State,SEC,36,1322,200,459,.436,118,251,82,208,.394,122,161,.758,30,104,134,160,70,11,99,81,604
883,Tyler Nelson,JR,2016-17,G,Fairfield,MAAC,31,1119,196,442,.443,115,235,81,207,.391,131,153,.856,23,75,98,112,35,4,69,53,604
886,D.J. Newbill,JR,2013-14,G,Penn State,Big Ten,34,1171,209,462,.452,163,321,46,141,.326,140,186,.753,61,106,167,58,27,11,72,96,604
887,Martin Samarco,SR,2006-07,F,Bowling Green State,MAC,31,1113,200,506,.395,120,263,80,243,.329,124,161,.770,21,92,113,70,29,5,74,74,604
888,Donald Sloan,SR,2009-10,G,Texas A&M,Big 12,34,1130,200,450,.444,153,321,47,129,.364,157,204,.770,23,99,122,79,22,2,80,56,604
889,Lamar Stevens,SO,2017-18,F,Penn State,Big Ten,39,1290,231,497,.465,201,403,30,94,.319,112,161,.696,54,178,232,74,24,43,87,93,604
890,Martez Walker,JR,2016-17,G,Oakland,Horizon,34,1146,195,446,.437,124,221,71,225,.316,143,172,.831,48,89,137,49,30,12,63,61,604
891,Nate Wolters,SO,2010-11,G,South Dakota State,Summit,31,1029,201,449,.448,159,346,42,103,.408,160,201,.796,32,110,142,188,41,7,68,63,604
892,Dwayne Bacon,SO,2016-17,G,Florida State,ACC,35,1008,221,489,.452,164,318,57,171,.333,104,138,.754,35,112,147,61,35,4,71,55,603
893,John Brown,SO,2013-14,F,High Point,Big South,31,986,224,411,.545,224,406,0,5,.000,155,208,.745,105,134,239,60,47,51,49,79,603
894,Gilberto Clavell,SR,2010-11,F,Sam Houston State,Southland,31,934,213,381,.559,211,374,2,7,.286,175,247,.709,100,125,225,28,20,4,97,107,603
895,Nick Dixon,JR,2016-17,G,Texas-Rio Grande Valley,WAC,32,877,201,386,.521,173,300,28,86,.326,173,226,.765,49,113,162,109,60,2,93,75,603
896,Dwight Hardy,SR,2010-11,G,St. John's (NY),Big East,33,1129,194,433,.448,132,258,62,175,.354,153,181,.845,26,71,97,62,42,3,73,59,603
897,Malcolm Hill,SR,2016-17,G,Illinois,Big Ten,35,1164,189,435,.434,124,252,65,183,.355,160,204,.784,35,145,180,102,42,13,66,74,603
898,Jeremy Lamb,SO,2011-12,G,Connecticut,Big East,34,1266,217,454,.478,146,243,71,211,.336,98,121,.810,32,134,166,58,42,21,68,57,603
899,Dominique Morrison,JR,2010-11,F,Oral Roberts,Summit,31,1083,207,403,.514,167,304,40,99,.404,149,191,.780,41,114,155,66,20,15,51,84,603
900,Darrion Pellum,SR,2011-12,G,Hampton,MEAC,33,1272,196,542,.362,124,299,72,243,.296,139,184,.755,20,119,139,55,40,10,105,67,603
901,Jahaad Proctor,JR,2018-19,G,High Point,Big South,31,1073,210,453,.464,155,287,55,166,.331,128,166,.771,18,101,119,101,39,11,68,50,603
902,Jerome Randle,JR,2008-09,G,University of California,Pac-10,33,1164,191,381,.501,109,204,82,177,.463,139,161,.863,14,86,100,165,24,0,95,58,603
903,Devon Saddler,SO,2011-12,G,Delaware,CAA,32,1130,193,493,.391,134,303,59,190,.311,158,197,.802,22,108,130,56,24,11,102,82,603
904,Thomas Wilder,SR,2017-18,G,Western Michigan,MAC,32,1050,191,443,.431,144,298,47,145,.324,174,207,.841,23,118,141,138,62,10,79,72,603
905,Wayne Ellington,JR,2008-09,G,North Carolina,ACC,38,1155,215,445,.483,130,241,85,204,.417,87,112,.777,57,129,186,101,36,6,62,57,602
908,Tim Frazier,JR,2011-12,G,Penn State,Big Ten,32,1188,208,497,.419,181,411,27,86,.314,159,201,.791,44,106,150,198,76,7,117,94,602
909,Langston Galloway,SR,2013-14,G,Saint Joseph's,A-10,34,1231,190,428,.444,82,184,108,244,.443,114,138,.826,28,117,145,53,36,17,28,81,602
910,Andrew Goudelock,SO,2008-09,G,College of Charleston,Southern,36,1120,221,481,.459,126,265,95,216,.440,65,75,.867,18,72,90,67,26,11,69,44,602
911,Tarence Kinsey,SR,2005-06,G,South Carolina,SEC,38,1321,209,461,.453,138,272,71,189,.376,113,134,.843,54,120,174,88,61,13,78,84,602
912,Marcquise Reed,SR,2018-19,G,Clemson,ACC,31,1098,202,459,.440,154,324,48,135,.356,150,178,.843,23,149,172,95,66,1,83,60,602
913,Scottie Reynolds,SR,2009-10,G,Villanova,Big East,33,1000,181,396,.457,112,217,69,179,.385,171,204,.838,17,72,89,108,51,4,87,68,602
914,Zack Rosen,SR,2011-12,G,Pennsylvania,Ivy,33,1259,211,466,.453,136,278,75,188,.399,105,119,.882,9,97,106,173,46,2,90,76,602
915,Devin Sibley,JR,2016-17,G,Furman,Southern,34,1093,201,385,.522,122,209,79,176,.449,121,162,.747,9,131,140,78,26,7,91,68,602
916,Khalil Small,SR,2017-18,G,Green Bay,Horizon,33,1130,201,454,.443,148,316,53,138,.384,147,177,.831,69,153,222,110,43,4,88,85,602
917,Andrew Warren,SR,2010-11,G,Bradley,MVC,32,1173,196,473,.414,120,278,76,195,.390,134,156,.859,38,137,175,59,54,10,57,90,602
918,Chris Warren,JR,2009-10,G,Mississippi,SEC,35,1152,192,451,.426,81,176,111,275,.404,107,131,.817,6,63,69,124,37,5,79,57,602
919,Antwan Carter,SR,2011-12,C,Longwood,Ind,31,1055,245,480,.510,222,405,23,75,.307,88,123,.715,78,207,285,41,30,27,72,98,601
920,Ian Clark,SR,2012-13,G,Belmont,OVC,33,1102,217,400,.543,115,178,102,222,.459,65,78,.833,12,96,108,79,53,8,88,64,601
921,De'Aaron Fox,FR,2016-17,G,Kentucky,SEC,36,1064,214,447,.479,197,378,17,69,.246,156,212,.736,21,122,143,165,53,7,87,90,601
922,Marcus Georges-Hunt,SR,2015-16,F,Georgia Tech,ACC,36,1167,178,392,.454,138,275,40,117,.342,205,249,.823,32,90,122,119,31,16,73,94,601
923,Justin Gray,SR,2005-06,G,Wake Forest,ACC,33,1156,180,490,.367,85,227,95,263,.361,146,175,.834,17,103,120,141,33,4,111,82,601
924,Draymond Green,SR,2011-12,F,Michigan State,Big Ten,37,1229,212,472,.449,160,338,52,134,.388,125,173,.723,79,315,394,141,54,35,112,105,601
925,Stephan Hicks,JR,2013-14,G,Cal State Northridge,Big West,35,1198,206,397,.519,196,364,10,33,.303,179,218,.821,73,164,237,37,47,10,55,86,601
926,Aaron Nixon,SR,2006-07,G,Cal State Long Beach,Big West,32,1055,198,479,.413,117,272,81,207,.391,124,166,.747,36,120,156,100,43,10,87,84,601
927,James Sinclair,SR,2014-15,G,Western Carolina,Southern,31,1180,214,532,.402,163,370,51,162,.315,122,159,.767,58,129,187,90,67,14,76,65,601
930,Jalan West,SO,2013-14,G,Northwestern State,Southland,31,1021,184,397,.463,114,226,70,171,.409,163,186,.876,14,111,125,197,78,8,84,75,601
931,Da'Sean Butler,JR,2008-09,F,West Virginia,Big East,35,1160,212,494,.429,150,317,62,177,.350,114,150,.760,76,132,208,60,45,10,81,88,600
932,Dionte Christmas,SO,2006-07,G,Temple,A-10,30,1029,192,412,.466,104,192,88,220,.400,128,147,.871,27,99,126,62,41,11,73,77,600
933,Jeremy Crouch,SR,2007-08,G,Bradley,MVC,38,1315,194,460,.422,76,164,118,296,.399,94,108,.870,17,121,138,122,57,3,87,83,600
934,Jared Dudley,JR,2005-06,F,Boston College,ACC,36,1340,198,401,.494,165,307,33,94,.351,171,241,.710,96,143,239,115,41,12,70,57,600
935,Troy Jackson,JR,2008-09,G,Alcorn State,SWAC,30,1114,193,455,.424,157,317,36,138,.261,178,230,.774,36,104,140,95,75,13,71,60,600
936,Robert Vaden,SR,2008-09,G,Alabama-Birmingham,CUSA,34,1240,207,522,.397,95,198,112,324,.346,74,100,.740,24,144,168,70,35,21,84,61,600
937,Amir Coffey,JR,2018-19,G,Minnesota,Big Ten,36,1267,198,454,.436,157,319,41,135,.304,162,219,.740,25,106,131,115,33,8,83,54,599
938,Trey Davis,SR,2015-16,G,Massachusetts,A-10,32,1087,184,470,.391,101,243,83,227,.366,148,169,.876,20,127,147,103,38,4,91,64,599
939,Keon Johnson,JR,2015-16,G,Winthrop,Big South,32,1100,178,395,.451,100,196,78,199,.392,165,198,.833,17,116,133,81,29,0,69,62,599
940,Cartier Martin,SR,2006-07,F,Kansas State,Big 12,35,963,197,428,.460,119,226,78,202,.386,127,159,.799,69,86,155,45,24,8,58,94,599
941,Kevin Palmer,JR,2008-09,G,Texas A&M-Corpus Christi,Southland,33,987,190,445,.427,136,271,54,174,.310,165,204,.809,56,114,170,94,86,18,111,63,599
942,Julius Randle,FR,2013-14,F,Kentucky,SEC,40,1233,196,391,.501,193,373,3,18,.167,204,289,.706,139,277,416,57,20,31,101,91,599
943,Marcus Thornton,JR,2013-14,G,William & Mary,CAA,32,1139,195,448,.435,102,217,93,231,.403,116,149,.779,7,66,73,90,34,7,76,57,599
944,Kevin Anderson,SO,2008-09,G,Richmond,A-10,36,1323,215,469,.458,181,351,34,118,.288,134,179,.749,29,74,103,101,48,2,84,81,598
945,Brandon Bowdry,SR,2010-11,F,Eastern Michigan,MAC,30,967,205,460,.446,177,379,28,81,.346,160,235,.681,71,213,284,55,32,9,97,74,598
946,Antonio Campbell,JR,2015-16,F,Ohio,MAC,35,1013,237,423,.560,194,306,43,117,.368,81,111,.730,74,283,357,23,23,63,44,111,598
947,Quinn Cook,SR,2014-15,G,Duke,ACC,39,1396,199,439,.453,97,181,102,258,.395,98,110,.891,15,116,131,103,39,1,47,76,598
948,Eric Eaves,JR,2015-16,G,South Carolina State,MEAC,34,961,196,376,.521,170,304,26,72,.361,180,236,.763,26,69,95,66,27,8,79,69,598
949,Kay Felder,SO,2014-15,G,Oakland,Horizon,33,1272,183,434,.422,136,295,47,139,.338,185,224,.826,25,133,158,252,66,8,137,83,598
952,Tre'Shaun Fletcher,SR,2017-18,G,Toledo,MAC,33,1087,205,443,.463,156,303,49,140,.350,139,195,.713,59,205,264,142,27,7,79,75,598
953,Isaiah Johnson,SR,2016-17,C,Akron,MAC,36,1076,223,357,.625,223,355,0,2,.000,152,259,.587,103,154,257,103,17,33,84,95,598
954,Christian Lutete,JR,2018-19,G,Massachusetts-Lowell,AEC,32,1085,213,399,.534,143,222,70,177,.395,102,142,.718,42,202,244,45,22,3,80,61,598
955,Denzel Mahoney,SO,2017-18,G,Southeast Missouri State,OVC,31,970,176,380,.463,112,225,64,155,.413,182,218,.835,45,113,158,39,28,5,51,91,598
956,Brandon Paul,SR,2012-13,G,Illinois,Big Ten,36,1153,184,459,.401,106,219,78,240,.325,152,206,.738,22,135,157,98,44,23,96,86,598
957,Courtney Pigram,SR,2008-09,G,East Tennessee State,A-Sun,34,1183,214,550,.389,138,317,76,233,.326,94,131,.718,24,92,116,138,58,6,113,70,598
958,Juwan Staten,JR,2013-14,G,West Virginia,Big 12,33,1231,205,423,.485,199,408,6,15,.400,182,253,.719,28,158,186,193,41,3,69,52,598
959,Travis Trice,SR,2014-15,G,Michigan State,Big Ten,39,1309,195,491,.397,105,247,90,244,.369,118,165,.715,18,105,123,197,40,6,69,70,598
960,Allonzo Trier,JR,2017-18,G,Arizona,Pac-12,33,1124,184,368,.500,114,184,70,184,.380,160,185,.865,11,89,100,107,21,11,70,57,598
961,Gary Wilkinson,SR,2008-09,F,Utah State,WAC,35,1122,213,367,.580,207,348,6,19,.316,166,201,.826,59,179,238,44,16,13,54,64,598
962,Solomon Bozeman,SR,2010-11,G,Little Rock,Sun Belt,36,1100,153,353,.433,88,211,65,142,.458,226,280,.807,16,60,76,99,25,2,92,82,597
963,Jared Brownridge,SR,2016-17,G,Santa Clara,WCC,33,1223,190,464,.409,84,177,106,287,.369,111,137,.810,9,80,89,93,32,4,55,69,597
964,Jimmy Gavin,SR,2015-16,G,Winthrop,Big South,32,1080,196,410,.478,102,181,94,229,.410,111,134,.828,16,78,94,95,26,2,66,57,597
965,Justin Hawkins,SR,2007-08,G,New Mexico State,WAC,33,1093,199,421,.473,157,316,42,105,.400,157,201,.781,84,154,238,78,32,16,92,89,597
966,Kevin Hervey,JR,2016-17,F,Texas-Arlington,Sun Belt,35,973,208,453,.459,140,255,68,198,.343,113,150,.753,49,249,298,74,43,14,66,65,597
967,Brock Motum,SR,2012-13,F,Washington State,Pac-12,32,1131,216,474,.456,171,340,45,134,.336,120,162,.741,61,140,201,35,20,26,77,74,597
968,Marc Eddy Norelia,JR,2015-16,F,Florida Gulf Coast,A-Sun,35,1148,234,429,.545,234,427,0,2,.000,129,192,.672,107,218,325,45,39,28,63,73,597
969,Jerome Robinson,SO,2016-17,F,Boston College,ACC,32,1089,213,503,.423,159,341,54,162,.333,117,162,.722,20,104,124,108,55,12,102,89,597
970,Derrick Rose,FR,2007-08,G,Memphis,CUSA,40,1168,208,436,.477,173,332,35,104,.337,146,205,.712,54,127,181,189,48,15,107,68,597
971,Rodrick Sikes,JR,2017-18,G,South Alabama,Sun Belt,32,998,178,421,.423,90,183,88,238,.370,153,197,.777,13,86,99,27,30,7,60,60,597
972,Will Whittington,SR,2006-07,G,Marist,MAAC,34,1272,179,456,.393,42,111,137,345,.397,102,128,.797,29,84,113,58,34,5,58,78,597
973,Andrew Wiggins,FR,2013-14,G,Kansas,Big 12,35,1148,189,422,.448,146,296,43,126,.341,176,227,.775,76,129,205,54,41,34,80,94,597
974,Davion Berry,SR,2013-14,G,Weber State,Big Sky,31,1031,163,351,.464,102,194,61,157,.389,209,254,.823,13,118,131,122,30,6,86,70,596
975,John Bryant,SR,2008-09,C,Santa Clara,WCC,33,1023,226,379,.596,226,378,0,1,.000,144,183,.787,140,327,467,35,17,84,82,84,596
976,Cameron Forte,SR,2015-16,F,Portland State,Big Sky,31,907,244,421,.580,243,419,1,2,.500,107,194,.552,106,182,288,80,30,15,99,65,596
977,Kyle Hines,SR,2007-08,F,North Carolina-Greensboro,Southern,31,1002,235,423,.556,234,415,1,8,.125,125,199,.628,122,159,281,43,56,95,103,86,596
978,Anthony Ireland,SR,2013-14,G,Loyola Marymount,WCC,32,1127,192,470,.409,150,336,42,134,.313,170,208,.817,39,80,119,173,53,3,90,76,596
979,Chavaughn Lewis,SR,2014-15,G,Marist,MAAC,29,1034,203,491,.413,162,349,41,142,.289,149,224,.665,26,129,155,78,67,22,104,71,596
980,Mike Muscala,JR,2011-12,F,Bucknell,Patriot,35,1047,193,384,.503,186,364,7,20,.350,203,238,.853,97,222,319,63,16,59,72,87,596
981,Josh Okogie,FR,2016-17,G,Georgia Tech,ACC,37,1141,194,428,.453,166,355,28,73,.384,180,241,.747,55,146,201,61,48,27,77,94,596
982,Marcus Paige,SO,2013-14,G,North Carolina,ACC,34,1211,191,434,.440,105,213,86,221,.389,128,146,.877,18,91,109,143,51,7,73,68,596
983,Jordan Price,JR,2015-16,G,La Salle,A-10,31,1170,195,500,.390,106,256,89,244,.365,117,163,.718,23,149,172,92,35,13,102,68,596
984,Andrew Rowsey,SO,2014-15,G,North Carolina-Asheville,Big South,31,1010,177,449,.394,75,182,102,267,.382,140,152,.921,19,67,86,89,44,2,70,67,596
985,Angelo Warner,JR,2013-14,G,Morehead State,OVC,34,1184,183,410,.446,127,238,56,172,.326,174,212,.821,54,109,163,103,67,10,89,96,596
986,Alan Williams,JR,2013-14,C,UC-Santa Barbara,Big West,28,872,224,420,.533,224,420,0,0,,148,216,.685,106,216,322,33,33,67,59,84,596
987,Ryan Wittman,SR,2009-10,F,Cornell,Ivy,34,1149,208,439,.474,99,184,109,255,.427,71,86,.826,17,118,135,62,36,12,57,63,596
988,Alex Francis,SR,2013-14,F,Bryant,NEC,32,1152,225,390,.577,225,390,0,0,,145,236,.614,85,177,262,46,37,26,97,93,595
989,Jonathan Gibson,SR,2009-10,G,New Mexico State,WAC,34,1109,197,441,.447,91,180,106,261,.406,95,112,.848,17,81,98,95,47,2,73,69,595
990,Tu Holloway,SR,2011-12,G,Xavier,A-10,34,1247,166,387,.429,121,257,45,130,.346,218,253,.862,14,110,124,166,52,3,102,73,595
991,Delroy James,SR,2010-11,F,Rhode Island,A-10,34,1160,213,487,.437,181,360,32,127,.252,137,186,.737,92,175,267,91,54,39,115,98,595
994,Justin Johnson,SR,2017-18,F,Western Kentucky,CUSA,38,1314,239,464,.515,192,351,47,113,.416,70,123,.569,84,276,360,48,27,28,57,69,595
995,Terrence Jones,FR,2010-11,F,Kentucky,SEC,38,1196,206,466,.442,180,387,26,79,.329,157,243,.646,92,244,336,60,43,72,75,91,595
996,Brian Laing,SR,2007-08,G,Seton Hall,Big East,32,1225,218,479,.455,181,380,37,99,.374,122,152,.803,60,161,221,63,50,16,78,90,595
997,Sa'eed Nelson,JR,2018-19,G,American,Patriot,30,1095,203,400,.508,177,315,26,85,.306,163,227,.718,29,138,167,155,71,16,109,69,595
998,Eric Paschall,SR,2018-19,F,Villanova,Big East,36,1301,195,436,.447,125,235,70,201,.348,135,181,.746,46,175,221,77,26,17,82,77,595
999,QJ Peterson,JR,2015-16,G,Virginia Military Institute,Southern,30,1006,189,467,.405,106,237,83,230,.361,134,148,.905,49,140,189,83,42,15,82,67,595
1000,A.J. Slaughter,SR,2009-10,G,Western Kentucky,Sun Belt,34,1240,184,442,.416,105,222,79,220,.359,148,179,.827,16,92,108,147,54,4,92,63,595
1001,Denzel Valentine,SR,2015-16,G,Michigan State,Big Ten,31,1022,205,444,.462,101,210,104,234,.444,81,95,.853,25,208,233,241,32,7,85,52,595
1002,Kori Babineaux,SR,2015-16,G,Jacksonville,A-Sun,32,1149,257,549,.468,248,516,9,33,.273,71,113,.628,22,133,155,123,31,5,90,75,594
1003,Roy Booker,SR,2005-06,G,Southeast Missouri State,OVC,27,964,178,504,.353,105,271,73,233,.313,165,200,.825,49,80,129,47,17,1,77,67,594
1004,Pat Calathes,SR,2007-08,G,Saint Joseph's,A-10,34,1143,189,422,.448,115,237,74,185,.400,142,172,.826,66,189,255,92,42,42,78,92,594
1005,Dikembe Dixson,FR,2015-16,F,Illinois-Chicago,Horizon,30,1102,192,520,.369,151,385,41,135,.304,169,256,.660,43,177,220,55,35,14,124,77,594
1006,Kelvin Lewis,JR,2008-09,G,Houston,CUSA,33,1218,195,473,.412,102,221,93,252,.369,111,133,.835,24,84,108,43,51,5,47,65,594
1007,P.J. Tucker,JR,2005-06,F,Texas,Big 12,37,1276,225,437,.515,223,434,2,3,.667,142,190,.747,105,248,353,106,66,13,115,105,594
1008,Corey Walden,SR,2014-15,G,Eastern Kentucky,OVC,32,1108,198,362,.547,147,222,51,140,.364,147,180,.817,27,100,127,123,99,5,71,79,594
1009,Dominic Waters,SR,2009-10,G,Portland State,Big Sky,32,1079,193,398,.485,123,233,70,165,.424,138,153,.902,9,64,73,151,25,1,113,82,594
1010,Cody Zeller,SO,2012-13,F,Indiana,Big Ten,36,1062,199,353,.564,199,351,0,2,.000,196,259,.757,101,188,289,47,37,45,81,80,594
1011,Vaughn Duggins,SR,2010-11,G,Wright State,Horizon,33,1160,202,452,.447,165,333,37,119,.311,152,185,.822,33,94,127,72,50,3,54,55,593
1012,Kellan Grady,FR,2017-18,G,Davidson,A-10,33,1163,219,437,.501,146,241,73,196,.372,82,102,.804,23,85,108,64,27,3,32,68,593
1013,Javonte Green,JR,2013-14,F,Radford,Big South,35,897,212,387,.548,200,352,12,35,.343,157,229,.686,81,204,285,37,68,21,56,97,593
1016,Matt Mobley,JR,2016-17,G,St. Bonaventure,A-10,32,1226,176,419,.420,90,192,86,227,.379,155,180,.861,16,171,187,82,50,10,74,78,593
1017,Keon Moore,SR,2014-15,G,Winthrop,Big South,32,1058,188,424,.443,87,190,101,234,.432,116,135,.859,25,141,166,56,44,8,59,62,593
1018,Brandon Polk,SR,2005-06,F,Butler,Horizon,33,1041,232,403,.576,231,399,1,4,.250,128,204,.627,65,89,154,42,21,50,62,80,593
1019,Dewayne Russell,SR,2016-17,G,Grand Canyon,WAC,28,1072,197,492,.400,145,361,52,131,.397,147,194,.758,13,92,105,151,41,4,75,60,593
1020,Sidney Sanders,SR,2013-14,G,Fairleigh Dickinson,NEC,31,1041,202,486,.416,171,397,31,89,.348,158,210,.752,32,85,117,181,67,0,78,84,593
1021,Ahmad Thomas,JR,2016-17,G,North Carolina-Asheville,Big South,33,1088,243,447,.544,206,366,37,81,.457,70,123,.569,46,172,218,77,99,15,69,85,593
1022,Isaiah Thomas,SO,2009-10,G,Washington,Pac-10,35,1089,186,448,.415,121,249,65,199,.327,156,213,.732,20,117,137,111,37,3,83,67,593
1023,Tristan Thompson,SR,2010-11,G,North Texas,Sun Belt,33,1056,158,344,.459,92,186,66,158,.418,211,253,.834,16,89,105,59,24,4,74,62,593
1024,Jimmy Baron,SR,2008-09,G,Rhode Island,A-10,34,1106,200,430,.465,82,170,118,260,.454,74,83,.892,33,58,91,65,23,4,44,52,592
1025,Jerryd Bayless,FR,2007-08,G,Arizona,Pac-10,30,1072,173,378,.458,114,233,59,145,.407,187,223,.839,13,69,82,121,29,3,89,66,592
1026,Ryan Boatright,SR,2014-15,G,Connecticut,AAC,34,1216,182,430,.423,96,221,86,209,.411,142,167,.850,15,124,139,129,46,8,81,64,592
1027,Calvin Cage,SR,2005-06,G,Buffalo,MAC,32,1138,178,440,.405,89,223,89,217,.410,147,177,.831,18,79,97,80,43,1,96,69,592
1028,Bakari Copeland,SR,2016-17,F,Maryland-Eastern Shore,MEAC,34,1028,194,417,.465,154,322,40,95,.421,164,213,.770,39,169,208,56,19,7,78,85,592
1029,Randy Culpepper,JR,2009-10,G,Texas-El Paso,CUSA,33,1100,201,426,.472,119,203,82,223,.368,108,147,.735,24,68,92,63,59,9,58,62,592
1030,Zabian Dowdell,SR,2006-07,G,Virginia Tech,ACC,34,1148,197,426,.462,153,312,44,114,.386,154,191,.806,27,95,122,106,71,7,67,52,592
1031,Olivier Hanlan,SO,2013-14,G,Boston College,ACC,32,1160,173,387,.447,112,211,61,176,.347,185,228,.811,12,98,110,93,25,2,78,82,592
1032,Justin James,SO,2016-17,G,Wyoming,MWC,37,974,198,429,.462,149,312,49,117,.419,147,193,.762,43,141,184,80,29,20,92,95,592
1033,Vasa Pusica,JR,2017-18,G,Northeastern,CAA,33,1132,189,375,.504,113,197,76,178,.427,138,171,.807,9,111,120,168,36,4,113,74,592
1034,Dar Tucker,SO,2008-09,F,DePaul,Big East,32,1038,203,520,.390,145,316,58,204,.284,128,182,.703,50,123,173,48,45,12,90,71,592
1035,A.D. Vassallo,JR,2007-08,G,Virginia Tech,ACC,35,1201,206,465,.443,121,250,85,215,.395,95,125,.760,27,133,160,77,24,16,87,78,592
1038,Wink Adams,JR,2007-08,G,Nevada-Las Vegas,MWC,35,1092,187,443,.422,121,258,66,185,.357,151,178,.848,19,120,139,107,52,1,64,63,591
1039,Kentavious Caldwell-Pope,SO,2012-13,G,Georgia,SEC,32,1086,186,430,.433,102,205,84,225,.373,135,169,.799,37,189,226,58,65,17,64,70,591
1040,Cleanthony Early,SR,2013-14,F,Wichita State,MVC,36,986,187,386,.484,121,209,66,177,.373,151,179,.844,48,165,213,27,29,28,70,83,591
1041,Trey Freeman,JR,2014-15,G,Old Dominion,CUSA,35,1131,221,502,.440,174,370,47,132,.356,102,140,.729,20,132,152,125,46,4,59,54,591
1042,A.J. Graves,JR,2006-07,G,Butler,Horizon,35,1247,174,464,.375,76,187,98,277,.354,145,153,.948,14,66,80,85,51,2,59,55,591
1043,Velton Jones,JR,2011-12,G,Robert Morris,NEC,37,1096,162,457,.354,102,271,60,186,.323,207,270,.767,29,75,104,167,68,1,99,107,591
1044,Gabe Levin,SR,2017-18,F,Cal State Long Beach,Big West,32,991,194,426,.455,171,365,23,61,.377,180,221,.814,68,164,232,52,32,22,93,85,591
1045,Maodo Lo,SR,2015-16,G,Columbia,Ivy,35,1144,212,467,.454,116,210,96,257,.374,71,101,.703,27,108,135,100,78,14,75,73,591
1046,Andrew Nicholson,SR,2011-12,F,St. Bonaventure,A-10,32,962,220,385,.571,197,332,23,53,.434,128,165,.776,83,186,269,33,21,63,80,90,591
1047,Norman Powell,SR,2014-15,G,UCLA,Pac-12,36,1244,213,467,.456,175,348,38,119,.319,127,169,.751,21,148,169,75,66,16,80,91,591
1048,Allan Ray,SR,2005-06,G,Villanova,Big East,32,1026,186,478,.389,79,190,107,288,.372,112,126,.889,19,96,115,56,37,3,59,77,591
1049,Breein Tyree,JR,2018-19,G,Mississippi,SEC,33,1117,197,429,.459,128,245,69,184,.375,128,154,.831,11,86,97,92,32,14,80,65,591
1050,David Walker,SR,2015-16,G,Northeastern,CAA,33,1263,179,399,.449,82,164,97,235,.413,136,157,.866,19,108,127,131,47,12,62,30,591
1051,Casper Ware,SR,2011-12,G,Cal State Long Beach,Big West,34,1146,189,471,.401,95,207,94,264,.356,119,150,.793,13,69,82,114,46,3,81,64,591
1052,Barry Brown,JR,2017-18,G,Kansas State,Big 12,37,1285,203,453,.448,161,321,42,132,.318,142,184,.772,22,94,116,120,67,5,95,81,590
1053,Kenneth Faried,JR,2009-10,F,Morehead State,OVC,35,1060,224,397,.564,223,393,1,4,.250,141,237,.595,148,308,456,19,56,67,84,115,590
1054,Ethan Happ,JR,2017-18,F,Wisconsin,Big Ten,33,1017,242,458,.528,241,447,1,11,.091,105,191,.550,78,187,265,122,49,35,93,87,590
1055,Manny Harris,SO,2008-09,G,Michigan,Big Ten,35,1152,181,436,.415,129,277,52,159,.327,176,204,.863,62,175,237,154,43,18,110,72,590
1056,Charles Hinkle,SR,2011-12,F,American,Patriot,32,1098,175,431,.406,90,228,85,203,.419,155,185,.838,33,141,174,58,30,14,68,66,590
1057,Brandon Johnson,JR,2007-08,G,San Diego,WCC,35,1230,207,496,.417,127,282,80,214,.374,96,153,.627,22,123,145,124,77,2,116,78,590
1060,Tywain McKee,SR,2008-09,G,Coppin State,MEAC,32,1177,194,480,.404,127,294,67,186,.360,135,167,.808,41,142,183,131,91,3,97,72,590
1061,Stuckey Mosley,JR,2017-18,G,James Madison,CAA,32,1140,199,482,.413,114,251,85,231,.368,107,127,.843,24,119,143,68,46,7,63,80,590
1062,Patrick Richard,SR,2011-12,G,McNeese State,Southland,33,1204,190,473,.402,140,294,50,179,.279,160,208,.769,63,147,210,109,43,22,80,78,590
1063,Josh Robinson,JR,2016-17,G,Austin Peay,OVC,29,1062,187,426,.439,116,232,71,194,.366,145,176,.824,10,76,86,101,28,4,74,55,590
1064,Tyler Smith,JR,2008-09,F,Tennessee,SEC,34,1107,196,446,.439,168,350,28,96,.292,170,222,.766,70,126,196,114,25,7,70,72,590
1065,Brad Waldow,SR,2014-15,F,Saint Mary's (CA),WCC,31,1068,235,421,.558,235,421,0,0,,120,182,.659,90,193,283,69,16,23,66,73,590
1066,Charles Williams,JR,2018-19,G,Howard,MEAC,33,1027,209,469,.446,149,308,60,161,.373,112,131,.855,22,68,90,23,22,9,49,55,590
1067,Keena Young,SR,2006-07,F,Brigham Young,MWC,34,984,236,435,.543,236,435,0,0,,118,147,.803,79,144,223,50,15,5,75,81,590
1068,Ky Bowman,JR,2018-19,G,Boston College,ACC,31,1220,196,485,.404,117,274,79,211,.374,118,155,.761,26,207,233,125,43,18,90,82,589
1069,Ronnie Brewer,JR,2005-06,G,Arkansas,SEC,32,1112,197,447,.441,146,296,51,151,.338,144,192,.750,39,115,154,104,83,15,70,46,589
1070,Robert Covington,JR,2011-12,F,Tennessee State,OVC,33,1028,212,403,.526,147,258,65,145,.448,100,129,.775,95,165,260,43,51,45,77,97,589
1071,Ethan Happ,SR,2018-19,F,Wisconsin,Big Ten,34,1088,257,485,.530,257,480,0,5,.000,75,161,.466,77,265,342,153,38,44,104,87,589
1072,Ben McLemore,FR,2012-13,G,Kansas,Big 12,37,1191,198,400,.495,125,226,73,174,.420,120,138,.870,47,145,192,73,37,25,77,69,589
1073,Elijah Minnie,JR,2017-18,F,Eastern Michigan,MAC,35,1098,210,464,.453,132,233,78,231,.338,91,108,.843,49,165,214,39,63,66,81,68,589
1074,Johnathan Motley,JR,2016-17,F,Baylor,Big 12,34,1036,226,434,.521,217,401,9,33,.273,128,183,.699,126,209,335,79,12,37,100,104,589
1075,Rian Pearson,SO,2011-12,G,Toledo,MAC,36,1161,231,486,.475,223,455,8,31,.258,119,175,.680,106,194,300,70,56,13,93,84,589
1076,QJ Peterson,SR,2016-17,G,Virginia Military Institute,Southern,30,951,200,464,.431,122,252,78,212,.368,111,156,.712,51,143,194,73,47,2,77,61,589
1077,LaMarcus Reed,SR,2011-12,F,Texas-Arlington,Southland,33,1009,179,388,.461,115,222,64,166,.386,167,209,.799,22,101,123,55,33,12,87,63,589
1078,Rashawn Rembert,JR,2013-14,G,East Tennessee State,A-Sun,35,1262,182,405,.449,74,151,108,254,.425,117,139,.842,29,78,107,61,43,12,54,49,589
1079,Victor Sanders,SR,2017-18,G,Idaho,Big Sky,31,953,182,398,.457,101,189,81,209,.388,144,185,.778,18,89,107,102,32,15,97,78,589
1080,Derrick Walton,SR,2016-17,G,Michigan,Big Ten,38,1323,171,392,.436,73,160,98,232,.422,149,170,.876,17,165,182,189,43,1,66,65,589
1081,Milan Acquaah,SO,2018-19,G,California Baptist,WAC,31,995,191,460,.415,115,257,76,203,.374,130,153,.850,21,135,156,104,50,4,102,82,588
1082,Brian Beard,SR,2018-19,G,Florida International,CUSA,34,1088,185,469,.394,131,282,54,187,.289,164,230,.713,21,92,113,203,100,2,118,73,588
1083,Kenny Boynton,JR,2011-12,G,Florida,SEC,37,1169,187,425,.440,77,155,110,270,.407,104,138,.754,20,77,97,100,28,1,52,39,588
1084,Joevan Catron,SR,2010-11,F,Oregon,Pac-10,37,1023,195,416,.469,175,347,20,69,.290,178,248,.718,88,159,247,56,42,12,88,95,588
1085,Jon Davis,SO,2016-17,G,Charlotte,CUSA,30,1056,196,407,.482,147,278,49,129,.380,147,188,.782,9,94,103,126,33,8,94,48,588
1086,Devan Downey,SO,2007-08,G,South Carolina,SEC,32,1197,218,515,.423,165,364,53,151,.351,99,135,.733,20,83,103,172,103,6,87,65,588
1087,Tyler Hooker,JR,2018-19,G,Kennesaw State,A-Sun,31,1123,200,509,.393,165,384,35,125,.280,153,184,.832,24,123,147,92,47,7,88,69,588
1088,Daniel Mullings,JR,2013-14,G,New Mexico State,WAC,35,1173,201,431,.466,183,366,18,65,.277,168,231,.727,50,123,173,123,65,16,90,87,588
1089,Kevin Olekaibe,SO,2011-12,G,Fresno State,WAC,33,1205,189,508,.372,97,236,92,272,.338,118,148,.797,21,84,105,39,44,4,50,61,588
1090,J.R. Reynolds,SR,2006-07,G,Virginia,ACC,32,1031,181,422,.429,119,254,62,168,.369,164,197,.832,32,96,128,117,28,3,97,86,588
1091,Sam Sessoms,FR,2018-19,G,Binghamton,AEC,33,1132,224,500,.448,154,309,70,191,.366,70,106,.660,24,85,109,115,37,2,142,71,588
1092,Trey Sumler,JR,2012-13,G,Western Carolina,Southern,32,1207,197,450,.438,143,301,54,149,.362,140,168,.833,31,113,144,114,61,2,115,70,588
1093,Alando Tucker,JR,2005-06,G,Wisconsin,Big Ten,31,1034,222,490,.453,205,422,17,68,.250,127,233,.545,75,102,177,53,19,7,63,40,588
1094,Kwame Vaughn,SR,2012-13,G,Cal State Fullerton,Big West,32,1116,179,399,.449,129,265,50,134,.373,180,215,.837,22,126,148,119,49,7,98,84,588
1095,Justin Black,SR,2013-14,G,Morgan State,MEAC,31,1052,200,442,.452,148,265,52,177,.294,135,225,.600,54,105,159,87,56,2,98,91,587
1096,David Collins,SO,2018-19,G,South Florida,AAC,37,1243,167,418,.400,120,268,47,150,.313,206,293,.703,23,116,139,115,76,11,117,117,587
1097,James Daniel,FR,2013-14,G,Howard,MEAC,28,891,155,421,.368,64,190,91,231,.394,186,233,.798,15,54,69,44,37,1,93,64,587
1098,Shy Ely,SR,2008-09,F,Evansville,MVC,31,1087,204,444,.459,191,395,13,49,.265,166,216,.769,33,147,180,53,24,9,66,64,587
1099,Tyler Hansbrough,FR,2005-06,F,North Carolina,ACC,31,943,199,349,.570,197,345,2,4,.500,187,253,.739,111,132,243,40,38,23,77,88,587
1102,Cory Higgins,JR,2009-10,G,Colorado,Big 12,31,1036,193,382,.505,161,292,32,90,.356,169,203,.833,20,100,120,73,60,11,72,77,587
1103,Reggie Holmes,JR,2008-09,G,Morgan State,MEAC,35,1094,178,479,.372,79,211,99,268,.369,132,178,.742,67,126,193,19,43,11,47,90,587
1104,Tramaine Isabell,JR,2017-18,G,Drexel,CAA,28,963,202,426,.474,152,279,50,147,.340,133,174,.764,30,180,210,96,34,0,80,52,587
1105,ShawnDre' Jones,SR,2016-17,G,Richmond,A-10,35,1269,198,428,.463,129,252,69,176,.392,122,149,.819,12,61,73,136,32,1,68,76,587
1106,Zach Lofton,JR,2016-17,G,Texas Southern,SWAC,35,1140,185,440,.420,152,312,33,128,.258,184,234,.786,30,105,135,86,47,10,81,99,587
1107,Daryl Macon,SR,2017-18,G,Arkansas,SEC,35,1082,174,389,.447,89,187,85,202,.421,154,176,.875,13,88,101,138,36,2,63,62,587
1108,Jalen Riley,SR,2014-15,G,East Tennessee State,Southern,29,798,165,426,.387,85,212,80,214,.374,177,214,.827,12,54,66,77,49,2,82,95,587
1109,B.J. Stith,SR,2018-19,G,Old Dominion,CUSA,35,1206,207,505,.410,134,307,73,198,.369,100,118,.847,50,213,263,36,32,9,62,64,587
1110,Isaiah Thomas,JR,2010-11,G,Washington,Pac-10,35,1115,188,422,.445,128,250,60,172,.349,151,210,.719,26,97,123,213,47,2,104,75,587
1111,Marc Trasolini,SR,2012-13,F,Santa Clara,WCC,38,1173,230,418,.550,216,377,14,41,.341,113,156,.724,100,182,282,34,32,54,64,87,587
1112,Isiah Umipig,JR,2013-14,G,Seattle,WAC,30,993,185,475,.389,79,188,106,287,.369,111,134,.828,19,63,82,107,32,1,98,78,587
1113,C.J. Wilcox,SR,2013-14,G,Washington,Pac-12,32,1116,197,435,.453,107,205,90,230,.391,103,118,.873,22,97,119,81,32,32,54,75,587
1114,Frank Bartley,SR,2017-18,G,Louisiana,Sun Belt,33,1014,179,413,.433,92,186,87,227,.383,141,164,.860,21,97,118,65,45,3,63,65,586
1115,T.J. Cline,JR,2015-16,F,Richmond,A-10,32,961,227,407,.558,183,288,44,119,.370,88,137,.642,38,129,167,122,21,3,72,87,586
1116,Guillermo Diaz,JR,2005-06,G,Miami (FL),ACC,34,1196,194,467,.415,116,253,78,214,.364,120,152,.789,17,83,100,97,39,7,67,59,586
1117,Jerome Dyson,SR,2009-10,G,Connecticut,Big East,34,1143,195,499,.391,155,362,40,137,.292,156,218,.716,33,113,146,144,44,21,132,95,586
1118,Kyle Guy,JR,2018-19,G,Virginia,ACC,38,1345,198,441,.449,78,159,120,282,.426,70,84,.833,27,144,171,78,26,2,53,39,586
1119,Gary Harris,SO,2013-14,G,Michigan State,Big Ten,35,1131,195,455,.429,114,225,81,230,.352,115,142,.810,37,103,140,94,63,15,60,73,586
1120,Corey Hawkins,SR,2014-15,G,UC-Davis,Big West,28,934,188,374,.503,107,208,81,166,.488,129,157,.822,19,119,138,94,39,6,84,53,586
1121,Ray Lee,SO,2014-15,G,Eastern Michigan,MAC,35,981,190,429,.443,120,235,70,194,.361,136,171,.795,25,42,67,54,50,7,101,78,586
1124,LeRoy Nobles,SR,2010-11,G,IUPUI,Summit,32,1144,180,380,.474,115,205,65,175,.371,161,196,.821,41,87,128,41,27,2,66,64,586
1125,Ronshad Shabazz,SR,2018-19,G,Appalachian State,Sun Belt,32,1030,203,460,.441,124,250,79,210,.376,101,124,.815,19,86,105,75,25,2,72,49,586
1126,Lew Stallworth,SR,2018-19,G,The Citadel,Southern,29,968,221,419,.527,185,323,36,96,.375,108,146,.740,11,143,154,181,30,1,104,80,586
1127,Shannon Brown,JR,2005-06,G,Michigan State,Big Ten,34,1196,202,433,.467,138,269,64,164,.390,117,141,.830,38,112,150,93,50,5,85,78,585
1128,Jeremy Chappell,SR,2008-09,G,Robert Morris,NEC,35,1143,213,453,.470,129,241,84,212,.396,75,89,.843,53,168,221,112,86,22,101,82,585
1129,Nick Emery,FR,2015-16,G,Brigham Young,WCC,36,1132,203,478,.425,106,225,97,253,.383,82,96,.854,18,108,126,91,52,4,53,100,585
1130,Nate Funk,SR,2006-07,G,Creighton,MVC,33,1138,202,423,.478,147,272,55,151,.364,126,146,.863,25,90,115,99,41,3,71,48,585
1131,Ramon Galloway,SR,2012-13,G,La Salle,A-10,34,1133,193,461,.419,99,233,94,228,.412,105,127,.827,25,132,157,127,65,17,107,81,585
1132,Juan'ya Green,FR,2011-12,G,Niagara,MAAC,33,1229,188,465,.404,127,285,61,180,.339,148,185,.800,24,82,106,147,63,11,115,75,585
1133,Erik McCree,SR,2016-17,F,Louisiana Tech,CUSA,33,1046,202,424,.476,148,275,54,149,.362,127,165,.770,53,242,295,44,15,15,84,53,585
1134,Casper Ware,JR,2010-11,G,Cal State Long Beach,Big West,34,1187,172,408,.422,97,211,75,197,.381,166,205,.810,16,68,84,150,56,6,102,88,585
1135,Billy Baron,JR,2012-13,G,Canisius,MAAC,34,1183,189,431,.439,123,258,66,173,.382,140,170,.824,22,119,141,171,35,0,95,45,584
1136,Kevin Bell,SR,2007-08,G,Fresno State,WAC,32,1199,202,460,.439,170,378,32,82,.390,148,212,.698,13,91,104,187,39,2,106,58,584
1137,Jaron Blossomgame,SR,2016-17,F,Clemson,ACC,33,1133,220,441,.499,196,347,24,94,.255,120,168,.714,59,148,207,51,27,30,56,53,584
1138,Markel Brown,SR,2013-14,G,Oklahoma State,Big 12,34,1201,190,402,.473,135,257,55,145,.379,149,194,.768,36,143,179,99,34,35,55,86,584
1139,Hayden Dalton,SR,2017-18,F,Wyoming,MWC,33,1098,190,415,.458,105,204,85,211,.403,119,142,.838,46,213,259,86,31,16,82,90,584
1140,Jamont Gordon,JR,2007-08,G,Mississippi State,SEC,34,1178,193,465,.415,133,277,60,188,.319,138,199,.693,40,184,224,168,38,21,138,88,584
1141,Juwan Howard,JR,2013-14,F,Detroit Mercy,Horizon,32,1105,216,515,.419,163,361,53,154,.344,99,118,.839,57,113,170,71,31,15,62,75,584
1142,Quin Humphrey,SR,2006-07,G,Youngstown State,Horizon,31,1105,189,437,.432,124,265,65,172,.378,141,182,.775,47,174,221,92,42,10,85,46,584
1143,Darius Johnson-Odom,JR,2010-11,G,Marquette,Big East,37,1109,196,453,.433,125,258,71,195,.364,121,171,.708,18,94,112,88,31,7,75,92,584
1146,Nick Perkins,JR,2017-18,F,Buffalo,MAC,36,990,211,445,.474,175,332,36,113,.319,126,172,.733,80,137,217,28,11,23,72,85,584
1147,Ahmaad Rorie,JR,2017-18,G,Montana,Big Sky,34,1218,206,488,.422,147,314,59,174,.339,113,133,.850,32,101,133,125,42,5,67,64,584
1148,Jeff Teague,SO,2008-09,G,Wake Forest,ACC,31,991,180,371,.485,135,269,45,102,.441,179,219,.817,15,87,102,110,58,20,104,68,584
1149,Alec Wintering,JR,2015-16,G,Portland,WCC,32,1010,182,410,.444,139,302,43,108,.398,177,227,.780,18,88,106,158,49,1,102,87,584
1150,Tristan Blackwood,JR,2006-07,G,Central Connecticut State,NEC,34,1243,182,464,.392,60,150,122,314,.389,97,105,.924,29,56,85,140,42,1,105,65,583
1151,Chase Budinger,SO,2007-08,F,Arizona,Pac-10,34,1200,204,457,.446,131,265,73,192,.380,102,142,.718,34,150,184,99,38,6,80,66,583
1152,E.J. Crawford,JR,2018-19,G,Iona,MAAC,33,1176,205,407,.504,152,267,53,140,.379,120,147,.816,37,130,167,61,23,7,61,72,583
1153,Robert Franks,SR,2018-19,F,Washington State,Pac-12,27,930,201,408,.493,126,220,75,188,.399,106,125,.848,37,158,195,70,18,19,87,68,583
1154,Fred Sims,SO,2016-17,G,Chicago State,WAC,31,1069,210,582,.361,139,356,71,226,.314,92,114,.807,22,122,144,45,32,9,69,51,583
1155,Curtis Stinson,JR,2005-06,G,Iowa State,Big 12,30,1069,224,492,.455,182,368,42,124,.339,93,140,.664,58,97,155,166,73,0,103,87,583
1156,Tyler Zeller,JR,2010-11,F,North Carolina,ACC,37,1041,211,384,.549,211,384,0,0,,161,212,.759,107,161,268,23,27,45,50,100,583
1157,Jamel Artis,SR,2016-17,F,Pittsburgh,ACC,32,1097,196,413,.475,122,224,74,189,.392,116,158,.734,40,116,156,106,13,9,83,61,582
1158,Miles Bridges,SO,2017-18,F,Michigan State,Big Ten,34,1067,209,457,.457,138,262,71,195,.364,93,109,.853,43,194,237,92,21,26,67,53,582
1159,Elijah Brown,JR,2016-17,G,New Mexico,MWC,31,1000,166,438,.379,98,232,68,206,.330,182,220,.827,13,148,161,95,41,4,95,63,582
1160,Jimmy Butler,SR,2010-11,G,Marquette,Big East,37,1282,187,382,.490,167,324,20,58,.345,188,240,.783,90,135,225,86,53,13,54,49,582
1161,Noah Dahlman,JR,2009-10,F,Wofford,Southern,35,1011,224,387,.579,224,386,0,1,.000,134,191,.702,115,104,219,24,30,15,38,70,582
1162,Johnny Dee,JR,2013-14,G,San Diego,WCC,35,1136,184,425,.433,90,200,94,225,.418,120,127,.945,9,88,97,49,38,0,47,57,582
1163,Darnell Edge,SR,2018-19,G,Fairleigh Dickinson,NEC,35,1295,190,402,.473,98,209,92,193,.477,110,123,.894,14,109,123,85,46,1,69,68,582
1164,Gary Flowers,SR,2010-11,F,Southern Mississippi,CUSA,31,965,219,460,.476,169,337,50,123,.407,94,130,.723,78,162,240,33,33,44,76,83,582
1165,Tra Holder,SR,2017-18,G,Arizona State,Pac-12,32,1124,177,435,.407,108,248,69,187,.369,159,190,.837,30,104,134,110,42,1,78,64,582
1168,Kimbal MacKenzie,SR,2018-19,G,Bucknell,Patriot,33,1133,178,419,.425,95,198,83,221,.376,143,167,.856,24,68,92,100,25,1,58,56,582
1169,Jaylen Nowell,SO,2018-19,G,Washington,Pac-12,36,1240,218,434,.502,167,318,51,116,.440,95,122,.779,35,155,190,112,46,9,106,81,582
1170,Wesley Person,SR,2017-18,G,Troy,Sun Belt,33,1123,174,416,.418,77,160,97,256,.379,137,167,.820,21,75,96,59,24,1,61,63,582
1171,Augustine Rubit,JR,2012-13,F,South Alabama,Sun Belt,30,995,192,400,.480,192,395,0,5,.000,198,249,.795,132,183,315,34,21,36,74,63,582
1172,Manny Ubilla,SR,2007-08,G,Fairleigh Dickinson,NEC,28,1074,178,409,.435,85,192,93,217,.429,133,163,.816,17,118,135,136,41,9,105,62,582
1173,Nikola Vucevic,JR,2010-11,F,Southern California,Pac-10,34,1187,215,426,.505,186,343,29,83,.349,123,163,.755,97,253,350,54,18,47,58,96,582
1174,Jaylin Walker,SR,2018-19,G,Kent State,MAC,27,971,181,468,.387,88,225,93,243,.383,127,158,.804,46,107,153,57,36,3,72,35,582
1175,Giordan Watson,JR,2006-07,G,Central Michigan,MAC,31,1071,186,455,.409,122,289,64,166,.386,146,177,.825,18,77,95,129,51,6,118,76,582
1176,Rashad Whack,SR,2013-14,G,Mount St. Mary's,NEC,33,1098,182,437,.416,99,210,83,227,.366,135,171,.789,30,113,143,43,54,13,70,77,582
1177,Denzel Bowles,JR,2010-11,F,James Madison,CAA,33,1061,226,389,.581,226,389,0,0,,129,181,.713,83,207,290,71,20,53,110,87,581
1178,Evan Bradds,SR,2016-17,F,Belmont,OVC,29,925,233,374,.623,229,365,4,9,.444,111,148,.750,56,189,245,68,13,6,83,74,581
1179,Ahmad Caver,SR,2018-19,G,Old Dominion,CUSA,35,1316,196,514,.381,126,283,70,231,.303,119,172,.692,18,132,150,193,50,9,76,69,581
1180,C.J. Fair,JR,2012-13,F,Syracuse,Big East,40,1394,217,462,.470,187,398,30,64,.469,117,155,.755,83,192,275,29,44,42,63,63,581
1181,Daniel Horton,SR,2005-06,G,Michigan,Big Ten,33,1126,187,418,.447,116,238,71,180,.394,136,151,.901,10,74,84,174,64,11,115,75,581
1182,Ty Lawson,JR,2008-09,G,North Carolina,ACC,35,1048,182,342,.532,131,234,51,108,.472,166,208,.798,23,81,104,230,75,5,66,59,581
1183,Tanner Leissner,SR,2017-18,F,New Hampshire,AEC,31,1111,195,432,.451,157,317,38,115,.330,153,199,.769,81,133,214,62,15,10,50,65,581
1184,Brynton Lemar,SR,2016-17,G,UC-Davis,Big West,36,1189,179,432,.414,99,224,80,208,.385,143,185,.773,22,98,120,95,28,4,64,74,581
1185,Doug McDermott,FR,2010-11,F,Creighton,MVC,39,1133,220,419,.525,173,303,47,116,.405,94,126,.746,82,198,280,45,11,4,87,81,581
1186,Kyle Randall,SR,2012-13,G,Central Michigan,MAC,31,1068,175,414,.423,109,246,66,168,.393,165,193,.855,23,86,109,79,25,1,89,42,581
1187,Ryan Rossiter,SR,2010-11,F,Siena,MAAC,31,1158,206,440,.468,203,420,3,20,.150,166,211,.787,121,287,408,47,27,42,72,79,581
1188,Jeffery Taylor,SR,2011-12,F,Vanderbilt,SEC,36,1157,210,426,.493,144,270,66,156,.423,95,157,.605,77,123,200,62,46,16,79,67,581
1189,A.J. Abrams,SR,2008-09,G,Texas,Big 12,35,1319,193,484,.399,88,219,105,265,.396,89,105,.848,14,64,78,46,47,4,48,69,580
1190,Jaron Blossomgame,JR,2015-16,F,Clemson,ACC,31,1060,201,392,.513,156,291,45,101,.446,133,170,.782,55,152,207,47,23,41,55,63,580
1191,Demetrius Dyson,JR,2016-17,G,Samford,Southern,36,1110,195,394,.495,109,207,86,187,.460,104,143,.727,36,136,172,40,24,6,79,85,580
1192,Juan'ya Green,JR,2014-15,G,Hofstra,CAA,34,1238,158,414,.382,97,232,61,182,.335,203,246,.825,18,128,146,220,48,9,86,73,580
1193,Jahmal McMurray,SR,2018-19,G,Southern Methodist,AAC,32,1046,206,459,.449,105,203,101,256,.395,67,81,.827,5,70,75,84,23,4,55,69,580
1194,Retin Obasohan,SR,2015-16,G,Alabama,SEC,33,1067,193,410,.471,145,281,48,129,.372,146,209,.699,19,107,126,87,45,10,82,83,580
1195,Tyrese Rice,SO,2006-07,G,Boston College,ACC,33,1208,185,404,.458,126,221,59,183,.322,151,190,.795,30,83,113,178,40,10,110,56,580
1196,Adrian Rodgers,SR,2015-16,G,Southern,SWAC,35,1131,201,492,.409,121,274,80,218,.367,98,124,.790,35,153,188,47,37,4,58,62,580
1197,Dennis Smith,FR,2016-17,G,North Carolina State,ACC,32,1114,191,420,.455,136,267,55,153,.359,143,200,.715,26,120,146,197,62,14,108,67,580
1198,D'Vauntes Smith-Rivera,SO,2013-14,G,Georgetown,Big East,33,1172,178,400,.445,112,232,66,168,.393,158,181,.873,43,121,164,90,41,5,57,64,580
1199,Justin Wright-Foreman,SO,2016-17,G,Hofstra,CAA,32,905,208,422,.493,141,242,67,180,.372,97,127,.764,21,93,114,52,24,2,45,59,580
1200,Kenny Adeleke,SR,2005-06,F,Hartford,AEC,28,981,223,377,.592,223,377,0,0,,133,224,.594,150,216,366,17,29,48,103,84,579
1201,Mike Brown,SR,2015-16,G,Western Carolina,Southern,34,1167,188,466,.403,144,328,44,138,.319,159,198,.803,75,125,200,110,52,12,108,114,579
1202,Tyler Brown,SR,2012-13,G,Illinois State,MVC,32,946,181,411,.440,101,206,80,205,.390,137,170,.806,26,116,142,86,46,7,94,52,579
1203,Frank Eaves,SR,2015-16,G,Appalachian State,Sun Belt,31,965,170,446,.381,87,230,83,216,.384,156,191,.817,20,96,116,68,26,1,70,71,579
1204,Markelle Fultz,FR,2016-17,G,Washington,Pac-12,25,892,209,439,.476,157,313,52,126,.413,109,168,.649,33,110,143,148,40,30,80,63,579
1205,Jessie Govan,SR,2018-19,C,Georgetown,Big East,33,1001,212,427,.496,165,313,47,114,.412,108,141,.766,58,188,246,41,27,41,49,86,579
1206,Randall Gulina,SR,2006-07,G,Samford,OVC,32,1067,184,400,.460,104,186,80,214,.374,131,164,.799,30,78,108,37,27,1,51,61,579
1207,De'Andre Hunter,SO,2018-19,G,Virginia,ACC,38,1234,205,394,.520,159,289,46,105,.438,123,157,.783,52,141,193,75,22,22,52,76,579
1210,Justin Moss ,JR,2014-15,F,Buffalo,MAC,33,991,203,390,.521,203,386,0,4,.000,173,237,.730,91,211,302,21,32,25,73,98,579
1211,Terran Petteway,JR,2013-14,G,Nebraska,Big Ten,32,1014,182,427,.426,134,280,48,147,.327,167,204,.819,29,126,155,52,29,24,88,102,579
1212,Shawn Prudhomme,SR,2016-17,F,Southern,SWAC,33,1103,212,482,.440,137,276,75,206,.364,80,112,.714,45,149,194,44,35,33,65,88,579
1213,Kendrick Ray,JR,2015-16,G,Kennesaw State,A-Sun,31,1059,214,441,.485,173,327,41,114,.360,110,154,.714,44,130,174,85,44,7,76,95,579
1214,Thomas Sanders,SR,2007-08,F,Gardner-Webb,A-Sun,32,1039,211,443,.476,203,405,8,38,.211,149,235,.634,104,242,346,104,43,6,112,99,579
1215,Jordan Sibert,SR,2014-15,G,Dayton,A-10,36,1215,177,388,.456,97,159,80,229,.349,145,184,.788,8,110,118,71,62,5,65,73,579
1216,Xavier Silas,SR,2010-11,G,Northern Illinois,MAC,26,831,178,388,.459,126,262,52,126,.413,171,201,.851,21,98,119,48,31,7,103,70,579
1217,Kyle Allman,SR,2018-19,G,Cal State Fullerton,Big West,33,1162,187,452,.414,127,280,60,172,.349,144,192,.750,10,90,100,65,24,13,81,66,578
1218,Harrison Barnes,FR,2010-11,F,North Carolina,ACC,37,1087,209,497,.421,142,302,67,195,.344,93,124,.750,75,141,216,53,27,16,72,72,578
1219,Yonel Brown,SR,2015-16,G,Kennesaw State,A-Sun,31,1203,198,478,.414,119,261,79,217,.364,103,130,.792,22,83,105,76,35,0,79,61,578
1220,Semaj Christon,SO,2013-14,G,Xavier,Big East,34,1200,201,420,.479,182,371,19,49,.388,157,235,.668,15,76,91,142,45,8,89,72,578
1221,Paul Davis,SR,2005-06,C,Michigan State,Big Ten,33,1018,206,364,.566,200,345,6,19,.316,160,184,.870,87,214,301,54,34,29,81,103,578
1222,Tyler Hall,FR,2015-16,G,Montana State,Big Sky,31,993,202,442,.457,106,219,96,223,.430,78,90,.867,26,137,163,51,28,8,56,68,578
1223,Kyle Hines,SO,2005-06,F,North Carolina-Greensboro,Southern,30,1019,239,384,.622,237,373,2,11,.182,98,178,.551,92,155,247,57,51,84,96,72,578
1224,Stefon Jackson,SO,2006-07,G,Texas-El Paso,CUSA,31,993,194,422,.460,163,325,31,97,.320,159,219,.726,78,119,197,47,47,4,69,87,578
1225,Zach Jackson,SR,2018-19,G,Omaha,Summit,32,1093,204,412,.495,144,273,60,139,.432,110,145,.759,30,109,139,61,26,4,51,58,578
1226,Garrison Johnson,SR,2009-10,G,Jackson State,SWAC,32,1077,172,465,.370,99,257,73,208,.351,161,220,.732,48,97,145,47,33,17,69,61,578
1227,Reggie Johnson,SR,2015-16,G,Hampton,MEAC,32,1153,192,519,.370,138,334,54,185,.292,140,194,.722,39,77,116,129,53,3,90,96,578
1228,Damion Lee,JR,2014-15,G,Drexel,CAA,27,1029,170,388,.438,105,219,65,169,.385,173,195,.887,24,141,165,63,41,9,50,60,578
1229,Kalin Lucas,SR,2010-11,G,Michigan State,Big Ten,34,1136,194,453,.428,141,317,53,136,.390,137,167,.820,16,57,73,114,35,2,87,72,578
1232,Damon Lynn,SO,2014-15,G,NJIT,Ind,33,1203,182,499,.365,56,149,126,350,.360,88,114,.772,15,83,98,123,58,2,92,67,578
1233,A.J. Ogilvy,FR,2007-08,C,Vanderbilt,SEC,34,896,201,342,.588,201,340,0,2,.000,176,229,.769,70,159,229,40,23,49,85,104,578
1234,Scottie Reynolds,JR,2008-09,G,Villanova,Big East,38,1223,168,420,.400,93,205,75,215,.349,167,205,.815,20,89,109,128,59,4,100,88,578
1235,Tracy Smith,JR,2009-10,F,North Carolina State,ACC,35,1122,222,424,.524,222,424,0,0,,134,205,.654,84,172,256,40,40,35,65,96,578
1236,Tyler Stone,SR,2013-14,F,Southeast Missouri State,OVC,30,1005,223,410,.544,200,342,23,68,.338,109,153,.712,73,211,284,58,29,46,51,83,578
1237,Sean Armand,SR,2013-14,G,Iona,MAAC,33,1184,190,391,.486,94,174,96,217,.442,101,128,.789,28,78,106,135,39,9,80,93,577
1238,Michael Bryson,SR,2015-16,G,UC-Santa Barbara,Big West,32,1080,202,422,.479,130,234,72,188,.383,101,123,.821,51,154,205,78,26,19,81,75,577
1239,Derrick Byars,SR,2006-07,G,Vanderbilt,SEC,34,1068,206,451,.457,127,239,79,212,.373,86,121,.711,52,113,165,116,48,4,80,81,577
1240,Devin Gibson,SR,2010-11,G,Texas-San Antonio,Southland,34,1190,159,376,.423,132,287,27,89,.303,232,297,.781,46,132,178,183,91,5,113,86,577
1241,D'Angelo Harrison,SR,2014-15,G,St. John's (NY),Big East,33,1150,178,429,.415,112,250,66,179,.369,155,194,.799,38,143,181,64,37,14,55,114,577
1242,Martez Harrison,SO,2014-15,G,Kansas City,WAC,33,1057,176,448,.393,129,280,47,168,.280,178,238,.748,19,60,79,129,60,0,86,89,577
1243,Wes Johnson,JR,2009-10,F,Syracuse,Big East,35,1224,207,412,.502,156,289,51,123,.415,112,145,.772,75,224,299,78,58,64,81,72,577
1244,Sean Kilpatrick,JR,2012-13,G,Cincinnati,Big East,34,1169,194,488,.398,112,221,82,267,.307,107,145,.738,45,131,176,63,42,8,67,42,577
1245,Jordan Nwora,SO,2018-19,F,Louisville,ACC,34,1084,198,444,.446,121,238,77,206,.374,104,136,.765,40,220,260,44,32,12,80,70,577
1246,Rodney Pryor,SR,2016-17,G,Georgetown,Big East,32,1044,212,442,.480,128,238,84,204,.412,69,94,.734,33,127,160,41,25,22,55,73,577
1247,Kevin Punter,SR,2015-16,G,Tennessee,SEC,26,886,177,385,.460,119,228,58,157,.369,165,202,.817,5,84,89,91,36,6,66,73,577
1248,Matt Rafferty,SR,2018-19,F,Furman,Southern,33,1101,217,353,.615,209,328,8,25,.320,135,176,.767,87,211,298,141,84,36,68,71,577
1249,Dyami Starks,SR,2014-15,G,Bryant,NEC,31,1183,187,496,.377,89,210,98,286,.343,105,115,.913,16,89,105,47,27,7,66,60,577
1250,Edwin Ubiles,SO,2007-08,F,Siena,MAAC,34,1130,231,439,.526,197,358,34,81,.420,81,115,.704,47,101,148,57,41,33,55,48,577
1251,Isiah Umipig,SR,2014-15,G,Seattle,WAC,34,1155,178,440,.405,55,146,123,294,.418,98,116,.845,12,95,107,98,45,0,73,73,577
1254,Greivis Vasquez,SO,2007-08,G,Maryland,ACC,34,1258,199,461,.432,135,254,64,207,.309,115,147,.782,31,162,193,231,47,9,149,78,577
1255,Thomas Wilder,SO,2015-16,G,Western Michigan,MAC,32,1018,172,405,.425,127,290,45,115,.391,188,238,.790,21,113,134,98,52,4,66,85,577
1256,Jeffrey Carroll,JR,2016-17,G,Oklahoma State,Big 12,33,960,198,369,.537,139,236,59,133,.444,121,150,.807,64,153,217,40,29,5,52,64,576
1257,Daniel Dixon,SR,2016-17,G,William & Mary,CAA,30,884,188,390,.482,115,197,73,193,.378,127,146,.870,26,115,141,75,22,9,67,83,576
1258,Keith Gabriel,SR,2011-12,G,Virginia Military Institute,Big South,33,944,192,448,.429,117,214,75,234,.321,117,157,.745,27,88,115,62,59,41,73,75,576
1259,D'Angelo Harrison,JR,2013-14,G,St. John's (NY),Big East,33,1086,169,443,.381,105,270,64,173,.370,174,202,.861,29,132,161,62,32,16,48,83,576
1260,Juwan Howard,SR,2014-15,F,Detroit Mercy,Horizon,33,1042,208,479,.434,144,322,64,157,.408,96,113,.850,35,100,135,78,31,10,69,67,576
1261,Kevin Knox,FR,2017-18,F,Kentucky,SEC,37,1198,196,440,.445,139,273,57,167,.341,127,164,.774,33,167,200,53,31,10,85,82,576
1262,Jock Landale,JR,2016-17,C,Saint Mary's (CA),WCC,34,962,229,375,.611,225,357,4,18,.222,114,158,.722,103,219,322,58,10,41,72,87,576
1263,Lauri Markkanen,FR,2016-17,F,Arizona,Pac-12,37,1140,185,376,.492,116,213,69,163,.423,137,164,.835,88,178,266,32,15,19,40,73,576
1264,Marquise Moore,SR,2016-17,G,George Mason,A-10,34,1188,202,418,.483,192,385,10,33,.303,162,231,.701,58,311,369,119,32,26,95,69,576
1265,Anthony Odunsi,SR,2015-16,G,Houston Baptist,Southland,33,950,154,324,.475,141,285,13,39,.333,255,304,.839,26,125,151,122,40,1,116,69,576
1266,Jalen Ross,SR,2016-17,G,Hartford,AEC,29,1003,173,452,.383,104,260,69,192,.359,161,195,.826,8,92,100,61,37,1,84,41,576
1267,Keith Simmons,SR,2006-07,G,Holy Cross,Patriot,34,1209,190,382,.497,139,236,51,146,.349,145,189,.767,79,117,196,63,77,23,62,77,576
1268,Ryan Thompson,JR,2008-09,G,Rider,MAAC,32,1224,197,387,.509,151,278,46,109,.422,136,176,.773,67,142,209,103,56,12,85,68,576
1269,Anthony Winchester,SR,2005-06,G,Western Kentucky,Sun Belt,31,971,201,425,.473,120,227,81,198,.409,93,122,.762,65,110,175,78,30,7,84,63,576
1270,Joe Young,SO,2012-13,G,Houston,CUSA,32,1048,185,404,.458,119,247,66,157,.420,140,160,.875,18,94,112,79,19,0,41,40,576
1271,Kendall Anthony,SR,2014-15,G,Richmond,A-10,35,1276,203,455,.446,143,302,60,153,.392,109,138,.790,10,53,63,89,33,1,54,74,575
1272,Keion Bell,SO,2009-10,G,Pepperdine,WCC,31,977,194,454,.427,154,342,40,112,.357,147,196,.750,40,119,159,98,41,9,121,45,575
1273,Ryan Bowie,SR,2015-16,G,Texas-San Antonio,CUSA,32,1107,188,425,.442,107,224,81,201,.403,118,152,.776,51,161,212,50,27,7,71,88,575
1276,Jackie Carmichael,SR,2012-13,F,Illinois State,MVC,33,1009,213,404,.527,211,393,2,11,.182,147,216,.681,83,223,306,28,32,68,77,84,575
1277,DeMarcus Cousins,FR,2009-10,F,Kentucky,SEC,38,893,206,369,.558,205,363,1,6,.167,162,268,.604,154,220,374,38,37,67,78,122,575
1278,Markeith Cummings,FR,2009-10,F,Kennesaw State,A-Sun,33,1123,204,448,.455,171,350,33,98,.337,134,187,.717,79,122,201,70,31,6,95,80,575
1279,Will Daniels,JR,2006-07,F,Rhode Island,A-10,33,933,180,367,.490,129,245,51,122,.418,164,215,.763,54,132,186,51,27,19,79,89,575
1280,David Gonzalvez,JR,2008-09,G,Richmond,A-10,36,1280,206,433,.476,134,259,72,174,.414,91,129,.705,37,135,172,72,40,14,58,91,575
1281,Paul Graham,SR,2008-09,G,Florida Atlantic,Sun Belt,31,1071,196,503,.390,130,306,66,197,.335,117,141,.830,26,94,120,62,20,3,64,55,575
1282,Jon Axel Gudmundsson,JR,2018-19,G,Davidson,A-10,34,1252,177,385,.460,117,215,60,170,.353,161,195,.826,25,223,248,164,45,3,84,51,575
1283,Walt Lemon ,SR,2013-14,G,Bradley,MVC,32,1135,210,495,.424,181,395,29,100,.290,126,169,.746,8,90,98,124,78,3,115,76,575
1284,Nick Mayo,SO,2016-17,F,Eastern Kentucky,OVC,31,1092,203,403,.504,171,321,32,82,.390,137,177,.774,45,156,201,88,27,42,93,77,575
1285,E'Twaun Moore,JR,2009-10,G,Purdue,Big Ten,35,1103,212,476,.445,161,330,51,146,.349,100,137,.730,32,102,134,93,51,10,73,79,575
1286,Monte Morris,SR,2016-17,G,Iowa State,Big 12,35,1237,216,465,.465,162,322,54,143,.378,89,111,.802,40,129,169,217,53,10,42,51,575
1287,Devin Patterson,SR,2015-16,G,Omaha,Summit,32,1046,181,424,.427,124,260,57,164,.348,156,194,.804,12,68,80,101,59,0,85,82,575
1288,Mike Scott,SR,2011-12,F,Virginia,ACC,32,999,215,382,.563,209,362,6,20,.300,139,172,.808,70,195,265,37,21,15,67,56,575
1289,Jameel Warney,JR,2014-15,F,Stony Brook,AEC,35,1156,243,452,.538,243,452,0,0,,89,155,.574,150,259,409,72,26,87,59,74,575
1290,D.J. White,SR,2007-08,F,Indiana,Big Ten,33,1105,216,357,.605,215,354,1,3,.333,142,206,.689,100,241,341,25,26,54,63,83,575
1291,Talor Battle,JR,2009-10,G,Penn State,Big Ten,31,1146,193,459,.420,122,256,71,203,.350,117,166,.705,19,146,165,129,34,2,72,52,574
1292,Sherwood Brown,SR,2012-13,G,Florida Gulf Coast,A-Sun,37,1225,210,449,.468,137,255,73,194,.376,81,123,.659,58,184,242,45,52,10,67,73,574
1293,Marcus Denmon,JR,2010-11,G,Missouri,Big 12,34,1035,199,398,.500,117,215,82,183,.448,94,124,.758,33,86,119,61,61,4,32,56,574
1294,Trevor Releford,SR,2013-14,G,Alabama,SEC,31,1078,187,377,.496,115,194,72,183,.393,128,151,.848,19,89,108,97,69,3,82,84,574
1295,Terrence Ross,SO,2011-12,G,Washington,Pac-12,35,1088,215,470,.457,143,276,72,194,.371,72,94,.766,48,177,225,49,44,33,70,99,574
1296,Blake Schilb,JR,2005-06,G,Loyola (IL),Horizon,30,1044,192,412,.466,124,232,68,180,.378,122,147,.830,37,119,156,118,38,27,100,56,574
1297,Loren Stokes,JR,2005-06,G,Hofstra,CAA,33,1155,233,474,.492,206,397,27,77,.351,81,136,.596,46,121,167,93,52,14,98,80,574
1298,Luke Babbitt,FR,2008-09,F,Nevada,WAC,34,1110,194,425,.456,161,348,33,77,.429,152,176,.864,63,188,251,47,24,24,65,61,573
1299,Travis Bader,SO,2011-12,G,Oakland,Summit,36,1302,188,441,.426,64,127,124,314,.395,73,94,.777,23,92,115,43,31,4,37,93,573
1300,Julian Boyd,JR,2011-12,F,Long Island University,NEC,33,893,206,370,.557,185,320,21,50,.420,140,190,.737,80,228,308,26,16,21,70,97,573
1301,Garrison Carr,SR,2008-09,G,American,Patriot,32,1153,189,471,.401,75,178,114,293,.389,81,105,.771,16,82,98,52,31,2,84,66,573
1302,J.J. Frazier,JR,2015-16,G,Georgia,SEC,34,1090,169,412,.410,93,215,76,197,.386,159,193,.824,17,137,154,151,49,3,55,92,573
1303,Kavin Gilder-Tilbury,SR,2016-17,F,Texas State,Sun Belt,36,1103,205,415,.494,134,228,71,187,.380,92,140,.657,37,165,202,64,43,35,69,103,573
1304,Antonio Green,JR,2018-19,G,Middle Tennessee,CUSA,32,1131,196,521,.376,91,217,105,304,.345,76,87,.874,11,118,129,51,33,3,101,64,573
1305,Khallid Hart,SR,2016-17,G,Marist,MAAC,32,1135,186,407,.457,122,233,64,174,.368,137,173,.792,11,74,85,73,36,8,50,68,573
1306,Sean Hoehn,SR,2018-19,G,Sacred Heart,NEC,32,1011,182,384,.474,117,224,65,160,.406,144,170,.847,15,90,105,82,48,4,99,84,573
1307,Braxton Huggins,SR,2018-19,G,Fresno State,MWC,31,924,190,447,.425,89,185,101,262,.385,92,116,.793,19,113,132,53,35,10,69,69,573
1308,Robbie Hummel,SR,2011-12,F,Purdue,Big Ten,35,1128,194,465,.417,122,277,72,188,.383,113,137,.825,55,196,251,66,23,42,32,73,573
1309,Nick Kellogg,SR,2013-14,G,Ohio,MAC,37,1206,196,424,.462,109,202,87,222,.392,94,106,.887,22,112,134,109,39,1,55,77,573
1310,Nathan Knight,SO,2017-18,F,William & Mary,CAA,31,890,206,358,.575,195,322,11,36,.306,150,195,.769,58,168,226,69,18,61,83,103,573
1311,Eric Maynor,JR,2007-08,G,Virginia Commonwealth,CAA,32,1115,196,427,.459,146,300,50,127,.394,131,172,.762,24,110,134,175,40,7,96,61,573
1312,Drew McDonald,SO,2016-17,F,Northern Kentucky,Horizon,35,1052,201,425,.473,148,287,53,138,.384,118,160,.738,71,197,268,61,15,19,77,82,573
1313,Jamal Olasewere,JR,2011-12,F,Long Island University,NEC,34,884,197,345,.571,183,304,14,41,.341,165,225,.733,68,187,255,37,51,37,110,120,573
1314,Dan Oppland,SR,2005-06,F,Valparaiso,Mid-Cont,29,985,231,455,.508,196,356,35,99,.354,76,121,.628,86,146,232,55,26,5,54,85,573
1315,Shamorie Ponds,FR,2016-17,G,St. John's (NY),Big East,33,1109,191,435,.439,116,235,75,200,.375,116,141,.823,38,108,146,102,68,8,62,58,573
1318,Michael Qualls,JR,2014-15,G,Arkansas,SEC,36,1086,180,413,.436,125,248,55,165,.333,158,204,.775,59,133,192,60,32,17,61,62,573
1319,Brian Roberts,JR,2006-07,G,Dayton,A-10,31,1103,179,386,.464,97,207,82,179,.458,133,148,.899,6,83,89,82,22,7,72,60,573
1320,Gabe Rogers,SR,2012-13,G,Northern Arizona,Big Sky,32,1115,202,517,.391,107,258,95,259,.367,74,91,.813,12,51,63,58,32,2,88,49,573
1321,Justin Strings,SR,2017-18,F,Sacramento State,Big Sky,32,1157,223,522,.427,193,416,30,106,.283,97,157,.618,46,179,225,75,19,30,73,77,573
1322,Kris Wilkes,SO,2018-19,G,UCLA,Pac-12,33,1047,204,471,.433,135,266,69,205,.337,96,143,.671,39,119,158,56,20,14,63,71,573
1323,Jahmar Young,SO,2008-09,G,New Mexico State,WAC,32,1086,182,398,.457,113,234,69,164,.421,140,170,.824,22,105,127,104,44,7,70,78,573
1324,James Young,FR,2013-14,G,Kentucky,SEC,40,1296,183,450,.407,101,215,82,235,.349,125,177,.706,41,130,171,67,30,8,75,83,573
1325,Grayson Allen,SR,2017-18,G,Duke,ACC,37,1319,181,433,.418,79,157,102,276,.370,108,127,.850,20,103,123,172,64,2,79,79,572
1326,Tookie Brown,SR,2018-19,G,Georgia Southern,Sun Belt,33,1163,198,399,.496,158,281,40,118,.339,136,178,.764,24,116,140,154,44,4,77,71,572
1327,T.T. Carey,SR,2013-14,G,Longwood,Big South,31,1013,206,470,.438,112,232,94,238,.395,66,84,.786,30,174,204,24,46,11,49,73,572
1328,Stephen Croone,SO,2013-14,G,Furman,Southern,30,998,175,374,.468,145,281,30,93,.323,192,256,.750,10,122,132,112,50,8,108,64,572
1329,Chris Denson,SR,2013-14,G,Auburn,SEC,30,961,187,406,.461,165,323,22,83,.265,176,268,.657,37,93,130,71,30,3,54,64,572
1330,Jud Dillard,JR,2011-12,F,Tennessee Tech,OVC,33,1103,198,383,.517,191,350,7,33,.212,169,205,.824,85,197,282,42,34,5,79,65,572
1331,Noah Hartsock,SR,2011-12,F,Brigham Young,WCC,34,1049,216,382,.565,204,347,12,35,.343,128,152,.842,41,130,171,50,29,55,53,69,572
1332,Gordon Hayward,SO,2009-10,F,Butler,Horizon,37,1239,173,373,.464,126,213,47,160,.294,179,216,.829,72,233,305,62,40,30,85,78,572
1333,Josh Jackson,FR,2016-17,G,Kansas,Big 12,35,1077,220,429,.513,186,339,34,90,.378,98,173,.566,81,177,258,104,59,37,97,104,572
1334,Shabazz Muhammad,FR,2012-13,G,UCLA,Pac-12,32,987,202,456,.443,162,350,40,106,.377,128,180,.711,87,80,167,27,23,4,51,53,572
1335,Kyle O'Quinn,SR,2011-12,C,Norfolk State,MEAC,36,1125,205,358,.573,199,326,6,32,.188,156,224,.696,114,258,372,51,25,97,95,117,572
1336,Cameron Payne,FR,2013-14,G,Murray State,OVC,34,1111,190,470,.404,118,259,72,211,.341,120,155,.774,10,113,123,185,57,20,110,96,572
1337,Jared Terrell,SR,2017-18,G,Rhode Island,A-10,34,1128,191,447,.427,116,266,75,181,.414,115,140,.821,32,87,119,80,50,7,59,78,572
1340,D.J. Thompson,JR,2005-06,G,Appalachian State,Southern,30,1038,175,458,.382,77,201,98,257,.381,124,154,.805,35,75,110,132,81,1,89,64,572
1341,Evan Turner,SO,2008-09,G,Ohio State,Big Ten,33,1202,193,384,.503,182,359,11,25,.440,175,222,.788,56,178,234,131,58,27,117,97,572
1342,Ryan Wittman,JR,2008-09,F,Cornell,Ivy,31,1056,197,436,.452,100,203,97,233,.416,81,99,.818,13,98,111,82,27,7,56,67,572
1343,Bradford Burgess,JR,2010-11,G,Virginia Commonwealth,CAA,40,1380,193,396,.487,121,230,72,166,.434,113,150,.753,85,166,251,66,43,30,61,86,571
1344,Joe Cremo,JR,2017-18,G,Albany (NY),AEC,32,1128,182,397,.458,106,231,76,166,.458,131,160,.819,20,112,132,120,27,9,68,70,571
1345,Majok Deng,SR,2015-16,F,Louisiana-Monroe,Sun Belt,31,1126,193,403,.479,134,246,59,157,.376,126,155,.813,51,167,218,60,22,51,68,77,571
1346,Tyler Dorsey,SO,2016-17,G,Oregon,Pac-12,39,1169,189,405,.467,101,197,88,208,.423,105,139,.755,33,102,135,67,30,4,59,57,571
1347,Jared Dudley,SR,2006-07,F,Boston College,ACC,30,1152,195,347,.562,156,259,39,88,.443,142,191,.743,91,157,248,90,42,10,78,66,571
1348,Adam Flagler,FR,2018-19,G,Presbyterian,Big South,36,1105,196,447,.438,88,167,108,280,.386,71,85,.835,27,95,122,45,28,9,42,61,571
1349,Kyle Gibson,SR,2009-10,G,Louisiana Tech,WAC,31,1065,163,411,.397,102,225,61,186,.328,184,219,.840,27,93,120,94,28,2,74,64,571
1350,Justin Greene,JR,2010-11,F,Kent State,MAC,37,1208,222,464,.478,222,463,0,1,.000,127,179,.709,99,209,308,61,39,53,111,105,571
1351,Marshall Henderson,SR,2013-14,G,Mississippi,SEC,30,934,172,487,.353,43,110,129,377,.342,98,120,.817,9,48,57,61,45,2,55,50,571
1352,Otis Livingston,JR,2017-18,G,George Mason,A-10,33,1198,193,443,.436,128,273,65,170,.382,120,140,.857,7,100,107,144,33,2,86,43,571
1353,Javier Mojica,SR,2006-07,G,Central Connecticut State,NEC,34,1233,204,455,.448,133,280,71,175,.406,92,122,.754,63,178,241,108,52,8,87,82,571
1354,Luke Nevill,SR,2008-09,C,Utah,MWC,34,1084,201,331,.607,201,331,0,0,,169,215,.786,68,239,307,44,15,92,82,97,571
1355,Kelly Olynyk,JR,2012-13,F,Gonzaga,WCC,32,845,215,342,.629,206,312,9,30,.300,132,170,.776,77,158,235,55,22,36,77,72,571
1356,Dylan Windler,JR,2017-18,F,Belmont,OVC,33,1168,204,365,.559,135,203,69,162,.426,94,131,.718,57,250,307,90,34,31,78,86,571
1357,Pablo Bertone,SR,2013-14,G,Florida Atlantic,CUSA,30,1014,207,459,.451,155,304,52,155,.335,104,143,.727,20,96,116,64,39,2,84,80,570
1358,Joe Harris ,JR,2012-13,G,Virginia,ACC,35,1139,191,408,.468,114,227,77,181,.425,111,150,.740,30,111,141,76,31,17,70,82,570
1359,TJ Haws,JR,2018-19,G,Brigham Young,WCC,32,1070,174,376,.463,117,214,57,162,.352,165,190,.868,10,102,112,162,38,9,75,69,570
1362,Lazar Hayward,JR,2008-09,F,Marquette,Big East,35,1109,204,435,.469,151,287,53,148,.358,109,133,.820,99,203,302,39,35,9,65,89,570
1363,Sheldon McClellan,SR,2015-16,G,Miami (FL),ACC,35,1151,177,351,.504,121,213,56,138,.406,160,191,.838,19,93,112,56,36,9,44,62,570
1364,Kenard Moore,SR,2008-09,G,Southeast Missouri State,OVC,30,1086,201,483,.416,104,198,97,285,.340,71,91,.780,16,51,67,47,35,4,85,63,570
1365,Sviatoslav Mykhailiuk,SR,2017-18,G,Kansas,Big 12,39,1346,205,472,.434,90,213,115,259,.444,45,56,.804,44,109,153,107,46,12,65,97,570
1366,Alec Peters,SO,2014-15,F,Valparaiso,Horizon,34,1039,195,399,.489,112,221,83,178,.466,97,117,.829,64,163,227,42,24,11,49,67,570
1367,Belton Rivers,SR,2006-07,G,Tennessee Tech,OVC,32,1068,182,457,.398,90,204,92,253,.364,114,153,.745,24,93,117,81,35,2,92,75,570
1368,Markel Starks,SR,2013-14,G,Georgetown,Big East,33,1222,186,451,.412,129,276,57,175,.326,141,162,.870,14,62,76,135,30,3,76,78,570
1369,Jarvis Summers,JR,2013-14,G,Mississippi,SEC,33,1011,190,391,.486,143,280,47,111,.423,143,187,.765,12,67,79,126,31,10,76,93,570
1370,Brandon Tabb,JR,2016-17,G,Bethune-Cookman,MEAC,32,1100,187,493,.379,81,186,106,307,.345,90,109,.826,26,148,174,53,43,19,48,101,570
1371,Jahad Thomas,SR,2017-18,G,Massachusetts-Lowell,AEC,27,979,211,410,.515,195,366,16,44,.364,132,189,.698,69,157,226,107,48,8,95,70,570
1372,Dan Trist,SR,2014-15,F,Lafayette,Patriot,33,892,230,399,.576,230,399,0,0,,110,141,.780,76,146,222,43,12,23,75,71,570
1373,Moritz Wagner,JR,2017-18,F,Michigan,Big Ten,39,1078,216,409,.528,153,249,63,160,.394,75,108,.694,57,221,278,33,38,20,56,120,570
1374,C.J. Wilcox,JR,2012-13,G,Washington,Pac-12,34,1184,201,480,.419,126,275,75,205,.366,93,114,.816,40,106,146,65,37,36,63,71,570
1375,Kyle Wilson,SO,2013-14,G,Army,Patriot,31,959,189,427,.443,126,282,63,145,.434,129,163,.791,15,65,80,45,17,3,64,50,570
1376,Jeremy Atkinson,SR,2012-13,F,North Carolina-Asheville,Big South,32,1101,198,411,.482,170,323,28,88,.318,145,179,.810,77,151,228,80,50,4,86,69,569
1377,Torrey Craig,JR,2012-13,F,South Carolina Upstate,A-Sun,33,1022,194,454,.427,116,240,78,214,.364,103,144,.715,62,166,228,63,33,25,88,68,569
1378,Torrey Craig,SR,2013-14,F,South Carolina Upstate,A-Sun,34,1113,204,500,.408,136,267,68,233,.292,93,151,.616,67,170,237,77,31,28,84,84,569
1379,Khallid Hart,JR,2015-16,G,Marist,MAAC,28,1021,164,369,.444,92,181,72,188,.383,169,201,.841,10,64,74,58,42,2,63,65,569
1380,Corey Hawkins,JR,2012-13,G,UC-Davis,Big West,28,951,183,386,.474,135,266,48,120,.400,155,184,.842,24,133,157,93,42,7,72,62,569
1381,TJ Leaf,FR,2016-17,F,UCLA,Pac-12,35,1048,235,381,.617,208,323,27,58,.466,72,106,.679,78,209,287,85,22,39,52,89,569
1384,Dennis Mavin,SR,2014-15,G,Florida International,CUSA,33,1174,198,452,.438,167,353,31,99,.313,142,221,.643,27,147,174,103,41,1,118,47,569
1385,Tasmin Mitchell,JR,2008-09,F,Louisiana State,SEC,35,1137,224,429,.522,214,410,10,19,.526,111,153,.725,92,159,251,68,55,23,70,89,569
1386,Harding Nana,SR,2005-06,F,Delaware,CAA,30,1059,200,426,.469,154,293,46,133,.346,123,192,.641,89,237,326,52,37,38,85,88,569
1387,Roberto Nelson,JR,2012-13,G,Oregon State,Pac-12,32,1000,179,404,.443,123,263,56,141,.397,155,202,.767,36,69,105,77,31,10,73,73,569
1388,Deshon Taylor,JR,2017-18,G,Fresno State,MWC,32,1083,155,353,.439,96,200,59,153,.386,200,240,.833,12,89,101,83,49,5,79,72,569
1389,MaCio Teague,SO,2017-18,G,North Carolina-Asheville,Big South,34,1200,181,433,.418,84,205,97,228,.425,110,127,.866,17,132,149,85,54,4,70,57,569
1390,Jon Brockman,JR,2007-08,F,Washington,Pac-10,32,1009,237,442,.536,237,442,0,0,,94,181,.519,141,229,370,35,21,8,76,94,568
1391,A.J. English,SO,2013-14,G,Iona,MAAC,33,1207,170,419,.406,86,182,84,237,.354,144,188,.766,22,108,130,142,33,14,92,80,568
1392,Moses Greenwood,SR,2018-19,F,Southeastern Louisiana,Southland,33,984,223,371,.601,207,331,16,40,.400,106,151,.702,92,156,248,28,31,35,81,114,568
1393,Eron Harris,SO,2013-14,G,West Virginia,Big 12,33,1035,183,418,.438,94,207,89,211,.422,113,132,.856,27,87,114,52,24,7,68,78,568
1394,Richard Hendrix,JR,2007-08,F,Alabama,SEC,32,980,229,383,.598,227,376,2,7,.286,108,201,.537,118,206,324,51,41,62,55,94,568
1395,Tyrone Lewis,JR,2008-09,G,Niagara,MAAC,35,1219,175,519,.337,76,220,99,299,.331,119,149,.799,60,102,162,69,91,28,72,82,568
1396,Derick Newton,SO,2016-17,F,Stetson,A-Sun,32,1012,184,399,.461,123,234,61,165,.370,139,171,.813,42,140,182,41,19,8,57,51,568
1397,James Palmer,JR,2017-18,G,Nebraska,Big Ten,33,1024,181,408,.444,138,269,43,139,.309,163,221,.738,41,103,144,99,32,16,72,61,568
1398,Will Pratt,SR,2010-11,F,Northwestern State,Southland,32,799,193,380,.508,172,312,21,68,.309,161,241,.668,51,91,142,39,42,9,109,113,568
1399,Jordan Price,SO,2014-15,G,La Salle,A-10,33,1054,180,465,.387,111,262,69,203,.340,139,174,.799,16,113,129,75,27,8,103,94,568
1400,Brandon Tabb,SR,2017-18,G,Bethune-Cookman,MEAC,30,938,172,433,.397,75,145,97,288,.337,127,139,.914,23,86,109,49,46,11,68,84,568
1401,Melo Trimble,FR,2014-15,G,Maryland,Big Ten,35,1173,150,338,.444,89,190,61,148,.412,207,240,.863,6,129,135,106,44,2,86,65,568
1402,Tre'Von Willis,JR,2009-10,G,Nevada-Las Vegas,MWC,33,985,182,381,.478,141,242,41,139,.295,163,190,.858,28,102,130,114,41,7,80,84,568
1403,Jared Brownridge,FR,2013-14,G,Santa Clara,WCC,33,1107,183,403,.454,88,185,95,218,.436,106,123,.862,11,74,85,76,24,4,48,64,567
1404,Kyle Collinsworth,SR,2015-16,G,Brigham Young,WCC,37,1249,206,444,.464,197,407,9,37,.243,146,224,.652,86,217,303,275,74,20,126,74,567
1405,Anthony Davis,FR,2011-12,F,Kentucky,SEC,40,1281,210,337,.623,207,317,3,20,.150,144,203,.709,119,296,415,50,54,186,41,78,567
1406,Grant Golden,SO,2018-19,F,Richmond,A-10,33,1035,221,439,.503,205,385,16,54,.296,109,166,.657,26,207,233,117,15,35,82,61,567
1407,Georges Niang,SO,2013-14,F,Iowa State,Big 12,34,1025,222,468,.474,174,321,48,147,.327,75,104,.721,34,118,152,123,21,21,82,109,567
1408,Jahad Thomas,JR,2016-17,G,Massachusetts-Lowell,AEC,31,1051,224,380,.589,222,378,2,2,1.000,117,173,.676,71,209,280,143,50,8,117,94,567
1409,Denzel Valentine,JR,2014-15,G,Michigan State,Big Ten,39,1295,197,445,.443,95,200,102,245,.416,71,86,.826,46,199,245,167,35,9,92,85,567
1410,Jamar Wilson,JR,2005-06,G,Albany (NY),AEC,32,1116,171,377,.454,122,242,49,135,.363,176,207,.850,31,127,158,125,43,7,117,88,567
1411,Antoine Agudio,SO,2005-06,G,Hofstra,CAA,33,1212,194,432,.449,103,216,91,216,.421,87,122,.713,23,74,97,90,35,3,92,43,566
1412,Sean Armand,JR,2012-13,G,Iona,MAAC,34,1233,189,434,.435,77,160,112,274,.409,76,99,.768,45,128,173,103,42,16,69,102,566
1413,William Buford,SR,2011-12,G,Ohio State,Big Ten,39,1320,205,489,.419,143,316,62,173,.358,94,114,.825,35,159,194,104,33,9,84,71,566
1414,Jaevin Cumberland,JR,2018-19,G,Oakland,Horizon,33,1222,173,407,.425,64,134,109,273,.399,111,130,.854,14,82,96,114,37,6,60,69,566
1415,Markeith Cummings,SO,2010-11,F,Kennesaw State,A-Sun,31,1102,198,434,.456,186,377,12,57,.211,158,235,.672,63,92,155,56,45,4,90,73,566
1416,Cortez Edwards,JR,2017-18,G,Southern Mississippi,CUSA,34,1219,221,449,.492,196,361,25,88,.284,99,128,.773,70,147,217,98,71,14,62,54,566
1417,Chris Evans,SR,2012-13,F,Kent State,MAC,35,1144,189,396,.477,150,273,39,123,.317,149,204,.730,79,190,269,72,66,24,93,88,566
1418,Jared Jordan,SR,2006-07,G,Marist,MAAC,33,1252,197,464,.425,141,276,56,188,.298,116,168,.690,46,148,194,286,45,2,110,54,566
1419,Jack McClinton,JR,2007-08,G,Miami (FL),ACC,32,1007,179,418,.428,85,198,94,220,.427,114,124,.919,11,66,77,82,24,1,79,58,566
1420,Jacolby Mobley,SR,2016-17,G,Tennessee-Martin,OVC,29,1025,182,432,.421,87,173,95,259,.367,107,137,.781,22,62,84,60,30,3,58,57,566
1421,Julian Norfleet,SR,2013-14,G,Mount St. Mary's,NEC,33,1078,195,431,.452,139,269,56,162,.346,120,162,.741,13,81,94,181,52,9,97,82,566
1422,Dyami Starks,JR,2013-14,G,Bryant,NEC,30,1089,193,465,.415,105,226,88,239,.368,92,107,.860,25,76,101,60,32,1,58,66,566
1423,Pancake Thomas,SR,2015-16,G,Hartford,AEC,30,1038,178,407,.437,97,217,81,190,.426,129,156,.827,30,163,193,84,36,6,53,72,566
1426,Ryan Thompson,SR,2009-10,G,Rider,MAAC,33,1209,172,408,.422,125,263,47,145,.324,175,214,.818,45,119,164,91,38,11,71,65,566
1427,Jerome Tillman,SR,2008-09,F,Ohio,MAC,32,1047,183,361,.507,156,279,27,82,.329,173,235,.736,84,174,258,38,35,16,74,93,566
1428,Damani Applewhite,JR,2018-19,F,South Carolina State,MEAC,34,1155,198,391,.506,194,375,4,16,.250,165,234,.705,81,171,252,37,12,9,54,61,565
1429,George Beamon,SR,2013-14,G,Manhattan,MAAC,30,926,170,417,.408,117,274,53,143,.371,172,208,.827,48,146,194,23,47,10,55,69,565
1430,Joel Bolomboy,SR,2015-16,F,Weber State,Big Sky,33,1041,193,337,.573,173,282,20,55,.364,159,228,.697,109,306,415,35,23,40,78,73,565
1431,Devontae Cacok,JR,2017-18,F,North Carolina-Wilmington,CAA,32,942,221,378,.585,221,378,0,0,,123,201,.612,162,269,431,28,33,18,72,124,565
1432,Antwan Carter,JR,2010-11,C,Longwood,Ind,31,1007,237,414,.572,228,377,9,37,.243,82,120,.683,72,221,293,50,28,23,66,106,565
1433,Jawan Carter,JR,2009-10,G,Delaware,CAA,31,1214,160,413,.387,86,186,74,227,.326,171,212,.807,23,79,102,151,40,0,93,83,565
1434,Eric Devendorf,JR,2008-09,G,Syracuse,Big East,36,1220,193,435,.444,111,225,82,210,.390,97,122,.795,14,57,71,108,38,12,107,82,565
1435,Anthony Drmic,SO,2012-13,G,Boise State,MWC,32,1027,185,399,.464,105,195,80,204,.392,115,148,.777,30,117,147,74,20,8,67,96,565
1436,Branden Frazier,SR,2013-14,G,Fordham,A-10,31,1140,186,468,.397,141,309,45,159,.283,148,173,.855,47,110,157,133,34,9,93,72,565
1437,J.R. Holder,SR,2016-17,F,Jacksonville,A-Sun,32,1080,200,389,.514,155,265,45,124,.363,120,167,.719,34,78,112,61,36,15,84,60,565
1438,Jordan Howard,SO,2015-16,G,Central Arkansas,Southland,28,976,175,411,.426,80,189,95,222,.428,120,137,.876,18,76,94,78,18,2,61,33,565
1439,Kareem Jamar,SR,2013-14,G,Montana,Big Sky,30,1086,182,386,.472,137,257,45,129,.349,156,219,.712,25,144,169,121,27,15,67,74,565
1440,David Jenkins Jr.,FR,2017-18,G,South Dakota State,Summit,35,1032,183,424,.432,99,204,84,220,.382,115,144,.799,10,103,113,57,13,0,59,68,565
1441,Dana Smith,SR,2009-10,F,Longwood,Ind,31,986,195,408,.478,162,311,33,97,.340,142,214,.664,76,148,224,78,30,16,92,103,565
1442,Marcus Thornton,SO,2012-13,G,William & Mary,CAA,30,1090,181,411,.440,88,197,93,214,.435,110,133,.827,11,72,83,83,26,15,92,44,565
1443,Marquis Weddle,FR,2007-08,G,Tennessee-Martin,OVC,33,1150,199,487,.409,100,193,99,294,.337,68,91,.747,13,81,94,59,29,1,77,38,565
1444,Brandon Wood,SO,2009-10,G,Valparaiso,Horizon,32,1014,198,427,.464,142,277,56,150,.373,113,139,.813,32,113,145,72,33,4,81,69,565
1445,Mark Zoller,SR,2006-07,F,Pennsylvania,Ivy,31,970,206,369,.558,165,260,41,109,.376,112,143,.783,59,173,232,87,55,12,83,107,565
1448,Tim Abromaitis,JR,2009-10,F,Notre Dame,Big East,35,1104,183,370,.495,102,181,81,189,.429,117,134,.873,43,123,166,52,17,11,42,76,564
1449,Armon Bassett,JR,2009-10,G,Ohio,MAC,33,1150,164,421,.390,92,213,72,208,.346,164,202,.812,9,99,108,117,41,2,77,44,564
1450,O'Darien Bassett,SR,2007-08,G,Troy,Sun Belt,31,954,186,452,.412,120,259,66,193,.342,126,154,.818,33,87,120,73,40,3,64,53,564
1451,Anthony Bennett,FR,2012-13,F,Nevada-Las Vegas,MWC,35,950,202,379,.533,166,283,36,96,.375,124,177,.701,86,199,285,34,24,43,65,80,564
1452,Davion Berry,JR,2012-13,G,Weber State,Big Sky,37,1186,179,376,.476,119,231,60,145,.414,146,193,.756,15,139,154,140,45,10,75,67,564
1453,Bennie Boatwright,SR,2018-19,F,Southern California,Pac-12,31,1038,197,416,.474,107,206,90,210,.429,80,114,.702,43,162,205,79,23,18,46,75,564
1454,Evan Bradds,JR,2015-16,F,Belmont,OVC,32,980,210,294,.714,207,287,3,7,.429,141,200,.705,69,226,295,70,10,8,78,91,564
1455,Taylor Braun,SR,2013-14,G,North Dakota State,Summit,32,1088,170,361,.471,129,262,41,99,.414,183,233,.785,20,155,175,120,49,6,63,68,564
1456,Dillon Brooks,JR,2016-17,F,Oregon,Pac-12,35,886,206,422,.488,149,280,57,142,.401,95,126,.754,35,78,113,95,38,16,72,97,564
1457,Jalen Cannon,SR,2014-15,F,St. Francis (NY),NEC,35,1184,210,404,.520,183,323,27,81,.333,117,168,.696,139,228,367,34,24,27,58,60,564
1458,Austin Freeman,SR,2010-11,G,Georgetown,Big East,32,1082,204,429,.476,142,256,62,173,.358,94,108,.870,21,97,118,78,23,5,54,58,564
1459,Zach Johnson,JR,2017-18,G,Florida Gulf Coast,A-Sun,35,1134,203,433,.469,134,257,69,176,.392,89,114,.781,15,100,115,104,70,5,79,72,564
1460,Christian Maraker,SR,2005-06,F,Pacific,Big West,32,1101,205,412,.498,175,322,30,90,.333,124,146,.849,66,219,285,68,27,21,83,72,564
1461,Josh Mayo,JR,2007-08,G,Illinois-Chicago,Horizon,33,1068,174,379,.459,80,179,94,200,.470,122,145,.841,16,68,84,106,40,0,83,58,564
1462,Tywain McKee,JR,2007-08,G,Coppin State,MEAC,34,1203,177,402,.440,114,258,63,144,.438,147,169,.870,49,99,148,106,52,4,88,91,564
1463,Tony Mitchell,SO,2010-11,F,Alabama,SEC,37,1167,228,437,.522,197,339,31,98,.316,77,117,.658,97,164,261,49,59,41,64,89,564
1464,Terran Petteway,JR,2014-15,G,Nebraska,Big Ten,31,1086,184,465,.396,116,248,68,217,.313,128,180,.711,17,136,153,87,35,27,104,94,564
1465,Torrance Rowe,SR,2015-16,G,Tennessee Tech,OVC,31,1100,177,430,.412,96,194,81,236,.343,129,149,.866,15,70,85,136,18,2,80,35,564
1466,Tyrone Wallace,JR,2014-15,G,University of California,Pac-12,33,1152,208,489,.425,180,401,28,88,.318,120,198,.606,30,205,235,131,42,11,94,91,564
1467,Jonathan Williams,JR,2015-16,G,Toledo,MAC,32,988,207,455,.455,137,269,70,186,.376,80,115,.696,18,77,95,91,26,2,89,62,564
1470,Tim Williams,SO,2013-14,F,Samford,Southern,32,1057,217,361,.601,216,358,1,3,.333,129,172,.750,64,171,235,24,43,45,59,75,564
1471,Martin Zeno,JR,2006-07,G,Texas Tech,Big 12,34,1211,186,376,.495,172,344,14,32,.438,178,225,.791,40,139,179,109,43,9,91,62,564
1472,Desmond Bane,JR,2018-19,G,Texas Christian,Big 12,37,1315,215,428,.502,147,268,68,160,.425,65,75,.867,49,162,211,89,42,20,49,86,563
1473,John Bowler,SR,2005-06,F,Eastern Michigan,MAC,28,938,189,344,.549,187,337,2,7,.286,183,253,.723,91,210,301,70,22,16,106,92,563
1474,Tookie Brown,SO,2016-17,G,Georgia Southern,Sun Belt,33,1123,177,436,.406,116,259,61,177,.345,148,193,.767,8,104,112,131,46,10,73,70,563
1475,Khadeen Carrington,JR,2016-17,G,Seton Hall,Big East,33,1099,189,446,.424,126,281,63,165,.382,122,167,.731,19,83,102,97,38,10,75,62,563
1476,Gilberto Clavell,JR,2009-10,F,Sam Houston State,Southland,33,928,205,358,.573,203,344,2,14,.143,151,207,.729,91,119,210,44,25,5,89,107,563
1477,Elgin Cook,SR,2015-16,F,Oregon,Pac-12,38,1213,191,405,.472,170,342,21,63,.333,160,207,.773,59,136,195,88,54,13,80,107,563
1478,Stephen Croone,SR,2015-16,G,Furman,Southern,33,999,161,376,.428,114,204,47,172,.273,194,253,.767,11,105,116,84,38,10,84,79,563
1479,Jermaine Crumpton,SR,2017-18,F,Canisius,MAAC,33,1063,205,426,.481,158,279,47,147,.320,106,139,.763,66,111,177,50,23,17,59,60,563
1480,TyShwan Edmondson,JR,2010-11,G,Austin Peay,OVC,33,1057,206,487,.423,134,292,72,195,.369,79,106,.745,53,94,147,66,60,15,67,78,563
1481,Andre Harris,SR,2006-07,F,Fairleigh Dickinson,NEC,30,1098,227,463,.490,217,431,10,32,.313,99,145,.683,74,150,224,41,41,37,80,85,563
1482,Danuel House,SR,2015-16,G,Texas A&M,SEC,36,1114,185,467,.396,110,224,75,243,.309,118,165,.715,39,132,171,77,19,11,64,51,563
1483,Jamaal King,JR,2017-18,G,Saint Francis (PA),NEC,31,959,195,412,.473,142,256,53,156,.340,120,147,.816,12,84,96,108,37,1,96,70,563
1484,Stefan Moody,JR,2014-15,G,Mississippi,SEC,34,975,168,433,.388,90,211,78,222,.351,149,165,.903,31,85,116,80,57,3,68,88,563
1485,Chris Oliver,SR,2006-07,F,Radford,Big South,30,1099,220,452,.487,204,390,16,62,.258,107,143,.748,97,152,249,62,56,39,94,55,563
1486,Shawn Roundtree,SR,2018-19,G,Central Michigan,MAC,34,1173,167,364,.459,91,186,76,178,.427,153,194,.789,10,81,91,105,31,2,78,66,563
1487,Tres Tinkle,SO,2017-18,F,Oregon State,Pac-12,32,1164,192,407,.472,144,260,48,147,.327,131,156,.840,56,175,231,117,45,18,93,88,563
1488,Jamarco Warren,SR,2010-11,G,Charleston Southern,Big South,32,1068,180,410,.439,100,193,80,217,.369,123,142,.866,16,79,95,90,44,2,100,70,563
1489,Andrew White,JR,2015-16,G,Nebraska,Big Ten,34,1010,195,405,.481,108,194,87,211,.412,86,111,.775,40,159,199,20,39,11,53,89,563
1492,Cody Zeller,FR,2011-12,F,Indiana,Big Ten,36,1025,200,321,.623,200,321,0,0,,163,216,.755,87,149,236,45,49,42,60,97,563
1493,Joshua Braun,SO,2015-16,G,Grand Canyon,WAC,34,1045,143,328,.436,70,142,73,186,.392,203,234,.868,56,122,178,37,26,23,44,71,562
1494,J'Nathan Bullock,SR,2008-09,F,Cleveland State,Horizon,37,1184,192,455,.422,156,338,36,117,.308,142,193,.736,73,188,261,51,36,15,56,76,562
1495,Dachon Burke,SO,2017-18,G,Robert Morris,NEC,32,1044,210,458,.459,166,328,44,130,.338,98,156,.628,59,125,184,80,67,16,86,81,562
1496,Jordan Caroline,SR,2018-19,F,Nevada,MWC,33,1171,193,427,.452,147,302,46,125,.368,130,207,.628,83,235,318,63,21,10,82,72,562
1497,Herb Courtney,JR,2006-07,F,Delaware,CAA,31,1139,191,451,.424,150,322,41,129,.318,139,196,.709,52,196,248,39,45,54,88,87,562
1498,Jordan Gregory,SR,2014-15,G,Montana,Big Sky,33,1189,176,437,.403,89,209,87,228,.382,123,154,.799,18,93,111,107,20,1,70,53,562
1499,Manny Harris,JR,2009-10,G,Michigan,Big Ten,31,1120,181,430,.421,133,274,48,156,.308,152,190,.800,57,130,187,126,56,11,88,45,562
1500,Rodney Hood,SO,2013-14,F,Duke,ACC,35,1150,191,412,.464,120,243,71,169,.420,109,135,.807,29,109,138,75,25,9,54,91,562
1501,Yante Maten,SO,2015-16,F,Georgia,SEC,34,1020,212,427,.496,204,412,8,15,.533,130,166,.783,89,184,273,27,9,62,76,92,562
1502,Ryan Pearson,SR,2011-12,F,George Mason,CAA,33,1012,201,400,.503,173,320,28,80,.350,132,182,.725,76,195,271,58,43,15,89,86,562
1503,Bruce Price,JR,2007-08,G,Tennessee State,OVC,32,1089,160,395,.405,106,229,54,166,.325,188,268,.701,29,122,151,160,71,2,128,96,562
1504,Coby White,FR,2018-19,G,North Carolina,ACC,35,999,188,444,.423,106,212,82,232,.353,104,130,.800,12,112,124,143,38,11,93,68,562
1505,Jamal Barney,SO,2008-09,G,Loyola (MD),MAAC,31,887,207,498,.416,178,395,29,103,.282,118,148,.797,54,115,169,40,44,14,79,75,561
1506,Landon Clement,JR,2010-11,G,North Carolina Central,Ind,30,1081,183,424,.432,74,156,109,268,.407,86,107,.804,16,96,112,32,34,1,43,43,561
1507,Kellen Dunham,JR,2014-15,G,Butler,Big East,34,1153,171,399,.429,94,211,77,188,.410,142,167,.850,18,69,87,31,19,1,51,47,561
1508,Henry Ellenson,FR,2015-16,F,Marquette,Big East,33,1107,194,435,.446,164,331,30,104,.288,143,191,.749,71,250,321,59,28,49,78,84,561
1509,C.J. Fair,SR,2013-14,F,Syracuse,ACC,34,1284,217,506,.429,193,419,24,87,.276,103,142,.725,59,160,219,43,44,27,85,71,561
1510,Brian Fobbs,JR,2018-19,G,Towson,CAA,32,1049,207,457,.453,142,280,65,177,.367,82,102,.804,59,129,188,41,21,7,59,58,561
1511,Jamont Gordon,SO,2006-07,G,Mississippi State,SEC,35,1129,181,432,.419,139,311,42,121,.347,157,222,.707,43,207,250,187,46,20,123,85,561
1512,B.J. Johnson,SR,2017-18,F,La Salle,A-10,27,951,194,435,.446,147,304,47,131,.359,126,145,.869,57,168,225,20,35,19,68,57,561
1513,Carl Jones,JR,2011-12,G,Saint Joseph's,A-10,33,1204,176,423,.416,114,245,62,178,.348,147,186,.790,10,100,110,108,40,1,92,56,561
1514,Dominique Jones,SO,2008-09,G,South Florida,Big East,31,1161,193,461,.419,139,286,54,175,.309,121,171,.708,61,112,173,122,41,12,82,79,561
1515,Kyle Landry,SR,2007-08,F,Northern Arizona,Big Sky,32,815,189,323,.585,189,323,0,0,,183,259,.707,89,169,258,28,32,27,49,86,561
1516,Z Mason,SR,2013-14,F,Chattanooga,Southern,31,939,201,410,.490,161,293,40,117,.342,119,167,.713,91,209,300,24,28,92,74,72,561
1517,Matt Scott,JR,2016-17,G,Niagara,MAAC,33,1139,187,430,.435,122,257,65,173,.376,122,170,.718,56,174,230,99,45,14,87,79,561
1518,Elston Turner,SR,2012-13,G,Texas A&M,SEC,32,1139,199,467,.426,125,262,74,205,.361,89,105,.848,14,82,96,74,31,7,59,38,561
1519,Kyle Weems,JR,2010-11,F,Missouri State,MVC,35,1087,204,428,.477,138,261,66,167,.395,87,110,.791,57,183,240,49,48,33,50,93,561
1520,Kamar Baldwin,JR,2018-19,G,Butler,Big East,33,1129,211,472,.447,169,337,42,135,.311,96,113,.850,21,140,161,102,49,11,90,86,560
1521,Jordan Davis,SO,2016-17,G,Northern Colorado,Big Sky,29,978,210,429,.490,185,345,25,84,.298,115,192,.599,20,120,140,162,35,15,126,84,560
1522,Jud Dillard,SR,2012-13,F,Tennessee Tech,OVC,29,982,182,404,.450,146,297,36,107,.336,160,197,.812,57,169,226,67,31,8,87,73,560
1523,Anthony Gurley,SR,2010-11,G,Massachusetts,A-10,30,920,193,462,.418,133,290,60,172,.349,114,156,.731,24,107,131,42,29,2,83,57,560
1524,Herbert Hill,SR,2006-07,F,Providence,Big East,31,990,240,375,.640,240,374,0,1,.000,80,133,.602,101,173,274,45,30,91,89,90,560
1525,DeAndre Kane,SO,2011-12,G,Marshall,CUSA,34,1156,201,486,.414,170,362,31,124,.250,127,212,.599,70,115,185,120,47,11,101,110,560
1526,Roy Devyn Marble,SR,2013-14,G,Iowa,Big Ten,33,995,183,436,.420,131,287,52,149,.349,142,199,.714,26,80,106,118,60,7,57,64,560
1527,Gerry McNamara,SR,2005-06,G,Syracuse,Big East,35,1232,173,490,.353,70,182,103,308,.334,111,123,.902,32,62,94,207,66,2,117,46,560
1528,Kevin Murphy,JR,2010-11,G,Tennessee Tech,OVC,33,966,202,423,.478,165,312,37,111,.333,119,162,.735,18,130,148,58,34,6,107,72,560
1529,Cameron Oliver,SO,2016-17,F,Nevada,MWC,35,1115,202,434,.465,136,262,66,172,.384,90,130,.692,57,247,304,64,29,91,83,101,560
1530,Christian Standhardinger,SR,2013-14,F,Hawaii,Big West,31,989,176,371,.474,163,324,13,47,.277,195,254,.768,92,169,261,46,42,23,85,89,560
1531,Darryl Bryant,SR,2011-12,G,West Virginia,Big East,33,1230,157,438,.358,86,208,71,230,.309,174,222,.784,27,74,101,89,45,2,80,72,559
1534,Torrey Craig,SO,2011-12,F,South Carolina Upstate,A-Sun,34,1010,194,446,.435,111,208,83,238,.349,88,129,.682,80,183,263,52,45,37,92,93,559
1535,David Efianayi,JR,2017-18,G,Gardner-Webb,Big South,32,1042,183,419,.437,132,278,51,141,.362,142,176,.807,19,97,116,81,40,7,82,54,559
1536,Josh Greene,SR,2013-14,G,Cal State Northridge,Big West,35,1256,156,382,.408,78,201,78,181,.431,169,185,.914,12,92,104,115,38,6,69,85,559
1537,Blake Hamilton,SR,2016-17,G,Buffalo,MAC,32,974,189,437,.432,130,277,59,160,.369,122,157,.777,27,171,198,141,32,15,111,92,559
1538,Marvelle Harris,SO,2013-14,G,Fresno State,MWC,39,1349,177,425,.416,122,272,55,153,.359,150,194,.773,30,175,205,75,40,13,58,92,559
1539,Chris Lofton,SR,2007-08,G,Tennessee,SEC,36,1071,170,426,.399,52,119,118,307,.384,101,120,.842,27,88,115,64,48,3,49,56,559
1540,Kalin Lucas,SO,2008-09,G,Michigan State,Big Ten,38,1213,173,438,.395,132,333,41,105,.390,172,213,.808,26,54,80,176,39,6,84,49,559
1541,Brandon McCoy,FR,2017-18,F,Nevada-Las Vegas,MWC,33,949,208,382,.545,205,373,3,9,.333,140,193,.725,103,238,341,17,15,60,87,87,559
1542,Lamont Middleton,SR,2013-14,G,North Carolina A&T,MEAC,32,1123,140,428,.327,90,263,50,165,.303,229,291,.787,45,106,151,66,33,5,95,77,559
1543,Darrion Pellum,JR,2010-11,G,Hampton,MEAC,32,1172,188,484,.388,115,267,73,217,.336,110,154,.714,23,115,138,63,53,10,92,70,559
1544,Jaylen Shaw,JR,2016-17,G,Coastal Carolina,Sun Belt,39,1194,203,441,.460,144,292,59,149,.396,94,116,.810,15,114,129,148,53,5,88,73,559
1545,TaShawn Thomas,SO,2012-13,F,Houston,CUSA,33,1072,234,424,.552,233,415,1,9,.111,90,141,.638,98,224,322,79,34,55,69,78,559
1546,Tony Wroten,FR,2011-12,G,Washington,Pac-12,35,1062,198,447,.443,189,391,9,56,.161,154,264,.583,80,96,176,130,66,13,132,93,559
1547,Bryce Alford,SR,2016-17,G,UCLA,Pac-12,36,1188,173,387,.447,57,117,116,270,.430,96,117,.821,11,78,89,92,19,5,35,51,558
1548,Joel Berry,JR,2016-17,G,North Carolina,ACC,38,1155,182,427,.426,94,197,88,230,.383,106,137,.774,16,102,118,138,53,5,71,84,558
1549,John Bryant,JR,2007-08,C,Santa Clara,WCC,31,862,214,367,.583,214,366,0,1,.000,130,175,.743,78,220,298,21,15,76,86,93,558
1550,Rotnei Clarke,SR,2012-13,G,Butler,A-10,33,1099,183,444,.412,68,162,115,282,.408,77,86,.895,14,79,93,90,24,1,94,54,558
1551,Sherron Collins,SR,2009-10,G,Kansas,Big 12,36,1187,185,434,.426,115,245,70,189,.370,118,138,.855,8,67,75,161,39,2,85,60,558
1552,Dylon Cormier,JR,2012-13,G,Loyola (MD),MAAC,34,1195,179,434,.412,151,331,28,103,.272,172,232,.741,75,80,155,84,62,11,61,66,558
1553,Robert Hite,SR,2005-06,G,Miami (FL),ACC,34,1127,201,446,.451,116,239,85,207,.411,71,87,.816,46,152,198,48,50,10,55,78,558
1556,Rapolas Ivanauskas,SO,2018-19,F,Colgate,Patriot,35,1058,207,400,.518,164,301,43,99,.434,101,130,.777,64,208,272,56,19,21,86,103,558
1557,Shawn Long,JR,2014-15,F,Louisiana,Sun Belt,34,951,205,378,.542,177,301,28,77,.364,120,182,.659,103,243,346,50,22,56,78,106,558
1558,Jarell Martin,SO,2014-15,F,Louisiana State,SEC,33,1159,202,397,.509,188,345,14,52,.269,140,203,.690,98,207,305,59,38,23,92,92,558
1559,Derek Needham,FR,2009-10,G,Fairfield,MAAC,34,1240,187,490,.382,129,301,58,189,.307,126,174,.724,22,87,109,177,60,4,130,94,558
1560,Shavar Newkirk,SR,2017-18,G,Saint Joseph's,A-10,32,1092,172,443,.388,120,284,52,159,.327,162,212,.764,25,114,139,125,50,7,56,57,558
1561,Marcus Romain,JR,2015-16,G,Mississippi Valley State,SWAC,30,869,188,429,.438,158,341,30,88,.341,152,200,.760,30,131,161,71,34,11,108,69,558
1562,Jarnell Stokes,JR,2013-14,F,Tennessee,SEC,37,1199,199,375,.531,199,375,0,0,,160,230,.696,155,237,392,75,26,34,77,73,558
1563,Zach Thomas,JR,2016-17,G,Bucknell,Patriot,35,1041,181,382,.474,125,245,56,137,.409,140,172,.814,39,191,230,120,39,17,108,82,558
1564,Aaron White,SR,2014-15,F,Iowa,Big Ten,34,1070,171,328,.521,150,269,21,59,.356,195,238,.819,71,177,248,48,45,16,41,53,558
1565,James Batemon,SR,2018-19,G,Loyola Marymount,WCC,34,1201,174,413,.421,131,262,43,151,.285,166,202,.822,21,84,105,122,54,1,103,79,557
1566,Murphy Burnatowski,SR,2012-13,F,Colgate,Patriot,32,974,203,474,.428,134,277,69,197,.350,82,112,.732,45,119,164,41,40,25,63,80,557
1567,Brandon Clark,JR,2013-14,G,Santa Clara,WCC,33,1058,178,419,.425,122,259,56,160,.350,145,167,.868,26,61,87,116,46,4,62,88,557
1568,Garret Covington,SR,2016-17,G,Western Illinois,Summit,28,974,178,428,.416,92,200,86,228,.377,115,131,.878,10,91,101,89,21,2,80,50,557
1569,Mo Evans,SR,2016-17,G,Purdue-Fort Wayne,Summit,33,1054,197,425,.464,97,194,100,231,.433,63,76,.829,14,88,102,205,51,5,103,80,557
1570,Jamaal Franklin,SO,2011-12,G,San Diego State,MWC,32,969,173,400,.433,122,243,51,157,.325,160,200,.800,57,195,252,47,31,20,95,81,557
1571,Jeremy Harris,JR,2017-18,G,Buffalo,MAC,36,1197,203,431,.471,111,211,92,220,.418,59,75,.787,48,164,212,77,36,26,46,76,557
1572,Chandler Hutchison,JR,2016-17,G,Boise State,MWC,32,1014,207,418,.495,181,349,26,69,.377,117,176,.665,38,212,250,84,39,6,86,87,557
1573,Kawhi Leonard,SO,2010-11,F,San Diego State,MWC,36,1172,211,475,.444,186,389,25,86,.291,110,145,.759,111,269,380,91,51,21,76,89,557
1574,Nick Mayo,JR,2017-18,F,Eastern Kentucky,OVC,31,1062,202,384,.526,169,310,33,74,.446,120,143,.839,47,161,208,67,24,46,98,88,557
1575,Mickey McConnell,SR,2010-11,G,Saint Mary's (CA),WCC,34,1255,177,351,.504,100,182,77,169,.456,126,142,.887,16,70,86,206,42,7,79,61,557
1578,Kwamain Mitchell,SO,2009-10,G,Saint Louis,A-10,35,1148,200,444,.450,136,266,64,178,.360,93,130,.715,18,88,106,106,50,2,86,81,557
1579,Isaiah Reese,SO,2017-18,G,Canisius,MAAC,33,1102,200,432,.463,117,201,83,231,.359,74,84,.881,18,172,190,154,73,5,87,71,557
1580,Tyrese Rice,SR,2008-09,G,Boston College,ACC,33,1101,162,392,.413,101,216,61,176,.347,172,201,.856,28,99,127,176,47,7,125,93,557
1581,Marcus Smart,SO,2013-14,G,Oklahoma State,Big 12,31,1014,163,386,.422,114,222,49,164,.299,182,250,.728,44,139,183,148,89,18,82,91,557
1582,Trey Sumler,SR,2013-14,G,Western Carolina,Southern,32,1138,177,422,.419,115,253,62,169,.367,141,176,.801,32,95,127,138,36,0,72,75,557
1583,Jordan Williams,SO,2010-11,F,Maryland,ACC,33,1073,213,396,.538,213,396,0,0,,131,228,.575,121,267,388,21,23,45,53,80,557
1584,Chris Clemons,FR,2015-16,G,Campbell,Big South,30,965,186,439,.424,94,193,92,246,.374,92,109,.844,10,101,111,54,45,8,57,75,556
1585,Lee Cummard,SR,2008-09,G,Brigham Young,MWC,33,1081,199,385,.517,163,292,36,93,.387,122,140,.871,47,158,205,111,30,30,54,82,556
1586,Sam Dekker,JR,2014-15,F,Wisconsin,Big Ten,40,1239,213,406,.525,163,255,50,151,.331,80,113,.708,77,143,220,49,21,18,36,42,556
1587,Damyean Dotson,SR,2016-17,G,Houston,AAC,32,1098,202,430,.470,94,186,108,244,.443,44,53,.830,49,173,222,36,29,5,33,53,556
1588,Tyler Johnson,SR,2013-14,G,Fresno State,MWC,35,1177,196,409,.479,139,277,57,132,.432,107,133,.805,56,200,256,103,36,13,47,98,556
1589,Aleks Maric,JR,2006-07,C,Nebraska,Big 12,30,864,203,359,.565,200,349,3,10,.300,147,216,.681,75,185,260,24,15,33,97,80,556
1590,Tywain McKee,SO,2006-07,G,Coppin State,MEAC,32,1087,180,449,.401,124,272,56,177,.316,140,182,.769,56,83,139,98,64,5,100,83,556
1591,Tony Murphy,SR,2007-08,G,Norfolk State,MEAC,31,1085,181,493,.367,108,256,73,237,.308,121,146,.829,17,78,95,76,54,3,104,30,556
1592,Rob Poole,JR,2013-14,G,Siena,MAAC,38,1289,177,429,.413,106,232,71,197,.360,131,171,.766,48,142,190,61,41,5,66,83,556
1593,Curtis Sumpter,SR,2006-07,F,Villanova,Big East,32,975,182,407,.447,130,265,52,142,.366,140,174,.805,82,148,230,28,30,28,70,97,556
1594,Melo Trimble,JR,2016-17,G,Maryland,Big Ten,33,1059,180,413,.436,122,230,58,183,.317,138,175,.789,9,110,119,121,36,5,100,59,556
1595,Mike Trimboli,JR,2007-08,G,Vermont,AEC,31,1130,186,425,.438,123,248,63,177,.356,121,140,.864,25,91,116,139,41,6,114,81,556
1596,LaMarcus Aldridge,SO,2005-06,F,Texas,Big 12,37,1247,219,385,.569,219,385,0,0,,117,181,.646,135,204,339,20,50,73,59,92,555
1597,Amanze Egekeze,SR,2017-18,F,Belmont,OVC,33,1139,185,365,.507,89,139,96,226,.425,89,111,.802,39,166,205,31,19,8,42,61,555
1600,Yogi Ferrell,JR,2014-15,G,Indiana,Big Ten,34,1186,181,412,.439,99,215,82,197,.416,111,129,.860,21,89,110,166,24,1,65,59,555
1601,Charron Fisher,JR,2006-07,F,Niagara,MAAC,27,904,188,412,.456,151,310,37,102,.363,142,185,.768,75,142,217,29,23,13,80,68,555
1602,Mike Gansey,SR,2005-06,F,West Virginia,Big East,33,1114,204,371,.550,129,196,75,175,.429,72,105,.686,65,124,189,64,62,10,43,32,555
1603,Darington Hobson,JR,2009-10,F,New Mexico,MWC,35,1175,193,439,.440,154,331,39,108,.361,130,199,.653,74,250,324,160,44,15,104,68,555
1604,David Kool,JR,2008-09,G,Western Michigan,MAC,31,1058,168,429,.392,110,234,58,195,.297,161,180,.894,15,112,127,62,44,0,84,72,555
1605,Trey Lewis,JR,2014-15,G,Cleveland State,Horizon,34,1204,186,417,.446,90,190,96,227,.423,87,115,.757,26,122,148,97,42,5,78,66,555
1606,Ray McCallum,SO,2011-12,G,Detroit Mercy,Horizon,36,1213,192,419,.458,162,294,30,125,.240,141,184,.766,37,126,163,143,57,7,80,74,555
1607,Sam Merrill,SO,2017-18,G,Utah State,MWC,34,1202,192,381,.504,94,170,98,211,.464,73,86,.849,7,104,111,107,35,7,62,75,555
1608,Carl Montgomery,SR,2010-11,F,Chicago State,GWC,32,879,209,398,.525,206,384,3,14,.214,134,217,.618,98,160,258,35,20,31,76,101,555
1609,Tanner Plomb,SR,2015-16,F,Army,Patriot,28,879,190,449,.423,110,222,80,227,.352,95,129,.736,17,144,161,42,25,8,48,48,555
1610,Scottie Reynolds,SO,2007-08,G,Villanova,Big East,35,1139,164,398,.412,85,192,79,206,.383,148,190,.779,17,90,107,113,51,1,107,75,555
1611,Rayvonte Rice,JR,2013-14,G,Illinois,Big Ten,35,1146,192,447,.430,146,291,46,156,.295,125,171,.731,44,166,210,53,58,12,55,86,555
1612,Rayvonte Rice,SO,2011-12,G,Drake,MVC,33,1101,190,436,.436,163,324,27,112,.241,148,209,.708,42,148,190,52,63,25,83,103,555
1613,Eric Williams,SR,2005-06,C,Wake Forest,ACC,34,1107,223,360,.619,223,360,0,0,,109,221,.493,107,194,301,34,44,37,77,87,555
1614,Matt Witt,SR,2005-06,G,Eastern Kentucky,OVC,30,1010,186,446,.417,89,186,97,260,.373,86,107,.804,8,59,67,132,34,2,99,56,555
1615,Marquis Wright,SR,2016-17,G,Siena,MAAC,33,1127,191,467,.409,138,316,53,151,.351,120,163,.736,43,94,137,165,37,5,93,71,555
1616,Bryce Alford,SO,2014-15,G,UCLA,Pac-12,36,1307,171,432,.396,78,194,93,238,.391,119,142,.838,6,108,114,176,34,1,89,54,554
1617,Jamar Butler,SR,2007-08,G,Ohio State,Big Ten,37,1341,184,428,.430,80,157,104,271,.384,82,87,.943,13,96,109,219,49,1,99,47,554
1618,Osiris Eldridge,SO,2007-08,G,Illinois State,MVC,35,1085,196,454,.432,112,236,84,218,.385,78,107,.729,56,143,199,68,47,11,75,70,554
1619,Chris Flemmings,SR,2016-17,G,North Carolina-Wilmington,CAA,35,1216,193,409,.472,123,210,70,199,.352,98,127,.772,39,157,196,76,48,26,76,68,554
1620,Rodney Green,SR,2009-10,G,La Salle,A-10,30,1113,204,491,.415,169,359,35,132,.265,111,158,.703,28,126,154,128,48,7,120,56,554
1621,Roy Devyn Marble,JR,2012-13,G,Iowa,Big Ten,37,1130,176,430,.409,127,280,49,150,.327,153,189,.810,34,113,147,112,42,10,80,50,554
1622,Dallas Moore,SO,2014-15,G,North Florida,A-Sun,35,1139,211,439,.481,150,282,61,157,.389,71,97,.732,33,78,111,128,35,1,82,42,554
1623,Anthony Raffa,SR,2012-13,G,Coastal Carolina,Big South,29,945,199,426,.467,139,256,60,170,.353,96,127,.756,23,81,104,42,55,6,57,66,554
1624,Matt Scott,SR,2017-18,G,Niagara,MAAC,29,959,179,422,.424,131,270,48,152,.316,148,208,.712,69,144,213,75,33,14,63,59,554
1625,Deonta Vaughn,SO,2007-08,G,Cincinnati,Big East,32,1069,178,408,.436,81,164,97,244,.398,101,128,.789,16,78,94,133,31,2,101,90,554
1626,Chris Warren,FR,2007-08,G,Mississippi,SEC,35,1097,183,462,.396,80,197,103,265,.389,85,106,.802,8,63,71,156,38,5,103,82,554
1627,Oshae Brissett,FR,2017-18,F,Syracuse,ACC,37,1411,162,458,.354,107,292,55,166,.331,174,221,.787,82,245,327,34,43,29,69,83,553
1628,Joe Cremo,SO,2016-17,G,Albany (NY),AEC,35,1241,185,409,.452,135,276,50,133,.376,133,153,.869,27,157,184,134,37,5,92,60,553
1629,Matthew Dellavedova,SR,2012-13,G,Saint Mary's (CA),WCC,35,1273,170,421,.404,84,196,86,225,.382,127,149,.852,23,95,118,223,40,4,99,61,553
1630,Blake Francis,SO,2017-18,G,Wagner,NEC,32,1046,182,423,.430,80,169,102,254,.402,87,108,.806,20,40,60,54,52,1,48,81,553
1631,Diante Garrett,SR,2010-11,G,Iowa State,Big 12,32,1175,214,518,.413,155,333,59,185,.319,66,80,.825,12,107,119,195,55,7,106,55,553
1632,Treveon Graham,JR,2013-14,G,Virginia Commonwealth,A-10,35,989,185,423,.437,127,251,58,172,.337,125,180,.694,69,176,245,70,32,6,63,83,553
1633,Nate Harris,SR,2005-06,F,Utah State,WAC,32,1068,215,346,.621,208,328,7,18,.389,116,156,.744,74,173,247,97,23,31,68,69,553
1634,Demetrius Jackson,JR,2015-16,G,Notre Dame,ACC,35,1259,193,428,.451,139,265,54,163,.331,113,139,.813,31,90,121,164,43,10,76,68,553
1635,Kevin McClain,SR,2018-19,G,Belmont,OVC,33,1101,185,399,.464,115,208,70,191,.366,113,161,.702,15,104,119,130,39,8,73,60,553
1636,Ramone Moore,SR,2011-12,G,Temple,A-10,32,1170,195,458,.426,138,309,57,149,.383,106,139,.763,29,109,138,110,35,5,82,78,553
1637,Malik Newman,SO,2017-18,G,Kansas,Big 12,39,1234,186,402,.463,101,197,85,205,.415,96,115,.835,20,176,196,82,42,6,57,61,553
1638,Derick Newton,FR,2015-16,F,Stetson,A-Sun,34,1061,171,384,.445,114,262,57,122,.467,154,186,.828,52,148,200,46,15,15,81,63,553
1639,Leon Powe,SO,2005-06,F,University of California,Pac-10,27,953,178,359,.496,175,350,3,9,.333,194,270,.719,89,184,273,38,24,15,66,67,553
1642,Marcquise Reed,JR,2017-18,G,Clemson,ACC,35,1221,183,426,.430,116,237,67,189,.354,120,142,.845,26,139,165,116,58,0,80,67,553
1643,Jaelan Sanford,JR,2017-18,G,Toledo,MAC,34,1175,186,412,.451,115,236,71,176,.403,110,130,.846,21,96,117,101,20,19,62,61,553
1644,Michael Thompson,SR,2010-11,G,Northwestern,Big Ten,34,1268,189,418,.452,94,176,95,242,.393,80,97,.825,12,62,74,147,49,2,64,75,553
1645,Terry Allen,SR,2015-16,F,Richmond,A-10,32,1065,193,392,.492,169,314,24,78,.308,142,195,.728,66,179,245,69,52,19,59,83,552
1646,Nick Calathes,FR,2007-08,G,Florida,SEC,36,1174,175,411,.426,117,253,58,158,.367,144,199,.724,41,146,187,221,58,3,104,76,552
1647,Gian Clavell,SR,2016-17,G,Colorado State,MWC,27,987,193,449,.430,115,247,78,202,.386,88,127,.693,37,133,170,47,53,20,53,58,552
1648,D.J. Cooper,SO,2010-11,G,Ohio,MAC,35,1248,180,471,.382,122,277,58,194,.299,134,179,.749,43,133,176,263,81,9,123,74,552
1649,Lee Cummard,JR,2007-08,G,Brigham Young,MWC,35,1101,198,348,.569,138,221,60,127,.472,96,112,.857,69,153,222,123,33,35,79,93,552
1650,Will Darley,SR,2016-17,G,Maryland-Baltimore County,AEC,34,1040,182,373,.488,92,170,90,203,.443,98,110,.891,33,100,133,64,15,3,60,80,552
1651,Ledrick Eackles,SR,2013-14,G,McNeese State,Southland,31,979,159,435,.366,81,221,78,214,.364,156,204,.765,37,116,153,73,48,5,91,78,552
1652,Yogi Ferrell,SO,2013-14,G,Indiana,Big Ten,32,1083,169,409,.413,81,189,88,220,.400,126,153,.824,9,86,95,125,24,1,84,54,552
1653,Kalin Fisher,SR,2018-19,G,Hampton,Big South,35,1216,182,455,.400,127,278,55,177,.311,133,165,.806,14,149,163,112,65,6,74,87,552
1654,T.J. Gibbs,SO,2017-18,G,Notre Dame,ACC,36,1348,171,416,.411,90,215,81,201,.403,129,154,.838,28,73,101,107,37,3,54,65,552
1655,Tim Hardaway,JR,2012-13,G,Michigan,Big Ten,38,1324,201,460,.437,128,265,73,195,.374,77,111,.694,9,168,177,93,26,17,71,73,552
1656,Brandon Hazzard,SR,2009-10,G,Troy,Sun Belt,33,1092,186,450,.413,103,233,83,217,.382,97,130,.746,10,56,66,52,37,0,77,66,552
1657,Erick Neal,SR,2017-18,G,Texas-Arlington,Sun Belt,33,1138,188,433,.434,95,191,93,242,.384,83,109,.761,24,114,138,222,65,3,122,79,552
1658,Joakim Noah,SO,2005-06,C,Florida,SEC,39,972,202,322,.627,202,321,0,1,.000,148,202,.733,85,193,278,80,44,95,76,84,552
1659,Zach Norvell,SO,2018-19,G,Gonzaga,WCC,37,1135,182,419,.434,85,157,97,262,.370,91,105,.867,29,130,159,116,47,3,53,67,552
1660,Giddy Potts,JR,2016-17,G,Middle Tennessee,CUSA,36,1098,196,407,.482,120,209,76,198,.384,84,104,.808,33,159,192,72,47,8,47,87,552
1661,Omar Prewitt,JR,2015-16,G,William & Mary,CAA,31,998,188,381,.493,145,263,43,118,.364,133,189,.704,26,136,162,77,24,16,59,71,552
1664,Devon Saddler,SR,2013-14,G,Delaware,CAA,28,1037,190,433,.439,143,305,47,128,.367,125,176,.710,30,89,119,101,24,7,61,61,552
1665,Cameron Wells,SR,2010-11,G,The Citadel,Southern,32,1145,197,451,.437,178,374,19,77,.247,139,168,.827,18,144,162,138,46,11,78,63,552
1666,Jake White,SR,2015-16,F,Omaha,Summit,32,829,197,347,.568,175,304,22,43,.512,136,168,.810,74,125,199,10,10,7,48,97,552
1667,Brandon Wood,JR,2010-11,G,Valparaiso,Horizon,33,1053,207,447,.463,146,279,61,168,.363,77,116,.664,32,110,142,103,55,6,72,51,552
1668,Jamie Adams,SR,2013-14,G,Florida A&M,MEAC,32,969,157,399,.393,80,195,77,204,.377,160,202,.792,17,63,80,118,48,1,103,84,551
1669,Ian Baker,SR,2016-17,G,New Mexico State,WAC,33,1079,164,421,.390,101,216,63,205,.307,160,193,.829,17,123,140,137,42,4,74,55,551
1670,Tookie Brown,FR,2015-16,G,Georgia Southern,Sun Belt,31,956,177,408,.434,127,274,50,134,.373,147,181,.812,18,82,100,104,51,4,69,81,551
1671,Kannon Burrage,SR,2012-13,G,Texas-San Antonio,WAC,32,1120,184,485,.379,126,312,58,173,.335,125,164,.762,54,104,158,43,29,2,78,60,551
1672,Tre Bussey,SR,2013-14,G,Georgia Southern,Southern,34,1186,197,431,.457,140,283,57,148,.385,100,151,.662,36,92,128,66,33,3,51,40,551
1673,Thomas Gardner,JR,2005-06,G,Missouri,Big 12,28,957,186,434,.429,92,197,94,237,.397,85,118,.720,31,59,90,45,27,0,92,59,551
1674,Rodney Green,JR,2008-09,G,La Salle,A-10,31,1093,199,418,.476,170,334,29,84,.345,124,176,.705,30,124,154,105,58,5,100,79,551
1675,Nigel Hayes,JR,2015-16,F,Wisconsin,Big Ten,35,1267,161,438,.368,122,305,39,133,.293,190,258,.736,69,135,204,104,39,14,79,71,551
1676,Trevor Lacey,JR,2014-15,G,North Carolina State,ACC,35,1256,190,436,.436,112,237,78,199,.392,93,126,.738,27,133,160,121,31,7,67,56,551
1677,Tayler Persons,SR,2018-19,G,Ball State,MAC,33,1058,199,451,.441,154,311,45,140,.321,108,135,.800,12,119,131,143,35,4,107,68,551
1678,Jamarr Sanders,SR,2010-11,G,Alabama-Birmingham,CUSA,31,1080,197,462,.426,107,229,90,233,.386,67,83,.807,29,113,142,58,27,10,91,60,551
1679,Steven Smith,SR,2005-06,F,La Salle,A-10,28,1009,208,428,.486,182,351,26,77,.338,109,141,.773,58,162,220,69,32,23,100,72,551
1680,Ovie Soko,SR,2013-14,F,Duquesne,A-10,30,930,171,366,.467,157,315,14,51,.275,195,289,.675,61,179,240,50,26,19,80,95,551
1681,Ameen Tanksley,JR,2014-15,G,Hofstra,CAA,34,1105,180,402,.448,106,216,74,186,.398,117,169,.692,60,128,188,49,48,8,68,82,551
1682,Ken Tutt,SR,2006-07,G,Oral Roberts,Mid-Cont,34,1209,184,447,.412,100,230,84,217,.387,99,135,.733,12,74,86,84,36,4,94,58,551
1683,Cameron Wells,JR,2009-10,G,The Citadel,Southern,32,1131,196,480,.408,179,415,17,65,.262,142,164,.866,39,142,181,132,47,12,69,69,551
1686,Rashad West,JR,2006-07,G,Hampton,MEAC,31,960,160,405,.395,88,222,72,183,.393,159,198,.803,31,80,111,82,58,0,107,76,551
1687,C.J. Wilkerson,SR,2010-11,G,North Carolina Central,Ind,29,1077,160,344,.465,116,232,44,112,.393,187,251,.745,17,81,98,53,30,2,94,73,551
1688,Frank Young,SR,2006-07,F,West Virginia,Big East,36,1152,189,425,.445,72,155,117,270,.433,56,77,.727,45,112,157,65,49,7,61,71,551
1689,Joe Zeglinski,SO,2007-08,G,Hartford,AEC,34,1196,190,433,.439,87,182,103,251,.410,68,96,.708,43,91,134,89,28,4,70,77,551
1690,Nickeil Alexander-Walker,SO,2018-19,G,Virginia Tech,ACC,34,1167,190,401,.474,132,246,58,155,.374,112,144,.778,16,123,139,135,64,18,97,78,550
1691,Tyus Battle,JR,2018-19,G,Syracuse,ACC,32,1162,188,436,.431,146,305,42,131,.321,132,173,.763,21,84,105,80,37,8,57,68,550
1692,DeAndre Bembry,SO,2014-15,F,Saint Joseph's,A-10,31,1197,199,461,.432,149,308,50,153,.327,102,160,.638,49,191,240,111,60,29,89,73,550
1693,DeJuan Blair,SO,2008-09,F,Pittsburgh,Big East,35,955,226,381,.593,226,381,0,0,,98,162,.605,195,237,432,42,54,34,44,95,550
1694,Marqus Blakely,SO,2007-08,F,Vermont,AEC,29,986,198,360,.550,197,354,1,6,.167,153,271,.565,110,210,320,67,57,79,73,80,550
1695,Craig Bradshaw,JR,2014-15,G,Belmont,OVC,30,950,197,401,.491,115,207,82,194,.423,74,99,.747,14,101,115,94,48,11,93,62,550
1696,Jason Burnell,SR,2018-19,F,Jacksonville State,OVC,32,1081,194,383,.507,165,292,29,91,.319,133,166,.801,100,208,308,98,34,29,66,89,550
1697,James Florence,SR,2009-10,G,Mercer,A-Sun,31,1027,173,427,.405,116,246,57,181,.315,147,197,.746,19,78,97,142,54,12,116,90,550
1698,Chris Fouch,SR,2013-14,G,Drexel,CAA,30,1062,186,466,.399,114,244,72,222,.324,106,129,.822,20,77,97,60,26,3,38,83,550
1699,Harald Frey,JR,2018-19,G,Montana State,Big Sky,32,1056,169,384,.440,94,190,75,194,.387,137,162,.846,26,117,143,159,39,0,61,65,550
1700,Sheldon McClellan,JR,2014-15,G,Miami (FL),ACC,38,1278,192,397,.484,138,246,54,151,.358,112,136,.824,32,146,178,74,34,7,49,59,550
1701,Jon Scheyer,JR,2008-09,G,Duke,ACC,37,1214,146,368,.397,67,163,79,205,.385,179,214,.836,42,92,134,102,58,6,57,62,550
1702,Trevis Simpson,SO,2011-12,G,North Carolina-Greensboro,Southern,30,835,186,486,.383,125,290,61,196,.311,117,155,.755,43,84,127,22,23,6,67,92,550
1703,Jarvis Williams,SR,2014-15,F,Murray State,OVC,35,1085,199,351,.567,199,350,0,1,.000,152,228,.667,135,158,293,32,26,35,48,95,550
1704,Milik Yarbrough,SR,2018-19,F,Illinois State,MVC,33,966,202,438,.461,169,341,33,97,.340,113,145,.779,32,196,228,101,24,18,133,86,550
1705,Desmond Yates,JR,2008-09,F,Middle Tennessee,Sun Belt,32,964,228,394,.579,208,334,20,60,.333,74,94,.787,44,101,145,8,20,13,58,103,550
1708,Javon Bess,SR,2018-19,F,Saint Louis,A-10,36,1323,172,437,.394,106,234,66,203,.325,139,176,.790,40,204,244,64,50,8,45,83,549
1709,Craig Bradshaw,SO,2013-14,G,Belmont,OVC,35,1080,191,378,.505,126,214,65,164,.396,102,126,.810,27,94,121,111,45,7,94,74,549
1710,John Brown,SR,2015-16,F,High Point,Big South,28,830,212,352,.602,211,351,1,1,1.000,124,177,.701,91,108,199,62,48,49,48,60,549
1711,Antonius Cleveland,SR,2016-17,G,Southeast Missouri State,OVC,33,1086,208,383,.543,180,310,28,73,.384,105,159,.660,28,141,169,73,47,30,66,85,549
1712,Will Figures,SR,2009-10,G,Northern Colorado,Big Sky,33,1058,151,358,.422,92,215,59,143,.413,188,221,.851,25,95,120,91,34,1,76,80,549
1713,Anthony Fisher,JR,2006-07,G,Tennessee Tech,OVC,32,1114,160,384,.417,98,198,62,186,.333,167,209,.799,23,99,122,136,32,4,82,75,549
1714,Chad Frazier,JR,2013-14,G,Alabama-Birmingham,CUSA,31,1095,170,424,.401,109,244,61,180,.339,148,203,.729,17,86,103,132,35,10,123,62,549
1715,Montrezl Harrell,JR,2014-15,F,Louisville,ACC,35,1229,213,376,.566,204,339,9,37,.243,114,191,.597,111,210,321,49,33,42,69,74,549
1716,Aaron Harrison,FR,2013-14,G,Kentucky,SEC,40,1303,174,411,.423,112,237,62,174,.356,139,176,.790,25,93,118,74,43,12,65,85,549
1717,Zaid Hearst,SR,2014-15,G,Quinnipiac,MAAC,30,1106,197,456,.432,157,312,40,144,.278,115,149,.772,69,113,182,76,15,10,67,66,549
1718,Tamir Jackson,SR,2012-13,G,Rice,CUSA,31,1090,196,506,.387,149,332,47,174,.270,110,158,.696,44,142,186,78,42,2,90,81,549
1719,Doron Lamb,SO,2011-12,G,Kentucky,SEC,40,1249,175,369,.474,99,206,76,163,.466,123,149,.826,15,93,108,60,19,2,44,72,549
1720,Greg Monroe,SO,2009-10,C,Georgetown,Big East,34,1164,202,385,.525,195,358,7,27,.259,138,209,.660,74,254,328,128,42,52,112,87,549
1721,Andy Ogide,SR,2010-11,F,Colorado State,MWC,32,944,215,366,.587,206,342,9,24,.375,110,169,.651,76,170,246,21,26,18,75,90,549
1722,Ladarius Tabb,SR,2015-16,G,Alabama A&M,SWAC,29,1000,201,457,.440,156,304,45,153,.294,102,160,.638,58,143,201,21,41,8,50,73,549
1723,Trey Thompkins,SO,2009-10,F,Georgia,SEC,31,962,207,429,.483,184,368,23,61,.377,112,147,.762,65,193,258,60,30,36,91,81,549
1724,Quinton Upshur,SR,2014-15,G,Northern Arizona,Big Sky,38,1131,172,454,.379,90,207,82,247,.332,123,165,.745,20,110,130,44,33,41,48,106,549
1725,Nick Aldridge,FR,2006-07,F,Western Carolina,Southern,30,975,203,440,.461,194,403,9,37,.243,133,211,.630,78,132,210,50,50,10,81,82,548
1726,Kamar Baldwin,SO,2017-18,G,Butler,Big East,35,1191,210,475,.442,161,327,49,148,.331,79,102,.775,13,159,172,111,54,15,75,89,548
1727,Ignas Brazdeikis,FR,2018-19,F,Michigan,Big Ten,37,1096,188,407,.462,132,264,56,143,.392,116,150,.773,43,158,201,31,26,18,46,79,548
1728,Vladimir Brodziansky,JR,2016-17,F,Texas Christian,Big 12,39,934,203,360,.564,192,330,11,30,.367,131,169,.775,85,137,222,24,13,82,42,81,548
1729,Quinton Day,JR,2005-06,G,Kansas City,Mid-Cont,27,1037,186,460,.404,113,264,73,196,.372,103,127,.811,17,81,98,130,76,0,108,46,548
1730,Matt Dickey,SR,2011-12,G,North Carolina-Asheville,Big South,34,1130,152,339,.448,90,170,62,169,.367,182,210,.867,26,87,113,124,50,2,81,76,548
1731,Ella Ellis,SR,2012-13,F,Army,Patriot,31,839,149,332,.449,77,160,72,172,.419,178,209,.852,25,92,117,44,21,20,66,71,548
1732,Jonny Flynn,FR,2007-08,G,Syracuse,Big East,35,1243,191,416,.459,135,255,56,161,.348,110,142,.775,22,72,94,185,53,6,95,51,548
1733,K.T. Harrell,JR,2013-14,G,Auburn,SEC,30,979,174,402,.433,108,218,66,184,.359,134,154,.870,20,99,119,64,24,6,86,77,548
1734,George Hill,SO,2005-06,G,IUPUI,Mid-Cont,29,1019,175,338,.518,159,288,16,50,.320,182,228,.798,62,111,173,105,49,9,80,79,548
1735,Anthony Ireland,SO,2011-12,G,Loyola Marymount,WCC,34,1241,190,432,.440,140,284,50,148,.338,118,153,.771,35,96,131,168,58,0,104,68,548
1736,Mike James,SR,2011-12,G,Lamar,Southland,32,995,211,466,.453,172,346,39,120,.325,87,108,.806,30,72,102,63,50,4,66,67,548
1737,Tiwian Kendley,SR,2017-18,G,Morgan State,MEAC,21,692,173,382,.453,141,265,32,117,.274,170,226,.752,26,58,84,46,45,7,75,59,548
1738,Denzel Livingston,JR,2013-14,G,Incarnate Word,Southland,27,888,174,349,.499,120,212,54,137,.394,146,189,.772,40,133,173,102,68,38,73,57,548
1739,Dejounte Murray,FR,2015-16,G,Washington,Pac-12,34,1139,202,486,.416,168,368,34,118,.288,110,166,.663,48,155,203,151,62,10,110,90,548
1740,Tylor Ongwae,SR,2014-15,F,Louisiana-Monroe,Sun Belt,38,1347,198,485,.408,173,382,25,103,.243,127,152,.836,93,159,252,110,37,11,93,82,548
1741,Wesley Person,JR,2016-17,G,Troy,Sun Belt,37,1160,164,378,.434,70,143,94,235,.400,126,154,.818,20,76,96,58,21,2,49,50,548
1742,Kassius Robertson,JR,2016-17,G,Canisius,MAAC,34,1135,178,398,.447,80,159,98,239,.410,94,117,.803,30,77,107,82,30,5,53,52,548
1743,Clarence Sanders,SR,2006-07,G,Mississippi,SEC,34,1058,206,486,.424,110,224,96,262,.366,40,51,.784,30,55,85,51,41,15,47,59,548
1744,Dyami Starks,SO,2012-13,G,Bryant,NEC,31,1031,193,429,.450,98,196,95,233,.408,67,79,.848,18,70,88,49,16,5,69,58,548
1745,Ricky Tarrant,SO,2012-13,G,Tulane,CUSA,35,1237,155,418,.371,84,199,71,219,.324,167,206,.811,19,78,97,125,47,2,89,80,548
1746,Rashawn Thomas,JR,2015-16,F,Texas A&M-Corpus Christi,Southland,33,870,206,373,.552,202,357,4,16,.250,132,191,.691,95,170,265,35,31,75,103,129,548
1747,Jake Toolson,JR,2018-19,G,Utah Valley,WAC,35,1164,188,350,.537,119,196,69,154,.448,103,121,.851,31,125,156,80,18,7,83,59,548
1750,Nic Wise,JR,2008-09,G,Arizona,Pac-10,35,1273,177,392,.452,111,233,66,159,.415,128,151,.848,13,75,88,160,52,3,101,86,548
1751,Francis Alonso,JR,2017-18,G,North Carolina-Greensboro,Southern,35,1026,175,425,.412,64,148,111,277,.401,86,99,.869,16,67,83,103,36,2,87,82,547
1752,Nick Barbour,SO,2009-10,G,High Point,Big South,29,816,171,402,.425,98,220,73,182,.401,132,173,.763,21,68,89,31,37,9,72,81,547
1753,AJ Brodeur,JR,2018-19,F,Pennsylvania,Ivy,31,1007,224,424,.528,208,377,16,47,.340,83,144,.576,63,194,257,113,30,41,84,74,547
1754,Anthony Brown,SR,2014-15,G,Stanford,Pac-12,37,1320,176,408,.431,97,229,79,179,.441,116,146,.795,42,214,256,94,28,7,72,78,547
1755,Luguentz Dort,FR,2018-19,G,Arizona State,Pac-12,34,1072,174,430,.405,120,254,54,176,.307,145,207,.700,44,101,145,79,52,7,99,102,547
1756,Alex Franklin,SR,2009-10,F,Siena,MAAC,34,1117,191,344,.555,191,344,0,0,,165,247,.668,93,184,277,46,47,30,81,76,547
1757,Kevin Hamilton,SR,2005-06,G,Holy Cross,Patriot,31,1120,160,420,.381,97,230,63,190,.332,164,211,.777,41,155,196,108,102,14,118,82,547
1758,Zach Jackson,JR,2017-18,G,Omaha,Summit,31,986,192,367,.523,150,269,42,98,.429,121,147,.823,47,150,197,29,35,12,68,71,547
1759,Tre Kelley,SR,2006-07,G,South Carolina,SEC,29,1064,198,454,.436,143,297,55,157,.350,96,120,.800,13,61,74,149,26,7,83,66,547
1760,Tanner Leissner,JR,2016-17,F,New Hampshire,AEC,32,1102,185,394,.470,164,321,21,73,.288,156,188,.830,73,148,221,57,15,10,56,84,547
1761,J.R. Lynch,SR,2018-19,G,Hartford,AEC,33,1253,176,388,.454,107,214,69,174,.397,126,150,.840,21,102,123,126,70,4,65,78,547
1762,Rodney McGruder,SR,2012-13,G,Kansas State,Big 12,35,1171,204,462,.442,153,310,51,152,.336,88,117,.752,74,114,188,71,44,9,58,54,547
1763,Isaiah Miller,SO,2018-19,G,North Carolina-Greensboro,Southern,36,1002,230,448,.513,208,370,22,78,.282,65,117,.556,54,108,162,75,103,10,60,73,547
1764,Elijah Millsap,JR,2009-10,G,Alabama-Birmingham,CUSA,34,1124,182,418,.435,163,339,19,79,.241,164,236,.695,92,232,324,60,56,11,118,111,547
1765,Stan Okoye,JR,2011-12,F,Virginia Military Institute,Big South,32,924,200,385,.519,183,321,17,64,.266,130,194,.670,59,172,231,64,47,22,87,88,547
1766,Ahmaad Rorie,SO,2016-17,G,Montana,Big Sky,31,1007,192,428,.449,129,264,63,164,.384,100,120,.833,25,84,109,97,26,7,47,66,547
1767,Martin Samarco,JR,2005-06,F,Bowling Green State,MAC,29,1035,175,418,.419,75,199,100,219,.457,97,113,.858,34,85,119,36,27,2,68,70,547
1768,Chad Tomko,SR,2010-11,G,North Carolina-Wilmington,CAA,31,1132,190,459,.414,110,243,80,216,.370,87,107,.813,18,164,182,132,58,8,100,60,547
1769,Marcus Tyus,SR,2016-17,G,Omaha,Summit,32,885,171,355,.482,99,194,72,161,.447,133,163,.816,19,77,96,55,50,3,76,90,547
1772,Marcus Walker,JR,2007-08,G,Colorado State,MWC,32,1069,206,467,.441,148,272,58,195,.297,77,100,.770,16,76,92,84,35,3,72,75,547
1773,Ray Barbosa,SR,2007-08,G,Maryland-Baltimore County,AEC,33,1104,179,420,.426,93,189,86,231,.372,102,122,.836,27,108,135,70,29,3,56,65,546
1774,Bradley Beal,FR,2011-12,G,Florida,SEC,37,1267,175,393,.445,112,207,63,186,.339,133,173,.769,50,199,249,83,51,31,79,76,546
1775,Bobby Brown,SR,2006-07,G,Cal State Fullerton,Big West,27,933,188,402,.468,108,196,80,206,.388,90,114,.789,16,56,72,138,35,3,96,64,546
1776,Stevie Browning,SR,2016-17,G,Marshall,CUSA,34,1084,204,449,.454,134,272,70,177,.395,68,83,.819,30,111,141,112,38,7,57,61,546
1777,Russell Carter,SR,2006-07,G,Notre Dame,Big East,32,974,191,443,.431,107,230,84,213,.394,80,112,.714,40,117,157,59,51,11,69,70,546
1778,Wes Channels,JR,2008-09,G,Austin Peay,OVC,33,1085,173,412,.420,94,209,79,203,.389,121,156,.776,29,95,124,103,42,2,100,88,546
1779,Patrick Christopher,SR,2009-10,G,University of California,Pac-10,35,1209,204,457,.446,146,285,58,172,.337,80,93,.860,50,140,190,71,56,3,50,72,546
1780,LaceDarius Dunn,SR,2010-11,G,Baylor,Big 12,28,987,169,425,.398,80,176,89,249,.357,119,144,.826,22,80,102,60,39,1,100,67,546
1781,James Feldeine,SR,2009-10,G,Quinnipiac,NEC,33,1070,197,463,.425,159,352,38,111,.342,114,143,.797,44,148,192,81,47,6,84,73,546
1782,Anthony Fisher,SR,2007-08,G,Tennessee Tech,OVC,32,1063,157,370,.424,110,210,47,160,.294,185,243,.761,18,80,98,114,48,1,108,90,546
1783,Juan'ya Green,SO,2012-13,G,Niagara,MAAC,33,1253,176,438,.402,120,269,56,169,.331,138,171,.807,23,108,131,163,63,14,89,55,546
1784,Ricky Harris,JR,2008-09,G,Massachusetts,A-10,30,973,173,416,.416,86,191,87,225,.387,113,143,.790,11,75,86,45,40,5,78,58,546
1785,Kenny Hasbrouck,JR,2007-08,G,Siena,MAAC,34,1074,199,450,.442,143,306,56,144,.389,92,128,.719,33,80,113,76,77,6,61,74,546
1786,Jalen Hayes,SR,2017-18,F,Oakland,Horizon,29,1036,212,404,.525,207,381,5,23,.217,117,141,.830,68,167,235,57,29,25,70,93,546
1787,Jelani Hewitt,SR,2014-15,G,Georgia Southern,Sun Belt,31,1087,149,424,.351,60,158,89,266,.335,159,197,.807,31,99,130,114,77,10,80,57,546
1788,Anthony Johnson,SR,2009-10,F,Fairfield,MAAC,34,1039,208,404,.515,208,401,0,3,.000,130,207,.628,158,176,334,17,41,82,63,103,546
1789,Mark Lyons,SR,2012-13,G,Arizona,Pac-12,35,1062,177,407,.435,110,206,67,201,.333,125,146,.856,8,60,68,99,38,2,95,86,546
1790,J.P. Macura,JR,2016-17,G,Xavier,Big East,38,1272,179,420,.426,115,232,64,188,.340,124,158,.785,50,117,167,110,54,8,77,90,546
1791,Randolph Morris,JR,2006-07,C,Kentucky,SEC,34,937,202,341,.592,202,341,0,0,,142,208,.683,67,197,264,37,26,70,74,80,546
1794,Keiton Page,SR,2011-12,G,Oklahoma State,Big 12,32,1139,164,395,.415,61,128,103,267,.386,115,135,.852,2,55,57,71,48,0,51,78,546
1795,T.J. Price,SR,2014-15,G,Western Kentucky,CUSA,32,1069,175,395,.443,94,199,81,196,.413,115,141,.816,21,150,171,127,30,2,82,86,546
1796,Rodney Pryor,JR,2014-15,G,Robert Morris,NEC,35,1028,201,418,.481,120,229,81,189,.429,63,84,.750,41,123,164,62,41,11,50,79,546
1797,Jordan Theodore,SR,2011-12,G,Seton Hall,Big East,34,1227,176,452,.389,132,314,44,138,.319,150,182,.824,28,78,106,226,61,2,99,67,546
1798,Will Thomas,SR,2007-08,F,George Mason,CAA,34,1212,208,324,.642,207,323,1,1,1.000,129,192,.672,85,268,353,67,31,18,52,60,546
1799,De'Angelo Alexander,JR,2005-06,G,Charlotte,A-10,32,1111,181,447,.405,85,223,96,224,.429,87,119,.731,88,107,195,59,35,10,52,63,545
1800,Jarrell Brown,SR,2007-08,G,Army,Patriot,30,1091,190,449,.423,89,197,101,252,.401,64,80,.800,16,102,118,58,48,2,51,49,545
1801,Justin Cobbs,SR,2013-14,G,University of California,Pac-12,35,1206,185,397,.466,153,301,32,96,.333,143,175,.817,17,85,102,204,29,3,85,64,545
1802,D.J. Cooper,JR,2011-12,G,Ohio,MAC,37,1199,162,465,.348,87,221,75,244,.307,146,196,.745,28,109,137,211,85,3,106,51,545
1803,Dwayne Davis,SR,2012-13,F,Southern Mississippi,CUSA,34,1026,193,395,.489,134,252,59,143,.413,100,127,.787,21,132,153,87,39,6,114,91,545
1804,James Ennis,SR,2012-13,G,Cal State Long Beach,Big West,33,1093,182,371,.491,127,217,55,154,.357,126,151,.834,65,156,221,70,58,43,99,75,545
1805,Buddy Hield,SO,2013-14,G,Oklahoma,Big 12,33,1059,196,440,.445,106,207,90,233,.386,63,84,.750,58,88,146,62,46,5,60,72,545
1806,Kris Jenkins,JR,2015-16,F,Villanova,Big East,40,1134,179,390,.459,79,131,100,259,.386,87,103,.845,20,136,156,87,32,16,52,103,545
1807,Carl Jones,SO,2010-11,G,Saint Joseph's,A-10,32,1086,163,396,.412,109,250,54,146,.370,165,221,.747,13,71,84,110,36,2,78,57,545
1808,Jaron Jones,SR,2011-12,G,Eastern Kentucky,OVC,32,1085,187,352,.531,163,288,24,64,.375,147,190,.774,55,87,142,59,46,8,60,85,545
1809,Walt Lemon ,JR,2012-13,G,Bradley,MVC,35,1200,201,446,.451,166,340,35,106,.330,108,142,.761,19,128,147,133,75,14,129,99,545
1810,Robert Merritt,SR,2005-06,F,Samford,OVC,31,1159,180,386,.466,60,134,120,252,.476,65,80,.813,29,131,160,53,33,2,58,49,545
1811,Jaylen Nowell,FR,2017-18,G,Washington,Pac-12,34,1106,203,450,.451,164,339,39,111,.351,100,125,.800,33,102,135,92,36,9,85,96,545
1812,Trent Plaisted,JR,2007-08,F,Brigham Young,MWC,35,958,202,373,.542,202,373,0,0,,141,260,.542,75,194,269,54,15,34,84,82,545
1813,Richard Roby,SR,2007-08,G,Colorado,Big 12,32,1110,189,396,.477,142,273,47,123,.382,120,157,.764,58,156,214,66,33,31,107,104,545
1816,Brandan Wright,FR,2006-07,F,North Carolina,ACC,37,1013,228,353,.646,228,353,0,0,,89,157,.567,77,152,229,37,36,65,59,55,545
1817,Damen Bell-Holter,SR,2012-13,F,Oral Roberts,Southland,35,1106,190,371,.512,185,353,5,18,.278,159,211,.754,117,211,328,42,19,47,71,103,544
1818,Leon Buchanan,SR,2008-09,F,Morehead State,OVC,36,1242,177,343,.516,174,339,3,4,.750,187,233,.803,107,120,227,37,27,12,80,83,544
1819,Cleanthony Early,JR,2012-13,F,Wichita State,MVC,39,979,184,404,.455,137,256,47,148,.318,129,163,.791,89,123,212,23,29,35,61,100,544
1820,Michael Ertel,SO,2018-19,G,Louisiana-Monroe,Sun Belt,35,1272,191,436,.438,111,256,80,180,.444,82,91,.901,13,93,106,99,23,5,44,56,544
1821,Austin Freeman,JR,2009-10,G,Georgetown,Big East,33,1135,201,383,.525,142,250,59,133,.444,83,97,.856,31,86,117,80,30,7,63,61,544
1822,Treveon Graham,SO,2012-13,G,Virginia Commonwealth,A-10,36,995,186,413,.450,134,271,52,142,.366,120,164,.732,99,110,209,56,32,5,56,81,544
1823,Tyler Hall,JR,2017-18,G,Montana State,Big Sky,31,995,174,428,.407,75,162,99,266,.372,97,107,.907,23,93,116,86,25,12,56,53,544
1824,D'Angelo Harrison,FR,2011-12,G,St. John's (NY),Big East,32,1130,158,421,.375,82,214,76,207,.367,152,189,.804,41,83,124,66,52,8,69,94,544
1825,Brad Jones,JR,2006-07,G,Wyoming,MWC,30,1113,157,396,.396,125,293,32,103,.311,198,253,.783,40,113,153,135,45,2,130,90,544
1826,Chavaughn Lewis,JR,2013-14,G,Marist,MAAC,31,1073,185,465,.398,157,374,28,91,.308,146,196,.745,22,134,156,88,60,11,98,89,544
1827,Kelvin Lewis,SR,2009-10,G,Houston,CUSA,35,1278,183,443,.413,81,186,102,257,.397,76,97,.784,38,102,140,41,63,10,24,75,544
1828,Kelan Martin,JR,2016-17,F,Butler,Big East,34,977,180,421,.428,116,237,64,184,.348,120,153,.784,34,162,196,40,23,14,66,74,544
1829,Drew McDonald,JR,2017-18,F,Northern Kentucky,Horizon,32,979,196,422,.464,141,259,55,163,.337,97,121,.802,62,246,308,72,16,16,70,74,544
1830,Darren Moore,SR,2010-11,G,UC-Irvine,Big West,32,979,169,337,.501,127,219,42,118,.356,164,223,.735,52,137,189,55,58,5,81,101,544
1831,Juwan Morgan,SR,2018-19,F,Indiana,Big Ten,35,1045,215,385,.558,189,297,26,88,.295,88,136,.647,88,199,287,65,41,54,68,100,544
1832,Patrick Patterson,JR,2009-10,F,Kentucky,SEC,38,1255,215,374,.575,191,305,24,69,.348,90,130,.692,116,167,283,36,27,51,41,61,544
1833,Kyle Roemer,SR,2009-10,F,Colgate,Patriot,29,999,192,447,.430,116,241,76,206,.369,84,106,.792,39,125,164,40,43,6,79,75,544
1834,Alex Rosenberg,JR,2013-14,F,Columbia,Ivy,34,984,133,308,.432,82,190,51,118,.432,227,276,.822,39,86,125,45,24,3,55,71,544
1835,Carlos Taylor,SR,2007-08,G,Montana State,Big Sky,30,887,184,402,.458,124,251,60,151,.397,116,144,.806,21,93,114,63,28,7,75,85,544
1836,Brandon Triche,SR,2012-13,G,Syracuse,Big East,40,1348,185,445,.416,136,275,49,170,.288,125,168,.744,57,79,136,144,51,5,109,86,544
1837,Kendall Williams,SR,2013-14,G,New Mexico,MWC,34,1200,151,351,.430,88,189,63,162,.389,179,226,.792,25,96,121,168,53,2,68,61,544
1838,A.J. Abrams,SO,2006-07,G,Texas,Big 12,35,1242,175,441,.397,55,157,120,284,.423,73,79,.924,25,61,86,52,46,4,48,63,543
1839,Hassan Adams,SR,2005-06,G,Arizona,Pac-10,31,1031,234,490,.478,217,425,17,65,.262,58,95,.611,67,88,155,90,82,14,69,60,543
1840,Deandre Burnett,JR,2016-17,G,Mississippi,SEC,33,989,139,391,.355,66,197,73,194,.376,192,218,.881,15,55,70,104,34,6,94,60,543
1841,Xavier Cooks,JR,2016-17,G,Winthrop,Big South,33,956,196,402,.488,158,293,38,109,.349,113,162,.698,53,247,300,92,29,56,95,87,543
1842,Alpha Diallo,JR,2018-19,G,Providence,Big East,34,1205,176,419,.420,136,299,40,120,.333,151,224,.674,88,188,276,106,56,17,91,87,543
1843,Fuquan Edwin,JR,2012-13,G,Seton Hall,Big East,33,1067,190,431,.441,127,278,63,153,.412,100,148,.676,46,145,191,63,79,17,84,101,543
1844,Issiah Grayson,SR,2013-14,G,Cal State Bakersfield,WAC,32,1017,171,341,.501,100,195,71,146,.486,130,160,.813,21,69,90,124,46,1,90,80,543
1845,Chris Hass,JR,2014-15,G,Bucknell,Patriot,34,1007,181,423,.428,99,215,82,208,.394,99,119,.832,20,93,113,38,17,11,51,58,543
1846,John Holland,SO,2008-09,F,Boston University,AEC,30,1065,185,399,.464,105,197,80,202,.396,93,121,.769,67,99,166,32,53,10,52,70,543
1847,Scotty Hopson,JR,2010-11,G,Tennessee,SEC,32,937,188,416,.452,135,275,53,141,.376,114,155,.735,28,79,107,41,26,5,89,63,543
1848,Zach LeDay,JR,2015-16,F,Virginia Tech,ACC,35,1078,181,379,.478,160,320,21,59,.356,160,210,.762,102,173,275,48,27,58,57,100,543
1849,Zach LeDay,SR,2016-17,F,Virginia Tech,ACC,32,945,183,340,.538,172,300,11,40,.275,166,215,.772,82,160,242,40,19,33,60,90,543
1850,Preston Parks,FR,2016-17,G,The Citadel,Southern,31,841,185,456,.406,108,222,77,234,.329,96,116,.828,30,64,94,116,60,5,78,62,543
1851,Sebastian Saiz,SR,2016-17,F,Mississippi,SEC,36,1200,181,386,.469,160,313,21,73,.288,160,215,.744,122,287,409,36,36,38,80,116,543
1852,Jovonni Shuler,SR,2010-11,G,Savannah State,Ind,30,1041,173,433,.400,96,213,77,220,.350,120,163,.736,38,117,155,59,40,11,80,74,543
1853,Devin Watson,SR,2018-19,G,San Diego State,MWC,34,1155,168,421,.399,79,188,89,233,.382,118,158,.747,13,93,106,142,29,0,89,44,543
1854,Keoni Watson,SR,2006-07,G,Idaho,WAC,30,941,191,435,.439,121,262,70,173,.405,91,117,.778,16,74,90,65,37,1,100,82,543
1855,Jalen Adams,JR,2017-18,G,Connecticut,AAC,30,1144,208,484,.430,160,336,48,148,.324,78,98,.796,26,101,127,141,46,10,87,46,542
1858,Aaron Bacote,SO,2013-14,G,Old Dominion,CUSA,35,1033,163,407,.400,107,249,56,158,.354,160,205,.780,16,89,105,102,26,5,100,67,542
1859,Alex Barnett,SR,2008-09,F,Dartmouth,Ivy,28,956,194,439,.442,140,307,54,132,.409,100,122,.820,35,121,156,54,36,33,63,53,542
1860,Aaron Calixte,SR,2017-18,G,Maine,AEC,32,1062,187,393,.476,126,235,61,158,.386,107,119,.899,15,85,100,102,28,4,121,74,542
1861,Rakeem Christmas,SR,2014-15,F,Syracuse,ACC,31,1064,203,368,.552,203,367,0,1,.000,136,191,.712,97,185,282,47,29,78,78,105,542
1862,Chris Cokley,SR,2017-18,F,Alabama-Birmingham,CUSA,32,870,219,376,.582,219,374,0,2,.000,104,127,.819,100,176,276,49,18,13,47,52,542
1863,Brandon Cotton,SR,2006-07,G,Detroit Mercy,Horizon,30,991,206,435,.474,164,326,42,109,.385,88,130,.677,12,41,53,53,26,0,62,31,542
1864,Quinton Day,SR,2006-07,G,Kansas City,Mid-Cont,32,1180,182,456,.399,90,214,92,242,.380,86,109,.789,13,98,111,131,54,1,109,50,542
1865,Kris Dunn,JR,2015-16,G,Providence,Big East,33,1088,184,411,.448,142,298,42,113,.372,132,190,.695,36,140,176,206,82,20,116,93,542
1866,KJ Feagin,JR,2017-18,G,Santa Clara,WCC,31,1085,201,454,.443,140,290,61,164,.372,79,91,.868,12,53,65,125,26,3,72,69,542
1867,Daniel Gafford,SO,2018-19,F,Arkansas,SEC,32,919,214,324,.660,214,324,0,0,,114,193,.591,91,186,277,23,30,65,76,88,542
1868,Trey Gilder,SR,2007-08,F,Northwestern State,Southland,33,887,189,394,.480,172,324,17,70,.243,147,192,.766,76,128,204,63,39,22,89,69,542
1869,David Huertas,JR,2008-09,G,Mississippi,SEC,30,951,166,398,.417,89,181,77,217,.355,133,165,.806,38,98,136,68,27,6,71,66,542
1870,JaJuan Johnson,JR,2009-10,F,Purdue,Big Ten,35,1093,192,379,.507,192,375,0,4,.000,158,220,.718,82,168,250,26,30,72,63,71,542
1871,Matt Lewis,SO,2018-19,G,James Madison,CAA,33,1200,168,436,.385,108,252,60,184,.326,146,180,.811,31,107,138,99,30,12,87,66,542
1872,E.C. Matthews,SO,2014-15,G,Rhode Island,A-10,32,1052,172,420,.410,104,211,68,209,.325,130,177,.734,34,112,146,63,24,17,115,68,542
1873,Demetri McCamey,JR,2009-10,G,Illinois,Big Ten,36,1241,191,421,.454,135,257,56,164,.341,104,147,.707,17,112,129,254,53,5,123,90,542
1874,Carlos Medlock,SR,2009-10,G,Eastern Michigan,MAC,32,1125,147,382,.385,72,158,75,224,.335,173,215,.805,19,93,112,121,50,2,111,93,542
1875,Takal Molson,SO,2018-19,G,Canisius,MAAC,32,1045,176,417,.422,121,212,55,205,.268,135,179,.754,57,117,174,63,41,9,82,80,542
1876,Nijal Pearson,JR,2018-19,G,Texas State,Sun Belt,33,1097,192,456,.421,112,249,80,207,.386,78,113,.690,49,120,169,46,45,6,59,58,542
1877,Jeff Roberson,SR,2017-18,F,Vanderbilt,SEC,32,1102,164,343,.478,102,190,62,153,.405,152,178,.854,61,167,228,49,28,10,49,91,542
1880,Desi Rodriguez,SR,2017-18,F,Seton Hall,Big East,31,939,204,410,.498,148,260,56,150,.373,78,106,.736,33,116,149,63,32,15,62,74,542
1881,Jaaron Simmons,SO,2015-16,G,Ohio,MAC,35,1276,172,370,.465,140,292,32,78,.410,166,213,.779,9,115,124,275,29,0,136,108,542
1882,Ryan Welage,JR,2017-18,F,San Jose State,MWC,30,1039,191,414,.461,131,274,60,140,.429,100,114,.877,26,135,161,42,17,5,54,43,542
1883,Isiah Williams,SR,2011-12,G,Utah Valley,GWC,33,1101,185,479,.386,102,227,83,252,.329,89,105,.848,13,78,91,73,28,4,76,49,542
1884,Leon Williams,SR,2007-08,F,Ohio,MAC,33,1009,180,293,.614,179,292,1,1,1.000,181,247,.733,145,180,325,41,47,23,80,93,542
1885,Matt Williams,SR,2016-17,G,Central Florida,AAC,36,1315,178,455,.391,52,127,126,328,.384,60,74,.811,16,138,154,69,25,1,65,64,542
1886,Jamaal Franklin,JR,2012-13,G,San Diego State,MWC,32,1058,165,401,.411,125,254,40,147,.272,171,219,.781,56,248,304,105,51,26,110,83,541
1887,Ashton Gibbs,SR,2011-12,G,Pittsburgh,Big East,37,1270,183,479,.382,102,244,81,235,.345,94,110,.855,19,65,84,77,19,2,61,38,541
1888,DeAndre Hall,SR,2009-10,G,Texas Southern,SWAC,33,1104,220,438,.502,206,399,14,39,.359,87,137,.635,56,127,183,87,63,15,107,83,541
1889,Demonte Harper,SR,2010-11,G,Morehead State,OVC,35,1180,198,459,.431,142,309,56,150,.373,89,133,.669,45,129,174,120,54,10,136,99,541
1890,Cameron Jones,JR,2009-10,G,Northern Arizona,Big Sky,28,986,203,404,.502,170,326,33,78,.423,102,138,.739,22,108,130,78,35,1,86,50,541
1891,Kaleo Kina,SR,2008-09,G,Navy,Patriot,30,978,185,458,.404,150,315,35,143,.245,136,187,.727,22,146,168,113,41,4,93,77,541
1892,Antoine Mason,SO,2012-13,G,Niagara,MAAC,29,1053,167,379,.441,133,271,34,108,.315,173,218,.794,34,84,118,43,33,7,64,69,541
1893,Grant Maxey,JR,2008-09,F,Jackson State,SWAC,33,1026,198,435,.455,156,309,42,126,.333,103,132,.780,69,151,220,76,52,29,99,97,541
1894,Jalen McDaniels,SO,2018-19,F,San Diego State,MWC,34,1055,212,455,.466,188,380,24,75,.320,93,127,.732,67,214,281,72,38,16,82,100,541
1895,Cleveland Melvin,SO,2011-12,F,DePaul,Big East,31,995,219,489,.448,203,419,16,70,.229,87,137,.635,76,153,229,24,25,34,69,59,541
1896,Ashton Moore,SR,2014-15,G,The Citadel,Southern,30,1129,173,420,.412,94,214,79,206,.383,116,135,.859,15,82,97,109,29,5,102,44,541
1897,Stuckey Mosley,SR,2018-19,G,James Madison,CAA,33,1158,194,487,.398,99,228,95,259,.367,58,81,.716,22,103,125,75,37,3,57,74,541
1898,Xavier Munford,SR,2013-14,G,Rhode Island,A-10,32,1139,184,458,.402,122,268,62,190,.326,111,157,.707,20,108,128,78,36,13,88,63,541
1899,Steve Novak,SR,2005-06,F,Marquette,Big East,31,1047,173,363,.477,52,104,121,259,.467,74,76,.974,34,149,183,39,18,4,32,64,541
1902,Royce Parran,JR,2005-06,G,Chicago State,Mid-Cont,30,1040,166,402,.413,98,229,68,173,.393,141,185,.762,20,82,102,116,57,1,83,77,541
1903,Dalton Pepper,SR,2013-14,G,Temple,AAC,31,1171,198,457,.433,114,233,84,224,.375,61,70,.871,42,117,159,74,32,6,52,54,541
1904,Brion Rush,SR,2005-06,G,Grambling,SWAC,21,730,189,462,.409,135,289,54,173,.312,109,131,.832,29,117,146,71,48,1,73,50,541
1905,Antwan Scott,SR,2015-16,G,Colorado State,MWC,33,1007,173,404,.428,77,173,96,231,.416,99,130,.762,9,133,142,70,21,2,58,85,541
1906,Trevis Simpson,JR,2012-13,G,North Carolina-Greensboro,Southern,29,858,187,461,.406,123,273,64,188,.340,103,129,.798,27,96,123,40,19,3,58,78,541
1907,Isaiah Thomas,FR,2008-09,G,Washington,Pac-10,35,993,180,431,.418,141,297,39,134,.291,142,207,.686,24,82,106,91,38,2,92,66,541
1908,Jeremy Wise,FR,2006-07,G,Southern Mississippi,CUSA,31,1034,176,439,.401,123,291,53,148,.358,136,163,.834,13,93,106,94,27,9,114,91,541
1909,Josh Ajayi,JR,2018-19,F,South Alabama,Sun Belt,33,1030,197,352,.560,181,316,16,36,.444,130,185,.703,74,170,244,52,22,29,87,88,540
1910,Davis Baker,JR,2008-09,G,Southern Utah,Summit,31,1085,200,426,.469,153,311,47,115,.409,93,106,.877,26,114,140,42,30,5,72,55,540
1911,Jordan Barnes,SO,2017-18,G,Indiana State,MVC,31,1044,168,405,.415,51,128,117,277,.422,87,102,.853,10,111,121,113,37,2,86,78,540
1912,Brett Bisping,JR,2015-16,F,Siena,MAAC,34,1129,180,389,.463,140,275,40,114,.351,140,176,.795,79,275,354,50,25,15,80,105,540
1913,Wes Channels,SR,2009-10,G,Austin Peay,OVC,32,1129,172,416,.413,101,255,71,161,.441,125,173,.723,35,104,139,94,45,6,92,85,540
1914,Zachary Hamilton,SR,2017-18,F,Prairie View,SWAC,34,936,181,453,.400,92,215,89,238,.374,89,113,.788,35,110,145,43,32,9,57,94,540
1915,Jalen Hayes,JR,2016-17,F,Oakland,Horizon,34,1025,217,397,.547,212,384,5,13,.385,101,142,.711,82,191,273,54,39,25,55,105,540
1916,Mac Hopson,JR,2008-09,G,Idaho,WAC,33,1133,183,397,.461,137,290,46,107,.430,128,189,.677,27,136,163,194,55,6,96,82,540
1917,Damion James,JR,2008-09,F,Texas,Big 12,35,1034,203,434,.468,175,348,28,86,.326,106,155,.684,103,219,322,47,34,30,79,94,540
1918,Orlando Johnson,SO,2009-10,G,UC-Santa Barbara,Big West,30,939,176,366,.481,130,250,46,116,.397,142,202,.703,56,106,162,69,21,17,81,72,540
1919,Jerome Jordan,SR,2009-10,C,Tulsa,CUSA,35,1043,184,335,.549,184,335,0,0,,172,250,.688,84,233,317,44,16,82,79,98,540
1920,Joe Kilgore,SR,2017-18,G,Texas A&M-Corpus Christi,Southland,29,1019,183,451,.406,146,343,37,108,.343,137,173,.792,28,135,163,96,52,18,86,60,540
1921,Elijah Mitrou-Long,SO,2016-17,G,Mount St. Mary's,NEC,36,1239,180,437,.412,133,314,47,123,.382,133,180,.739,16,171,187,157,57,3,123,100,540
1924,Demetrius Nelson,SR,2008-09,F,The Citadel,Southern,33,946,183,307,.596,183,307,0,0,,174,225,.773,68,147,215,28,15,17,68,93,540
1925,Taurean Prince,SR,2015-16,F,Baylor,Big 12,34,1040,187,433,.432,134,286,53,147,.361,113,146,.774,81,125,206,77,43,25,91,86,540
1926,Justin Sears,SO,2013-14,F,Yale,Ivy,32,978,183,354,.517,179,342,4,12,.333,170,244,.697,91,129,220,46,39,62,70,83,540
1927,DeShawn Sims,JR,2008-09,F,Michigan,Big Ten,35,1075,224,444,.505,198,362,26,82,.317,66,93,.710,86,152,238,26,40,27,46,76,540
1928,Adam Smith,SR,2015-16,C,Georgia Tech,ACC,36,1098,185,455,.407,76,192,109,263,.414,61,76,.803,12,70,82,69,15,1,44,57,540
1929,Ben Smith,JR,2008-09,G,Jacksonville,A-Sun,32,1160,168,399,.421,102,220,66,179,.369,138,175,.789,23,82,105,128,70,0,74,54,540
1930,Mark Tyndale,SR,2007-08,G,Temple,A-10,34,1272,178,365,.488,146,278,32,87,.368,152,214,.710,45,200,245,145,54,21,117,74,540
1931,Ryan Anderson,FR,2006-07,F,University of California,Pac-10,33,1096,189,397,.476,131,245,58,152,.382,103,129,.798,79,190,269,16,22,18,47,91,539
1932,Shannon Bogues,JR,2017-18,G,Stephen F. Austin,Southland,35,842,201,398,.505,157,273,44,125,.352,93,117,.795,24,61,85,48,46,6,49,40,539
1933,Clif Brown,SR,2006-07,F,Niagara,MAAC,33,1112,194,480,.404,138,323,56,157,.357,95,127,.748,117,204,321,28,26,10,77,80,539
1934,Norris Cole,JR,2009-10,G,Cleveland State,Horizon,33,1127,185,428,.432,147,317,38,111,.342,131,164,.799,14,77,91,146,61,3,91,81,539
1935,Jermaine Crumpton,JR,2016-17,F,Canisius,MAAC,34,967,195,397,.491,138,264,57,133,.429,92,128,.719,65,88,153,45,33,11,68,86,539
1936,James Florence,FR,2006-07,G,Mercer,A-Sun,28,934,163,437,.373,108,254,55,183,.301,158,203,.778,,,114,91,47,14,,,539
1937,Chris Fowler,SO,2013-14,G,Central Michigan,MAC,31,1026,184,370,.497,158,302,26,68,.382,145,212,.684,18,77,95,163,60,1,87,93,539
1938,Corey Hawkins,JR,2013-14,G,UC-Davis,Big West,30,1014,171,385,.444,133,267,38,118,.322,159,210,.757,21,114,135,89,44,11,60,65,539
1939,Leo Lyons,SR,2008-09,F,Missouri,Big 12,37,861,176,357,.493,171,344,5,13,.385,182,245,.743,82,143,225,73,38,26,85,93,539
1940,Kyle McAlarney,SR,2008-09,G,Notre Dame,Big East,36,1329,177,437,.405,53,144,124,293,.423,61,69,.884,6,87,93,124,23,3,68,52,539
1941,Josh Sharkey,JR,2018-19,G,Samford,Southern,33,1168,175,394,.444,145,297,30,97,.309,159,212,.750,19,108,127,239,86,2,165,86,539
1942,Keifer Sykes,SO,2012-13,G,Green Bay,Horizon,34,1175,175,402,.435,145,331,30,71,.423,159,196,.811,18,93,111,146,37,4,84,85,539
1943,Ameen Tanksley,SR,2015-16,G,Hofstra,CAA,34,1180,170,406,.419,108,234,62,172,.360,137,173,.792,66,112,178,48,30,8,68,79,539
1944,Erving Walker,JR,2010-11,G,Florida,SEC,37,1212,153,372,.411,74,167,79,205,.385,154,198,.778,18,91,109,125,41,0,87,56,539
1945,Julius Wells,SO,2009-10,F,James Madison,CAA,33,1211,182,470,.387,91,212,91,258,.353,84,120,.700,24,143,167,74,30,2,106,68,539
1946,Tim Williams,JR,2015-16,F,New Mexico,MWC,32,1078,215,356,.604,215,356,0,0,,109,163,.669,65,172,237,33,19,39,48,67,539
1947,Kent Bazemore,SR,2011-12,G,Old Dominion,CAA,35,1103,186,457,.407,135,298,51,159,.321,115,182,.632,65,148,213,107,74,12,112,96,538
1948,Julius Brown,SR,2014-15,G,Toledo,MAC,33,1098,193,416,.464,125,246,68,170,.400,84,98,.857,10,63,73,144,31,11,74,44,538
1949,Kareem Canty,FR,2013-14,G,Marshall,CUSA,33,1211,187,502,.373,122,288,65,214,.304,99,136,.728,25,49,74,180,24,3,121,54,538
1950,Joe Crawford,SR,2007-08,G,Kentucky,SEC,30,1009,188,401,.469,125,228,63,173,.364,99,130,.762,31,78,109,64,17,5,83,81,538
1951,Ross Cummings,JR,2018-19,G,Mercer,Southern,31,1032,162,379,.427,61,126,101,253,.399,113,141,.801,12,79,91,59,16,2,70,50,538
1952,Chris Douglas-Roberts,SO,2006-07,G,Memphis,CUSA,35,930,194,357,.543,175,299,19,58,.328,131,179,.732,37,83,120,61,39,16,66,76,538
1953,Alex Francis,JR,2012-13,F,Bryant,NEC,31,1083,211,371,.569,211,363,0,8,.000,116,192,.604,92,175,267,56,23,5,105,75,538
1954,Louis Graham,SR,2007-08,F,Georgia Southern,Southern,32,841,192,400,.480,175,356,17,44,.386,137,186,.737,67,149,216,19,52,54,81,102,538
1955,Alex Hamilton,SO,2013-14,G,Louisiana Tech,CUSA,37,1034,172,370,.465,142,258,30,112,.268,164,226,.726,25,109,134,109,53,16,79,61,538
1956,Isaac Hamilton,JR,2015-16,G,UCLA,Pac-12,32,1129,206,436,.472,146,277,60,159,.377,66,82,.805,31,104,135,106,33,2,76,69,538
1957,Cory Higgins,SO,2008-09,G,Colorado,Big 12,31,1146,165,347,.476,133,258,32,89,.360,176,212,.830,18,149,167,80,59,11,87,77,538
1958,Quin Humphrey,JR,2005-06,G,Youngstown State,Horizon,28,1034,189,381,.496,139,247,50,134,.373,110,149,.738,68,165,233,72,34,11,80,51,538
1959,Tyren Johnson,SR,2009-10,F,Louisiana,Sun Belt,30,1082,205,410,.500,175,327,30,83,.361,98,142,.690,60,179,239,99,54,44,108,84,538
1960,Tyreke Key,SO,2018-19,G,Indiana State,MVC,31,1065,181,345,.525,138,249,43,96,.448,133,169,.787,26,84,110,53,33,1,49,61,538
1961,Jordan Murphy,JR,2017-18,F,Minnesota,Big Ten,32,1019,202,385,.525,191,350,11,35,.314,123,176,.699,129,232,361,45,39,32,83,81,538
1962,Sa'eed Nelson,SO,2017-18,G,American,Patriot,29,1074,191,431,.443,163,335,28,96,.292,128,188,.681,25,79,104,147,52,5,109,77,538
1963,Charles Rhodes,SR,2007-08,F,Mississippi State,SEC,31,976,214,381,.562,211,375,3,6,.500,107,159,.673,89,153,242,29,16,42,74,74,538
1966,Quinton Rose,JR,2018-19,G,Temple,AAC,33,1143,204,500,.408,163,351,41,149,.275,89,130,.685,15,110,125,82,71,7,83,67,538
1967,Yuta Watanabe,SR,2017-18,F,George Washington,A-10,33,1207,193,442,.437,137,288,56,154,.364,96,119,.807,42,158,200,52,26,54,51,50,538
1968,Cecil Williams,SR,2017-18,F,Central Michigan,MAC,36,1088,181,386,.469,158,310,23,76,.303,153,197,.777,56,177,233,94,36,37,101,106,538
1969,Michael Williams,SR,2013-14,G,Cal State Fullerton,Big West,31,1073,184,441,.417,113,243,71,198,.359,99,139,.712,19,109,128,76,28,6,67,74,538
1970,Jaylen Adams,SO,2015-16,G,St. Bonaventure,A-10,30,1125,150,337,.445,66,145,84,192,.438,153,175,.874,23,87,110,150,40,9,82,80,537
1971,Raheem Appleby,SR,2014-15,G,Louisiana Tech,CUSA,36,1184,200,500,.400,129,284,71,216,.329,66,86,.767,22,75,97,73,46,2,39,35,537
1972,Michael Bramos,SR,2008-09,F,Miami (OH),MAC,30,1057,173,430,.402,102,231,71,199,.357,120,144,.833,15,109,124,51,29,33,60,54,537
1973,Darell Combs,SR,2016-17,G,IUPUI,Summit,32,1029,187,441,.424,124,257,63,184,.342,100,134,.746,16,62,78,92,24,4,81,82,537
1974,Donte DiVincenzo,SO,2017-18,G,Villanova,Big East,40,1170,188,391,.481,103,179,85,212,.401,76,107,.710,46,144,190,139,42,8,79,83,537
1975,Patricio Garino,SR,2015-16,G,George Washington,A-10,38,1217,203,398,.510,145,263,58,135,.430,73,106,.689,52,109,161,56,52,31,72,98,537
1976,J.R. Giddens,SR,2007-08,G,New Mexico,MWC,33,1063,210,407,.516,185,332,25,75,.333,92,157,.586,57,233,290,103,47,39,73,64,537
1977,Corey Hassan,SR,2009-10,F,Sacred Heart,NEC,28,962,187,435,.430,97,201,90,234,.385,73,105,.695,63,149,212,58,39,1,77,56,537
1978,Fred Hunter,SR,2012-13,G,Nicholls State,Southland,27,861,186,328,.567,170,270,16,58,.276,149,225,.662,89,131,220,57,48,8,64,72,537
1979,Christian Keeling,FR,2016-17,G,Charleston Southern,Big South,31,968,183,400,.458,158,327,25,73,.342,146,187,.781,40,179,219,43,28,9,53,53,537
1980,Javon McCrea,SR,2013-14,F,Buffalo,MAC,29,937,202,360,.561,201,358,1,2,.500,132,198,.667,112,174,286,64,44,65,70,92,537
1981,Michael Oguine,JR,2017-18,G,Montana,Big Sky,34,1096,177,384,.461,131,255,46,129,.357,137,186,.737,73,115,188,67,48,18,45,95,537
1982,Jarelle Reischel,SR,2015-16,F,Eastern Kentucky,OVC,30,941,165,339,.487,125,234,40,105,.381,167,213,.784,38,166,204,96,50,13,124,88,537
1983,Kassius Robertson,SR,2017-18,G,Missouri,SEC,33,1187,158,374,.422,53,131,105,243,.432,116,146,.795,9,90,99,77,32,2,77,57,537
1984,D.J. Seeley,JR,2011-12,G,Cal State Fullerton,Big West,31,966,169,385,.439,103,233,66,152,.434,133,182,.731,61,109,170,57,45,6,89,92,537
1985,Iman Shumpert,JR,2010-11,G,Georgia Tech,ACC,31,992,177,436,.406,135,285,42,151,.278,141,175,.806,53,130,183,108,85,6,72,86,537
1988,Chase Tapley,JR,2011-12,G,San Diego State,MWC,34,1157,200,440,.455,123,262,77,178,.433,60,83,.723,22,124,146,77,60,15,55,58,537
1989,Kibwe Trim,SR,2005-06,F,Sacred Heart,NEC,28,913,194,314,.618,194,314,0,0,,149,221,.674,99,142,241,18,22,15,76,90,537
1990,Davauhnte Turner,SR,2018-19,G,Saint Peter's,MAAC,32,1148,183,445,.411,112,243,71,202,.351,100,126,.794,33,73,106,77,33,9,80,54,537
1991,Jaylin Walker,SO,2016-17,G,Kent State,MAC,34,1055,185,468,.395,97,204,88,264,.333,79,101,.782,51,97,148,31,26,0,69,58,537
1992,James White,SR,2005-06,F,Cincinnati,Big East,33,1104,177,363,.488,128,232,49,131,.374,134,160,.838,42,125,167,67,36,28,77,89,537
1993,Elijah Wilson,FR,2013-14,G,Coastal Carolina,Big South,34,1107,200,464,.431,149,297,51,167,.305,86,123,.699,41,99,140,30,32,8,46,84,537
1994,Calvin Wooten,JR,2005-06,G,Oakland,Mid-Cont,28,930,188,441,.426,93,198,95,243,.391,66,83,.795,11,58,69,65,49,4,76,62,537
1995,Dwayne Bacon,FR,2015-16,G,Florida State,ACC,34,979,197,441,.447,165,327,32,114,.281,110,154,.714,46,151,197,50,33,1,74,73,536
1996,Shannon Bogues,SR,2018-19,G,Stephen F. Austin,Southland,30,1083,178,424,.420,112,245,66,179,.369,114,145,.786,13,77,90,108,36,8,95,44,536
1997,Devin Carter,JR,2015-16,G,Arkansas State,Sun Belt,31,1110,183,400,.458,95,189,88,211,.417,82,117,.701,30,105,135,60,22,10,56,86,536
1998,Mardy Collins,SR,2005-06,G,Temple,A-10,32,1212,202,468,.432,160,331,42,137,.307,90,151,.596,46,104,150,127,89,6,65,71,536
1999,T.J. Cromer,JR,2015-16,G,East Tennessee State,Southern,36,1152,182,421,.432,112,229,70,192,.365,102,128,.797,26,97,123,110,36,2,73,92,536
2000,Jimmer Fredette,SO,2008-09,G,Brigham Young,MWC,33,1090,184,383,.480,132,247,52,136,.382,116,137,.847,18,80,98,135,50,3,85,43,536
2001,Jessie Govan,JR,2017-18,C,Georgetown,Big East,30,980,201,396,.508,185,350,16,46,.348,118,155,.761,74,227,301,59,18,34,52,87,536
2002,Tra Holder,JR,2016-17,G,Arizona State,Pac-12,33,1175,169,390,.433,123,265,46,125,.368,152,197,.772,38,83,121,106,29,1,66,68,536
2003,Pooh Jeter,SR,2005-06,G,Portland,WCC,29,1045,173,409,.423,116,253,57,156,.365,133,153,.869,17,86,103,87,35,0,72,54,536
2004,Manu Lecomte,SR,2017-18,G,Baylor,Big 12,33,1124,162,403,.402,71,164,91,239,.381,121,136,.890,7,65,72,122,22,0,71,60,536
2005,Shelvin Mack,SO,2009-10,G,Butler,Horizon,38,1173,192,423,.454,120,239,72,184,.391,80,109,.734,20,122,142,115,52,5,79,71,536
2006,Brian Mills,SR,2010-11,F,Mercer,A-Sun,33,1011,195,428,.456,176,359,19,69,.275,127,176,.722,69,130,199,41,31,16,75,107,536
2007,Jonathan Rodriguez,FR,2006-07,F,Campbell,A-Sun,31,1028,184,393,.468,164,324,20,69,.290,148,209,.708,76,196,272,94,45,34,82,72,536
2010,Jared Sam,SR,2017-18,F,Southern,SWAC,33,1106,177,405,.437,176,404,1,1,1.000,181,236,.767,103,189,292,44,28,25,75,66,536
2011,Jon Severe,FR,2013-14,G,Fordham,A-10,31,1021,163,493,.331,84,262,79,231,.342,131,165,.794,31,56,87,63,29,6,82,69,536
2012,DeShawn Sims,SR,2009-10,F,Michigan,Big Ten,32,1026,220,447,.492,199,373,21,74,.284,75,112,.670,98,144,242,30,35,21,48,71,536
2013,Gary Trent,FR,2017-18,G,Duke,ACC,37,1253,177,427,.415,80,186,97,241,.402,85,97,.876,31,126,157,52,43,5,38,62,536
2014,Darren White,JR,2011-12,G,Campbell,Big South,32,1025,197,379,.520,152,260,45,119,.378,97,147,.660,57,118,175,67,29,34,84,80,536
2015,Booker Woodfox,SR,2008-09,G,Creighton,MVC,34,848,173,363,.477,82,172,91,191,.476,99,114,.868,21,65,86,37,22,1,34,41,536
2016,Jaylen Adams,SR,2017-18,G,St. Bonaventure,A-10,28,1036,153,350,.437,78,178,75,172,.436,154,181,.851,12,83,95,146,43,7,86,80,535
2017,Roy Bright,SR,2007-08,F,Delaware State,MEAC,28,1014,195,458,.426,117,238,78,220,.355,67,83,.807,36,113,149,18,20,17,38,73,535
2018,Mike Caffey,SR,2014-15,G,Cal State Long Beach,Big West,33,1073,195,449,.434,133,274,62,175,.354,83,114,.728,21,110,131,119,61,5,88,65,535
2019,Reggie Chamberlain,SR,2011-12,G,Kansas City,Summit,31,1022,174,384,.453,77,178,97,206,.471,90,104,.865,11,68,79,77,28,2,51,75,535
2020,Stephen Croone,JR,2014-15,G,Furman,Southern,31,992,155,346,.448,100,188,55,158,.348,170,226,.752,26,119,145,80,51,6,75,78,535
2021,Ron Curry,SR,2015-16,G,James Madison,CAA,31,1035,167,378,.442,95,184,72,194,.371,129,173,.746,13,114,127,112,31,12,46,63,535
2022,Terence Davis,SO,2016-17,G,Mississippi,SEC,36,911,200,415,.482,151,268,49,147,.333,86,119,.723,51,139,190,63,50,18,74,114,535
2023,LaVonte Dority,SR,2013-14,G,Valparaiso,Horizon,34,1062,163,367,.444,99,217,64,150,.427,145,172,.843,18,68,86,83,22,2,72,58,535
2024,Kellen Dunham,SR,2015-16,G,Butler,Big East,33,1069,166,379,.438,79,176,87,203,.429,116,138,.841,15,67,82,50,22,3,50,55,535
2025,Anthony Goods,SR,2008-09,G,Stanford,Pac-10,33,1052,161,386,.417,90,203,71,183,.388,142,182,.780,26,83,109,59,23,2,78,44,535
2026,Desharick Guidry,SR,2014-15,F,McNeese State,Southland,31,1092,195,400,.488,158,301,37,99,.374,108,151,.715,135,211,346,51,40,20,66,86,535
2027,Armon Johnson,JR,2009-10,G,Nevada,WAC,34,1172,219,442,.495,202,371,17,71,.239,80,118,.678,26,89,115,189,28,12,114,61,535
2028,Austin Kenon,JR,2009-10,G,Virginia Military Institute,Big South,29,908,161,415,.388,81,173,80,242,.331,133,158,.842,35,53,88,105,41,3,73,70,535
2029,Egor Koulechov,SO,2015-16,G,Rice,CUSA,32,1101,175,420,.417,95,186,80,234,.342,105,122,.861,48,176,224,42,28,6,45,69,535
2032,Jack Leasure,SO,2005-06,G,Coastal Carolina,Big South,30,1041,180,411,.438,55,113,125,298,.419,50,60,.833,23,69,92,122,49,0,83,45,535
2033,Luke Maye,SR,2018-19,F,North Carolina,ACC,36,1111,198,460,.430,162,335,36,125,.288,103,133,.774,92,285,377,84,23,20,71,93,535
2034,Egidijus Mockevicius,SR,2015-16,C,Evansville,MVC,34,1082,195,306,.637,195,306,0,0,,145,212,.684,85,389,474,9,27,94,55,110,535
2035,Derick Nelson,JR,2007-08,F,Oakland,Summit,31,1050,176,395,.446,157,336,19,59,.322,164,257,.638,102,128,230,48,54,2,87,81,535
2036,Tyrone Nelson,SO,2005-06,F,New Mexico State,WAC,30,987,189,343,.551,189,342,0,1,.000,157,208,.755,97,164,261,48,48,14,99,88,535
2037,Rodney Pierce,SR,2009-10,G,Buffalo,MAC,29,985,188,458,.410,131,297,57,161,.354,102,126,.810,16,82,98,94,43,6,68,65,535
2038,Gerald Robinson,SO,2008-09,G,Tennessee State,OVC,30,990,178,403,.442,148,295,30,108,.278,149,193,.772,36,81,117,116,61,2,108,70,535
2039,Daniel Utomi,SO,2017-18,G,Akron,MAC,32,1104,175,389,.450,87,170,88,219,.402,97,126,.770,33,137,170,60,30,9,67,74,535
2040,Drew Viney,SO,2009-10,F,Loyola Marymount,WCC,32,1103,184,415,.443,121,267,63,148,.426,104,127,.819,48,178,226,60,37,38,65,84,535
2041,Jay Wright,SR,2016-17,G,Louisiana,Sun Belt,33,1137,181,404,.448,130,254,51,150,.340,122,170,.718,20,62,82,129,65,11,79,69,535
2042,Brandon Young,JR,2012-13,G,DePaul,Big East,32,1008,180,411,.438,149,312,31,99,.313,144,194,.742,27,80,107,146,49,5,86,55,535
2043,Ty-Shon Alexander,SO,2018-19,G,Creighton,Big East,34,1108,176,433,.406,79,167,97,266,.365,85,107,.794,17,118,135,92,41,10,69,70,534
2044,James Batemon,JR,2017-18,G,Loyola Marymount,WCC,30,1050,167,350,.477,124,240,43,110,.391,157,196,.801,32,77,109,139,35,1,87,82,534
2045,Martin Breunig,JR,2014-15,F,Montana,Big Sky,32,963,214,361,.593,212,348,2,13,.154,104,141,.738,82,151,233,60,17,27,76,110,534
2046,Matthew Bryan-Amaning,SR,2010-11,F,Washington,Pac-10,35,986,215,394,.546,215,393,0,1,.000,104,168,.619,105,176,281,24,37,54,57,100,534
2047,Bryant Crawford,SO,2016-17,G,Wake Forest,ACC,33,1049,169,386,.438,115,230,54,156,.346,142,172,.826,11,115,126,182,49,9,76,93,534
2048,Matt Dickey,JR,2010-11,G,North Carolina-Asheville,Big South,34,1163,169,389,.434,104,214,65,175,.371,131,154,.851,19,107,126,111,64,1,97,89,534
2049,Dontaye Draper,SR,2006-07,G,College of Charleston,Southern,33,1186,165,407,.405,74,170,91,237,.384,113,153,.739,19,116,135,176,57,11,111,73,534
2050,Antonio Green,SO,2016-17,G,Texas-Rio Grande Valley,WAC,32,972,177,448,.395,66,150,111,298,.372,69,89,.775,21,85,106,56,19,4,87,46,534
2051,Jhivvan Jackson,FR,2017-18,G,Texas-San Antonio,CUSA,29,745,174,404,.431,97,195,77,209,.368,109,142,.768,9,85,94,52,30,2,70,70,534
2052,Kosta Koufos,FR,2007-08,F,Ohio State,Big Ten,37,1003,222,437,.508,200,374,22,63,.349,68,100,.680,98,149,247,19,16,67,55,81,534
2053,Francois Lewis,SR,2018-19,F,Presbyterian,Big South,36,971,180,384,.469,98,176,82,208,.394,92,123,.748,40,138,178,57,27,6,52,100,534
2054,Bryant McIntosh,JR,2016-17,G,Northwestern,Big Ten,36,1231,199,493,.404,157,356,42,137,.307,94,108,.870,9,90,99,188,26,4,96,74,534
2055,Chimezie Metu,SO,2016-17,F,Southern California,Pac-12,36,1128,202,366,.552,201,364,1,2,.500,129,174,.741,73,207,280,50,28,55,76,89,534
2056,Matt Mobley,SO,2014-15,G,Central Connecticut State,NEC,31,1147,171,428,.400,97,221,74,207,.357,118,156,.756,15,71,86,57,26,6,83,64,534
2057,Marcus Paige,JR,2014-15,G,North Carolina,ACC,38,1263,172,416,.413,78,178,94,238,.395,96,111,.865,14,96,110,170,65,8,73,62,534
2058,Alex Renfroe,SR,2008-09,G,Belmont,A-Sun,33,999,182,332,.548,150,246,32,86,.372,138,205,.673,70,166,236,169,69,17,120,79,534
2059,Mike Rosario,SO,2009-10,G,Rutgers,Big East,32,1079,184,487,.378,106,248,78,239,.326,88,119,.739,43,83,126,46,31,3,87,63,534
2060,Quincy Taylor,SR,2014-15,G,Longwood,Big South,31,1115,188,433,.434,102,254,86,179,.480,72,98,.735,13,79,92,83,40,5,93,74,534
2061,Melo Trimble,SO,2015-16,G,Maryland,Big Ten,36,1183,159,388,.410,101,204,58,184,.315,158,182,.868,11,119,130,175,45,6,96,68,534
2062,Seth Tuttle,SR,2014-15,F,Northern Iowa,MVC,35,1062,183,303,.604,164,259,19,44,.432,149,195,.764,47,193,240,114,33,20,99,75,534
2063,Averyl Ugba,SR,2017-18,F,Austin Peay,OVC,34,1020,202,368,.549,186,324,16,44,.364,114,170,.671,101,172,273,34,16,36,77,97,534
2064,Ben Uzoh,SR,2009-10,G,Tulsa,CUSA,35,1202,184,403,.457,135,260,49,143,.343,117,153,.765,34,129,163,163,34,26,80,60,534
2065,Quinndary Weatherspoon,JR,2017-18,G,Mississippi State,SEC,37,1162,187,386,.484,145,252,42,134,.313,118,153,.771,56,166,222,123,52,12,99,86,534
2066,Akwasi Yeboah,JR,2018-19,G,Stony Brook,AEC,32,1019,183,443,.413,117,234,66,209,.316,102,130,.785,52,193,245,46,28,15,82,82,534
2067,Antonio Blakeney,SO,2016-17,G,Louisiana State,SEC,31,1018,194,424,.458,141,276,53,148,.358,92,127,.724,32,117,149,54,21,3,64,49,533
2068,Chris Flemmings,JR,2015-16,G,North Carolina-Wilmington,CAA,33,1052,180,353,.510,123,196,57,157,.363,116,143,.811,44,148,192,52,45,23,44,68,533
2069,Ashton Gibbs,SO,2009-10,G,Pittsburgh,Big East,34,1178,159,401,.397,81,202,78,199,.392,137,155,.884,14,82,96,62,26,3,41,40,533
2070,Treveon Graham,SR,2014-15,G,Virginia Commonwealth,A-10,33,970,172,402,.428,108,234,64,168,.381,125,181,.691,73,162,235,53,20,9,38,67,533
2071,Kevon Harris,JR,2018-19,F,Stephen F. Austin,Southland,30,1045,176,338,.521,126,206,50,132,.379,131,178,.736,52,142,194,60,30,15,87,73,533
2074,Ria'n Holland,JR,2016-17,G,Mercer,Southern,31,975,177,405,.437,100,201,77,204,.377,102,121,.843,24,78,102,59,32,7,44,72,533
2075,Frank Howard,JR,2017-18,G,Syracuse,ACC,37,1422,187,497,.376,120,292,67,205,.327,92,128,.719,19,110,129,175,68,10,126,96,533
2076,Robert Jarvis,SR,2008-09,G,Oral Roberts,Summit,31,1086,181,467,.388,97,216,84,251,.335,87,112,.777,11,69,80,63,29,2,80,63,533
2077,Tyler Kalinoski,SR,2014-15,G,Davidson,A-10,32,1112,191,410,.466,100,195,91,215,.423,60,76,.789,48,133,181,130,39,13,44,85,533
2078,Dior Lowhorn,SR,2009-10,F,San Francisco,WCC,29,835,189,402,.470,167,324,22,78,.282,133,164,.811,65,127,192,17,19,14,59,63,533
2079,Jordan Lyons,JR,2018-19,G,Furman,Southern,33,1084,185,467,.396,80,164,105,303,.347,58,76,.763,14,60,74,75,39,2,76,38,533
2080,Chimezie Metu,JR,2017-18,F,Southern California,Pac-12,34,1053,205,392,.523,193,352,12,40,.300,111,152,.730,64,189,253,53,27,59,68,87,533
2081,Artsiom Parakhouski,JR,2008-09,C,Radford,Big South,33,1033,201,374,.537,201,369,0,5,.000,131,200,.655,132,237,369,37,26,50,72,78,533
2082,Isaiah Pineiro,JR,2017-18,F,San Diego,WCC,34,957,188,383,.491,161,305,27,78,.346,130,166,.783,33,179,212,71,40,27,88,107,533
2083,LaQuinton Ross,JR,2013-14,F,Ohio State,Big Ten,35,1015,184,412,.447,142,293,42,119,.353,123,168,.732,63,145,208,29,25,20,60,54,533
2084,JaJuan Smith,JR,2006-07,G,Tennessee,SEC,35,1012,183,402,.455,94,160,89,242,.368,78,107,.729,60,99,159,46,73,8,63,90,533
2085,D'Vauntes Smith-Rivera,SR,2015-16,G,Georgetown,Big East,33,1168,172,416,.413,99,195,73,221,.330,116,143,.811,22,98,120,150,48,10,69,78,533
2086,Ryan Taylor,JR,2017-18,G,Evansville,MVC,25,879,195,458,.426,128,300,67,158,.424,76,88,.864,12,84,96,28,20,6,57,57,533
2087,Vedran Vukusic,SR,2005-06,F,Northwestern,Big Ten,28,1033,191,388,.492,128,213,63,175,.360,88,112,.786,25,78,103,48,32,18,52,67,533
2088,Dean Wade,JR,2017-18,F,Kansas State,Big 12,33,1083,198,360,.550,158,269,40,91,.440,97,129,.752,43,160,203,89,51,27,47,64,533
2089,Calvin Watson,SR,2006-07,G,North Texas,Sun Belt,34,1017,183,427,.429,93,200,90,227,.396,77,117,.658,37,98,135,44,29,11,70,74,533
2090,Michael Weathers,FR,2016-17,G,Miami (OH),MAC,32,906,177,411,.431,158,325,19,86,.221,160,206,.777,23,111,134,155,60,45,146,109,533
2091,Byron Wesley,JR,2013-14,G,Southern California,Pac-12,30,1038,191,409,.467,167,338,24,71,.338,127,178,.713,46,147,193,69,27,10,61,51,533
2092,Jeremy Wise,JR,2008-09,G,Southern Mississippi,CUSA,32,1142,165,369,.447,139,263,26,106,.245,177,216,.819,12,99,111,150,42,11,102,93,533
2093,J.J. Avila,JR,2013-14,F,Colorado State,MWC,32,1070,186,410,.454,162,334,24,76,.316,136,171,.795,82,155,237,106,35,16,78,84,532
2096,Travis Betran,JR,2012-13,G,Austin Peay,OVC,31,1071,178,414,.430,94,210,84,204,.412,92,109,.844,14,55,69,84,40,9,80,49,532
2097,Askia Booker,SR,2014-15,G,Colorado,Pac-12,31,936,173,447,.387,118,280,55,167,.329,131,157,.834,15,88,103,99,44,2,70,56,532
2098,Keith Braxton,SO,2017-18,G,Saint Francis (PA),NEC,31,1091,180,379,.475,140,270,40,109,.367,132,166,.795,50,245,295,102,54,18,81,56,532
2099,William Buford,SO,2009-10,G,Ohio State,Big Ten,37,1272,197,451,.437,148,323,49,128,.383,89,118,.754,52,157,209,116,41,10,65,81,532
2100,Dominic Calegari,SR,2009-10,F,UC-Davis,Big West,32,979,187,369,.507,127,225,60,144,.417,98,137,.715,41,128,169,65,35,30,76,90,532
2101,Drew Crawford,JR,2011-12,G,Northwestern,Big Ten,33,1143,195,403,.484,134,255,61,148,.412,81,115,.704,40,115,155,68,40,19,54,67,532
2102,Brandon Davies,JR,2011-12,F,Brigham Young,WCC,35,1002,196,380,.516,195,377,1,3,.333,139,210,.662,79,190,269,73,51,47,100,114,532
2103,Nana Foulland,SR,2017-18,C,Bucknell,Patriot,35,1001,210,358,.587,210,356,0,2,.000,112,201,.557,76,169,245,46,18,61,63,92,532
2104,Christopher Galbreath,SR,2017-18,F,Sam Houston State,Southland,36,1004,219,464,.472,202,413,17,51,.333,77,115,.670,94,193,287,45,23,21,79,101,532
2105,Matt Gatens,SR,2011-12,G,Iowa,Big Ten,35,1212,173,369,.469,98,186,75,183,.410,111,130,.854,35,90,125,69,48,6,38,66,532
2106,Shai Gilgeous-Alexander,FR,2017-18,G,Kentucky,SEC,37,1248,183,377,.485,160,320,23,57,.404,143,175,.817,33,120,153,189,61,18,100,62,532
2107,Malcolm Grant,JR,2010-11,G,Miami (FL),ACC,36,1165,158,378,.418,64,156,94,222,.423,122,143,.853,12,53,65,115,31,1,92,49,532
2108,Jeremy Green,SO,2009-10,G,Stanford,Pac-10,32,1081,182,453,.402,89,209,93,244,.381,75,92,.815,26,95,121,25,24,1,41,67,532
2109,Chris Hansen,SR,2014-15,G,Idaho State,Big Sky,30,998,157,389,.404,77,180,80,209,.383,138,165,.836,11,90,101,70,39,0,59,45,532
2110,Adnan Hodzic,SR,2010-11,C,Lipscomb,A-Sun,30,949,206,366,.563,205,358,1,8,.125,119,164,.726,68,156,224,30,8,2,66,73,532
2111,Kory Holden,SO,2015-16,G,Delaware,CAA,30,1088,181,459,.394,112,281,69,178,.388,101,127,.795,16,75,91,126,12,2,88,62,532
2112,Chavis Holmes,JR,2007-08,G,Virginia Military Institute,Big South,29,897,186,419,.444,104,191,82,228,.360,78,110,.709,43,81,124,73,70,11,62,74,532
2113,Jeremiah Jefferson,SR,2018-19,G,Nicholls State,Southland,31,1068,194,447,.434,96,197,98,250,.392,46,64,.719,10,80,90,62,30,6,52,51,532
2114,Jarkel Joiner,SO,2018-19,G,Cal State Bakersfield,WAC,34,1096,208,461,.451,158,326,50,135,.370,66,93,.710,40,81,121,49,37,3,43,71,532
2115,Johnathan Jordan,SR,2014-15,G,Texas A&M-Corpus Christi,Southland,34,1219,167,373,.448,155,331,12,42,.286,186,283,.657,28,104,132,178,63,3,88,71,532
2118,Travis Munnings,SR,2018-19,F,Louisiana-Monroe,Sun Belt,35,1275,184,405,.454,112,216,72,189,.381,92,123,.748,78,196,274,91,25,6,93,102,532
2119,Le'Bryan Nash,JR,2014-15,G,Oklahoma State,Big 12,31,982,178,385,.462,176,365,2,20,.100,174,220,.791,37,139,176,62,24,29,100,92,532
2120,Shane Richards,SR,2015-16,F,Manhattan,MAAC,31,1125,154,398,.387,76,183,78,215,.363,146,170,.859,19,99,118,52,29,3,63,77,532
2121,Shawn Roundtree,JR,2017-18,G,Central Michigan,MAC,36,1187,166,416,.399,110,251,56,165,.339,144,175,.823,21,84,105,151,23,1,113,61,532
2122,Bryson Scott,JR,2016-17,G,Purdue-Fort Wayne,Summit,33,928,193,407,.474,135,235,58,172,.337,88,127,.693,28,136,164,76,56,3,83,62,532
2123,Jordan Taylor,SR,2011-12,G,Wisconsin,Big Ten,36,1297,166,413,.402,101,237,65,176,.369,135,172,.785,31,106,137,147,37,1,56,73,532
2124,Anthony Vereen,SR,2008-09,F,Texas-Arlington,Southland,30,889,176,303,.581,166,275,10,28,.357,170,217,.783,59,136,195,67,23,4,49,90,532
2125,Tim Ambrose,SR,2010-11,G,Albany (NY),AEC,32,1086,192,422,.455,130,277,62,145,.428,85,122,.697,40,126,166,116,43,5,96,89,531
2126,Anthony Beane,JR,2014-15,G,Southern Illinois,MVC,33,1148,187,442,.423,139,298,48,144,.333,109,134,.813,18,69,87,36,41,10,59,72,531
2127,Marqus Blakely,JR,2008-09,F,Vermont,AEC,33,1080,199,326,.610,198,323,1,3,.333,132,235,.562,94,203,297,84,67,88,108,102,531
2128,Jaylen Bland,SR,2015-16,G,UC-Riverside,Big West,33,1120,166,422,.393,48,130,118,292,.404,81,98,.827,15,109,124,59,47,5,74,69,531
2129,Khadeen Carrington,SR,2017-18,G,Seton Hall,Big East,34,1120,170,407,.418,117,263,53,144,.368,138,167,.826,20,86,106,150,36,10,79,73,531
2130,Jamelle Cornley,SR,2008-09,F,Penn State,Big Ten,37,1288,221,427,.518,202,378,19,49,.388,70,130,.538,74,160,234,44,14,5,66,58,531
2131,Anthony Cowan,JR,2018-19,G,Maryland,Big Ten,34,1178,168,428,.393,98,220,70,208,.337,125,155,.806,13,113,126,150,31,7,94,78,531
2132,Geno Crandall,JR,2017-18,G,North Dakota,Big Sky,32,1068,179,356,.503,129,236,50,120,.417,123,169,.728,32,107,139,114,67,3,105,97,531
2133,Will Cummings,SR,2014-15,G,Temple,AAC,36,1224,159,396,.402,135,291,24,105,.229,189,234,.808,33,114,147,151,67,7,71,86,531
2134,Taquan Dean,SR,2005-06,G,Louisville,Big East,31,1025,167,437,.382,62,162,105,275,.382,92,107,.860,39,135,174,107,32,2,79,71,531
2135,Paul Delaney,SR,2008-09,G,Alabama-Birmingham,CUSA,33,1157,180,322,.559,158,263,22,59,.373,149,193,.772,29,117,146,115,70,5,73,66,531
2136,James Florence,SO,2007-08,G,Mercer,A-Sun,28,896,179,507,.353,112,265,67,242,.277,106,160,.663,14,102,116,84,49,6,106,94,531
2137,Shan Foster,JR,2006-07,G,Vanderbilt,SEC,34,1101,191,425,.449,117,211,74,214,.346,75,89,.843,47,111,158,78,40,14,63,57,531
2140,Taurean Green,JR,2006-07,G,Florida,SEC,40,1328,154,347,.444,72,145,82,202,.406,141,166,.849,9,87,96,147,42,1,107,60,531
2141,Ken Horton,SR,2011-12,F,Central Connecticut State,NEC,28,967,192,391,.491,146,244,46,147,.313,101,126,.802,77,173,250,48,59,40,52,72,531
2142,Dominique Jones,FR,2007-08,G,South Florida,Big East,31,1085,177,385,.460,123,232,54,153,.353,123,162,.759,44,99,143,86,47,8,70,73,531
2143,Marco Killingsworth,SR,2005-06,F,Indiana,Big Ten,31,882,211,389,.542,207,368,4,21,.190,105,173,.607,76,166,242,59,22,21,122,106,531
2144,JeQuan Lewis,SR,2016-17,G,Virginia Commonwealth,A-10,35,1092,168,390,.431,85,164,83,226,.367,112,137,.818,8,91,99,158,61,3,86,87,531
2145,Charles Matthews,JR,2017-18,G,Michigan,Big Ten,41,1234,205,414,.495,171,307,34,107,.318,87,156,.558,53,174,227,98,30,26,84,88,531
2146,Cleveland Melvin,JR,2012-13,F,DePaul,Big East,32,994,216,451,.479,201,400,15,51,.294,84,124,.677,81,136,217,25,39,26,72,58,531
2147,Ajdin Penava,JR,2017-18,F,Marshall,CUSA,34,1001,191,340,.562,158,243,33,97,.340,116,154,.753,67,221,288,66,32,134,67,121,531
2148,Tim Pollitz,JR,2006-07,F,Miami (OH),MAC,33,1165,234,408,.574,232,405,2,3,.667,61,93,.656,63,123,186,56,33,19,92,74,531
2149,Rome Sanders,SR,2006-07,C,Florida A&M,MEAC,35,1083,173,265,.653,173,265,0,0,,185,244,.758,93,116,209,30,7,10,83,94,531
2150,John Shurna,JR,2010-11,F,Northwestern,Big Ten,32,1088,176,366,.481,101,193,75,173,.434,104,147,.707,31,126,157,83,36,31,58,57,531
2151,Jamaal Tatum,SR,2006-07,G,Southern Illinois,MVC,35,1149,172,395,.435,101,221,71,174,.408,116,149,.779,30,74,104,85,41,0,83,63,531
2152,PJ Washington,SO,2018-19,F,Kentucky,SEC,35,1024,190,364,.522,157,286,33,78,.423,118,178,.663,81,183,264,63,29,43,69,86,531
2153,Charles Williams,FR,2016-17,G,Howard,MEAC,34,1019,179,452,.396,113,259,66,193,.342,107,141,.759,34,54,88,20,19,12,57,73,531
2154,Grant Williams,SO,2017-18,F,Tennessee,SEC,35,1008,183,387,.473,180,362,3,25,.120,162,212,.764,81,130,211,66,21,44,74,116,531
2155,Khalif Wyatt,JR,2011-12,G,Temple,A-10,31,1022,162,338,.479,109,198,53,140,.379,154,180,.856,22,76,98,103,69,13,76,80,531
2156,Milik Yarbrough,JR,2017-18,F,Illinois State,MVC,32,895,172,380,.453,141,273,31,107,.290,156,194,.804,46,164,210,152,30,21,126,85,531
2157,Jerrelle Benimon,SR,2012-13,F,Towson,CAA,31,1116,188,353,.533,168,304,20,49,.408,134,205,.654,102,244,346,79,21,60,120,85,530
2158,Folarin Campbell,SR,2007-08,G,George Mason,CAA,34,1117,161,384,.419,101,219,60,165,.364,148,202,.733,27,127,154,112,39,16,102,86,530
2159,Raasean Davis,JR,2017-18,F,North Carolina Central,MEAC,35,1015,233,347,.671,233,346,0,1,.000,64,109,.587,102,180,282,15,20,35,70,82,530
2160,Seth Dugan,SR,2018-19,C,Western Michigan,MAC,32,1066,209,372,.562,207,357,2,15,.133,110,171,.643,108,208,316,54,11,29,68,72,530
2161,Dorian Finney-Smith,SR,2015-16,F,Florida,SEC,36,1145,169,387,.437,98,194,71,193,.368,121,165,.733,89,211,300,74,33,29,68,78,530
2162,Allerik Freeman,SR,2017-18,G,North Carolina State,ACC,33,1135,164,425,.386,94,243,70,182,.385,132,170,.776,20,117,137,85,40,0,82,56,530
2163,Alex Hamilton,JR,2014-15,G,Louisiana Tech,CUSA,36,1099,170,395,.430,136,276,34,119,.286,156,209,.746,28,91,119,94,62,9,76,63,530
2164,Darnell Harris,SR,2007-08,G,La Salle,A-10,32,1063,176,389,.452,53,132,123,257,.479,55,72,.764,6,66,72,65,36,8,36,59,530
2165,Ryan Harrow,SR,2014-15,G,Georgia State,Sun Belt,29,923,208,413,.504,165,304,43,109,.394,71,99,.717,11,49,60,104,42,3,55,43,530
2166,Frank Kaminsky,JR,2013-14,C,Wisconsin,Big Ten,38,1032,196,371,.528,159,273,37,98,.378,101,132,.765,81,159,240,49,26,66,39,96,530
2167,Michael Lyons,SR,2012-13,G,Air Force,MWC,30,948,191,405,.472,139,244,52,161,.323,96,133,.722,39,79,118,69,30,4,56,61,530
2168,Nazareth Mitrou-Long,SR,2016-17,G,Iowa State,Big 12,35,1164,185,391,.473,87,136,98,255,.384,62,78,.795,24,136,160,93,43,1,59,75,530
2169,Kwame Morgan,JR,2010-11,G,Hampton,MEAC,33,1098,167,450,.371,67,177,100,273,.366,96,120,.800,40,107,147,44,48,4,43,52,530
2170,Lamond Murray,JR,2015-16,G,Pepperdine,WCC,32,1009,207,442,.468,176,363,31,79,.392,85,112,.759,49,124,173,28,30,17,40,69,530
2171,Ike Nwamu,JR,2014-15,G,Mercer,Southern,35,1163,171,400,.428,91,185,80,215,.372,108,142,.761,24,91,115,56,26,14,75,62,530
2172,Jose Olivero,JR,2005-06,G,Lehigh,Patriot,31,1012,179,411,.436,108,237,71,174,.408,101,152,.664,23,75,98,91,30,1,99,71,530
2173,Arizona Reid,SO,2005-06,F,High Point,Big South,29,980,218,449,.486,201,413,17,36,.472,77,110,.700,81,178,259,49,42,9,89,57,530
2174,Terry Taylor,FR,2017-18,G,Austin Peay,OVC,34,1070,196,362,.541,158,274,38,88,.432,100,137,.730,133,158,291,25,20,34,61,85,530
2175,Terrico White,SO,2009-10,G,Mississippi,SEC,35,1103,192,447,.430,131,268,61,179,.341,85,119,.714,55,105,160,52,30,7,45,62,530
2176,Malik Beasley,FR,2015-16,G,Florida State,ACC,34,1014,185,393,.471,130,251,55,142,.387,104,128,.813,44,136,180,51,32,6,59,75,529
2177,Derick Beltran,SR,2012-13,G,Southern,SWAC,33,1147,171,428,.400,91,194,80,234,.342,107,135,.793,14,132,146,51,43,16,56,51,529
2178,Gary Blackston,SR,2018-19,G,Prairie View,SWAC,34,1062,176,410,.429,127,267,49,143,.343,128,195,.656,59,178,237,63,57,6,68,91,529
2179,Shannon Evans,SR,2017-18,G,Arizona State,Pac-12,32,1117,156,412,.379,61,156,95,256,.371,122,143,.853,11,93,104,112,44,9,53,60,529
2182,Gavin Grant,JR,2006-07,F,North Carolina State,ACC,36,1313,181,383,.473,152,291,29,92,.315,138,186,.742,38,152,190,137,19,22,151,87,529
2183,Dusty Hannahs,JR,2015-16,G,Arkansas,SEC,32,866,174,380,.458,93,193,81,187,.433,100,115,.870,19,58,77,29,20,0,41,68,529
2184,Justin Hawkins,JR,2006-07,G,New Mexico State,WAC,34,1110,195,372,.524,186,345,9,27,.333,130,185,.703,76,149,225,79,44,12,91,104,529
2185,Twymond Howard,SR,2015-16,F,Tennessee-Martin,OVC,34,1129,187,414,.452,165,353,22,61,.361,133,180,.739,41,196,237,83,24,13,78,80,529
2186,Ibrahim Jaaber,JR,2005-06,G,Pennsylvania,Ivy,29,1063,190,362,.525,134,216,56,146,.384,93,129,.721,33,66,99,64,96,15,49,69,529
2187,Nick Lewis,SR,2005-06,F,San Diego,WCC,30,908,191,372,.513,147,274,44,98,.449,103,130,.792,39,111,150,40,24,23,79,60,529
2188,Terrell Miller,JR,2016-17,F,Murray State,OVC,33,976,184,386,.477,117,217,67,169,.396,94,121,.777,78,191,269,46,26,7,79,108,529
2189,Donovan Mitchell,SO,2016-17,G,Louisville,ACC,34,1098,181,444,.408,101,218,80,226,.354,87,108,.806,37,128,165,93,70,17,56,88,529
2190,Tyler Nelson,SO,2015-16,G,Fairfield,MAAC,33,1169,158,368,.429,92,177,66,191,.346,147,167,.880,16,87,103,95,44,0,53,43,529
2191,Nick Perkins,SR,2018-19,F,Buffalo,MAC,36,943,184,393,.468,137,268,47,125,.376,114,170,.671,72,195,267,24,17,30,64,83,529
2192,Marcquise Reed,FR,2014-15,G,Robert Morris,NEC,35,973,197,402,.490,164,322,33,80,.413,102,131,.779,20,68,88,73,67,1,90,72,529
2193,Jontae Sherrod,SR,2010-11,G,East Carolina,CUSA,34,1016,153,360,.425,80,173,73,187,.390,150,189,.794,26,96,122,64,37,3,81,94,529
2194,Bernard Thompson,SO,2012-13,G,Florida Gulf Coast,A-Sun,37,1107,190,406,.468,136,264,54,142,.380,95,144,.660,49,114,163,64,102,4,80,93,529
2195,Savalance Townsend,SR,2011-12,G,Arkansas-Pine Bluff,SWAC,33,1233,170,414,.411,135,311,35,103,.340,154,210,.733,38,117,155,103,73,22,98,71,529
2196,Brad Waldow,JR,2013-14,F,Saint Mary's (CA),WCC,35,1013,191,338,.565,191,337,0,1,.000,147,239,.615,111,150,261,50,21,46,59,80,529
2197,Thomas Walkup,JR,2014-15,G,Stephen F. Austin,Southland,34,943,185,326,.567,174,284,11,42,.262,148,199,.744,84,136,220,126,40,6,73,100,529
2198,Pendarvis Williams,SR,2013-14,G,Norfolk State,MEAC,34,1172,184,375,.491,123,203,61,172,.355,100,120,.833,39,129,168,89,51,10,55,84,529
2199,Muhammad-Ali Abdur-Rahkman,SR,2017-18,G,Michigan,Big Ten,41,1432,179,415,.431,106,220,73,195,.374,97,129,.752,27,131,158,132,35,7,30,64,528
2200,De'Angelo Alexander,SR,2006-07,G,Charlotte,A-10,30,1049,177,443,.400,99,210,78,233,.335,96,122,.787,90,125,215,55,38,6,60,67,528
2201,Craig Brackins,JR,2009-10,F,Iowa State,Big 12,32,1124,192,457,.420,165,370,27,87,.310,117,154,.760,67,206,273,69,25,38,68,64,528
2204,Keith Braxton,JR,2018-19,G,Saint Francis (PA),NEC,33,1129,182,398,.457,141,277,41,121,.339,123,160,.769,56,266,322,124,49,11,82,56,528
2205,Jalen Brunson,SO,2016-17,G,Villanova,Big East,36,1118,183,338,.541,141,227,42,111,.378,120,137,.876,17,76,93,148,32,0,74,59,528
2206,Draelon Burns,SR,2007-08,G,DePaul,Big East,30,962,173,430,.402,110,248,63,182,.346,119,147,.810,27,74,101,74,51,3,54,54,528
2207,Marcus Graves,SR,2018-19,G,Sacramento State,Big Sky,31,1077,182,431,.422,132,302,50,129,.388,114,144,.792,28,119,147,167,61,2,96,81,528
2208,Jeff Green,JR,2006-07,F,Georgetown,Big East,37,1232,196,382,.513,160,286,36,96,.375,100,129,.775,62,174,236,117,30,43,96,92,528
2209,Jalen Hudson,JR,2017-18,G,Florida,SEC,34,904,179,393,.455,101,200,78,193,.404,92,139,.662,13,119,132,36,26,20,40,72,528
2210,Sean Kilpatrick,SO,2011-12,G,Cincinnati,Big East,37,1277,185,432,.428,93,187,92,245,.376,66,88,.750,52,117,169,78,49,12,56,49,528
2211,Romeo Langford,FR,2018-19,G,Indiana,Big Ten,32,1090,177,395,.448,143,270,34,125,.272,140,194,.722,45,127,172,75,25,26,68,60,528
2212,C.J. Leslie,JR,2012-13,F,North Carolina State,ACC,35,1135,192,370,.519,190,364,2,6,.333,142,232,.612,65,193,258,51,34,43,105,86,528
2213,Max Mahoney,JR,2018-19,F,Boston University,Patriot,32,865,222,353,.629,222,353,0,0,,84,132,.636,81,129,210,53,25,21,61,102,528
2214,Yante Maten,JR,2016-17,F,Georgia,SEC,29,842,179,345,.519,158,302,21,43,.488,149,208,.716,72,125,197,43,21,43,72,79,528
2215,Travis Niesen,SR,2005-06,F,Santa Clara,WCC,28,947,190,422,.450,175,371,15,51,.294,133,195,.682,48,137,185,44,20,5,86,69,528
2216,Jose Perez,FR,2018-19,G,Gardner-Webb,Big South,35,1101,175,391,.448,122,252,53,139,.381,125,178,.702,35,164,199,105,27,8,69,62,528
2217,Sayeed Pridgett,JR,2018-19,G,Montana,Big Sky,35,1045,230,380,.605,211,339,19,41,.463,49,86,.570,46,126,172,78,44,17,85,98,528
2218,Cameron Reynolds,JR,2016-17,G,Tulane,AAC,31,1090,184,434,.424,106,233,78,201,.388,82,103,.796,43,167,210,45,26,14,47,84,528
2219,Blake Schilb,SR,2006-07,G,Loyola (IL),Horizon,31,1034,179,396,.452,126,247,53,149,.356,117,137,.854,36,125,161,124,41,19,103,54,528
2220,Jackson Stevenett,SR,2012-13,F,Southern Utah,Big Sky,30,1014,184,410,.449,161,333,23,77,.299,137,158,.867,62,122,184,53,23,21,62,83,528
2221,Ahmad Thomas,SR,2017-18,G,North Carolina-Asheville,Big South,32,1028,220,438,.502,203,376,17,62,.274,71,107,.664,50,136,186,91,62,11,77,88,528
2222,Tai Webster,SR,2016-17,G,Nebraska,Big Ten,31,1075,183,435,.421,143,299,40,136,.294,122,164,.744,33,125,158,124,42,4,100,74,528
2223,James Woodard,SO,2013-14,G,Tulsa,CUSA,34,1101,162,370,.438,97,202,65,168,.387,139,178,.781,53,148,201,60,32,6,46,76,528
2226,Kyan Anderson,JR,2013-14,G,Texas Christian,Big 12,31,1072,161,342,.471,115,229,46,113,.407,159,187,.850,9,66,75,139,43,1,90,54,527
2227,Kyle Anderson,SO,2013-14,G,UCLA,Pac-12,36,1196,181,377,.480,153,319,28,58,.483,137,186,.737,45,270,315,233,64,27,110,60,527
2228,La'Shard Anderson,SR,2010-11,G,Boise State,WAC,35,1128,176,404,.436,143,296,33,108,.306,142,181,.785,29,84,113,165,77,13,109,111,527
2229,Jahsha Bluntt,SR,2006-07,G,Delaware State,MEAC,34,1228,169,400,.423,90,174,79,226,.350,110,134,.821,57,109,166,53,40,6,67,79,527
2230,Stephen Brown,SR,2017-18,G,Bucknell,Patriot,35,1059,186,386,.482,122,215,64,171,.374,91,109,.835,17,98,115,150,41,9,61,82,527
2231,Deonte Burton,SR,2016-17,G,Iowa State,Big 12,35,1034,203,445,.456,161,333,42,112,.375,79,117,.675,40,178,218,62,60,49,80,105,527
2232,Thomas Coleman,SR,2010-11,F,North Carolina A&T,MEAC,31,989,200,323,.619,200,322,0,1,.000,127,199,.638,116,209,325,44,36,83,79,76,527
2233,Cliff Colimon,SR,2011-12,G,Eastern Washington,Big Sky,32,1123,173,430,.402,107,247,66,183,.361,115,142,.810,19,101,120,160,52,4,105,87,527
2234,Johnny Dee,SR,2014-15,G,San Diego,WCC,31,965,167,390,.428,87,179,80,211,.379,113,123,.919,11,96,107,40,36,2,32,45,527
2235,Noah Dickerson,JR,2017-18,F,Washington,Pac-12,34,915,178,313,.569,176,308,2,5,.400,169,215,.786,93,191,284,30,23,19,77,114,527
2236,Langston Galloway,SO,2011-12,G,Saint Joseph's,A-10,34,1215,182,373,.488,92,180,90,193,.466,73,93,.785,34,119,153,76,35,20,41,91,527
2237,JaMychal Green,JR,2010-11,F,Alabama,SEC,34,948,190,374,.508,189,373,1,1,1.000,146,198,.737,106,150,256,49,49,70,95,111,527
2238,R.J. Hunter,FR,2012-13,G,Georgia State,CAA,31,1038,175,399,.439,102,199,73,200,.365,104,134,.776,30,128,158,57,53,26,52,52,527
2239,Armon Johnson,SO,2008-09,G,Nevada,WAC,34,1097,193,448,.431,168,358,25,90,.278,116,147,.789,27,95,122,145,30,6,84,42,527
2240,Ben Lammers,JR,2016-17,C,Georgia Tech,ACC,37,1309,214,415,.516,213,413,1,2,.500,98,133,.737,111,231,342,78,43,125,64,85,527
2241,Jaron Lane,SR,2013-14,F,North Carolina-Asheville,Big South,32,1070,168,335,.501,132,246,36,89,.404,155,201,.771,49,128,177,48,30,14,53,68,527
2242,Greg Mangano,SR,2011-12,F,Yale,Ivy,29,931,197,416,.474,159,302,38,114,.333,95,145,.655,91,188,279,14,12,65,57,78,527
2243,Jared Newson,SR,2005-06,F,Tennessee-Martin,OVC,28,980,181,400,.453,145,311,36,89,.404,129,182,.709,53,132,185,39,48,16,75,52,527
2244,Juvonte Reddic,JR,2012-13,F,Virginia Commonwealth,A-10,36,1004,210,369,.569,209,363,1,6,.167,106,150,.707,122,169,291,23,50,31,59,83,527
2245,Austin Rivers,FR,2011-12,G,Duke,ACC,34,1129,174,402,.433,116,243,58,159,.365,121,184,.658,21,94,115,71,33,1,79,76,527
2248,Augustine Rubit,SR,2013-14,F,South Alabama,Sun Belt,31,973,185,400,.463,164,336,21,64,.328,136,204,.667,129,163,292,42,23,46,61,79,527
2249,Tyler Seibring,SR,2018-19,F,Elon,CAA,32,1044,191,396,.482,114,209,77,187,.412,68,85,.800,44,145,189,49,14,16,28,52,527
2250,Kendall Anthony,JR,2013-14,G,Richmond,A-10,33,1028,166,429,.387,84,197,82,232,.353,112,136,.824,14,36,50,54,21,1,46,75,526
2251,Marcus Barham,SR,2017-18,G,Florida A&M,MEAC,31,1115,169,431,.392,84,197,85,234,.363,103,123,.837,32,101,133,59,25,6,92,60,526
2252,Brayon Blake,SR,2017-18,F,Idaho,Big Sky,31,898,202,404,.500,150,288,52,116,.448,70,106,.660,65,233,298,38,22,15,60,93,526
2253,Craig Bradshaw,SR,2015-16,G,Belmont,OVC,32,1034,176,399,.441,89,164,87,235,.370,87,118,.737,25,101,126,103,40,12,77,80,526
2254,Devin Carter,SR,2016-17,G,Arkansas State,Sun Belt,32,1055,177,410,.432,75,156,102,254,.402,70,98,.714,23,91,114,25,29,5,39,76,526
2255,Quenton DeCosey,SR,2015-16,G,Temple,AAC,33,1142,164,407,.403,115,270,49,137,.358,149,191,.780,42,157,199,85,41,13,73,65,526
2256,James Feldeine,JR,2008-09,G,Quinnipiac,NEC,31,1057,189,454,.416,143,318,46,136,.338,102,137,.745,50,135,185,73,52,11,98,66,526
2257,Langston Hall,SR,2013-14,G,Mercer,A-Sun,36,1157,152,380,.400,66,160,86,220,.391,136,160,.850,14,97,111,201,52,5,85,51,526
2258,Marvelle Harris,JR,2014-15,G,Fresno State,MWC,32,1168,174,402,.433,121,237,53,165,.321,125,169,.740,23,138,161,120,65,8,85,96,526
2259,Omega Harris,JR,2016-17,G,Texas-El Paso,CUSA,31,1127,183,403,.454,134,273,49,130,.377,111,141,.787,11,100,111,66,40,5,86,67,526
2260,Mustapha Heron,SO,2017-18,G,Auburn,SEC,32,916,172,392,.439,129,262,43,130,.331,139,173,.803,41,129,170,30,38,2,66,82,526
2261,Gerald Lee,JR,2008-09,C,Old Dominion,CAA,34,1046,202,373,.542,200,366,2,7,.286,120,159,.755,78,115,193,49,23,28,68,75,526
2262,Rob Marberry,JR,2017-18,F,Lipscomb,A-Sun,33,940,218,356,.612,218,354,0,2,.000,90,122,.738,67,125,192,62,23,23,50,76,526
2263,Chima Moneke,JR,2016-17,F,UC-Davis,Big West,36,981,192,364,.527,192,364,0,0,,142,220,.645,92,249,341,29,32,51,94,95,526
2264,Jalen Moore,SR,2016-17,F,Utah State,MWC,31,1099,181,379,.478,118,231,63,148,.426,101,128,.789,29,143,172,82,16,15,62,46,526
2265,Darius Morris,SO,2010-11,G,Michigan,Big Ten,35,1219,201,411,.489,185,347,16,64,.250,108,151,.715,31,108,139,235,36,1,103,74,526
2266,Kyle O'Quinn,JR,2010-11,C,Norfolk State,MEAC,32,1050,198,356,.556,183,293,15,63,.238,115,151,.762,107,248,355,32,18,110,68,114,526
2267,Tayler Persons,SO,2016-17,G,Ball State,MAC,34,986,183,382,.479,139,277,44,105,.419,116,152,.763,13,118,131,167,44,2,105,88,526
2268,Myles Powell,SO,2017-18,G,Seton Hall,Big East,34,1078,171,395,.433,77,147,94,248,.379,90,114,.789,17,73,90,94,34,8,68,82,526
2269,Brandon Rush,SO,2006-07,G,Kansas,Big 12,38,1234,186,420,.443,111,246,75,174,.431,79,116,.681,58,154,212,76,15,34,78,60,526
2270,Omar Strong,SR,2012-13,G,Texas Southern,SWAC,31,1102,164,427,.384,44,98,120,329,.365,78,92,.848,19,86,105,65,27,0,67,65,526
2271,Dominique Sutton,SR,2011-12,F,North Carolina Central,MEAC,32,1086,183,316,.579,183,314,0,2,.000,160,241,.664,63,175,238,54,71,17,84,100,526
2272,B.J. Taylor,SR,2018-19,G,Central Florida,AAC,33,1135,139,362,.384,78,198,61,164,.372,187,240,.779,11,66,77,107,29,0,54,46,526
2273,Terrence Todd,SR,2005-06,G,Fairfield,MAAC,28,898,201,442,.455,174,359,27,83,.325,97,120,.808,29,85,114,73,29,1,58,62,526
2274,Edwin Ubiles,JR,2008-09,F,Siena,MAAC,35,1174,208,422,.493,187,354,21,68,.309,89,140,.636,55,117,172,75,52,34,91,46,526
2275,Davon Usher,JR,2012-13,G,Mississippi Valley State,SWAC,28,915,158,379,.417,97,225,61,154,.396,149,191,.780,48,122,170,40,45,10,63,65,526
2276,Marlain Veal,SR,2018-19,G,Southeastern Louisiana,Southland,33,1032,148,391,.379,78,192,70,199,.352,160,194,.825,25,88,113,147,58,3,147,84,526
2277,Kyle Visser,SR,2006-07,C,Wake Forest,ACC,31,899,188,322,.584,188,320,0,2,.000,150,233,.644,89,140,229,19,23,42,61,79,526
2278,Kobe Webster,SO,2018-19,G,Western Illinois,Summit,31,1054,195,455,.429,119,271,76,184,.413,60,85,.706,14,123,137,97,34,1,50,60,526
2279,Tim Abromaitis,SR,2010-11,F,Notre Dame,Big East,34,1162,169,371,.456,91,189,78,182,.429,109,139,.784,45,161,206,61,26,15,52,66,525
2280,Kenny Boynton,SO,2010-11,G,Florida,SEC,37,1218,169,439,.385,89,197,80,242,.331,107,130,.823,15,39,54,98,32,9,53,49,525
2281,Earl Clark,JR,2008-09,F,Louisville,Big East,37,1269,202,442,.457,171,347,31,95,.326,90,139,.647,102,220,322,119,38,51,119,71,525
2282,Tre' Coggins,SR,2016-17,G,Cal State Fullerton,Big West,30,966,177,429,.413,88,179,89,250,.356,82,98,.837,10,96,106,37,28,4,61,55,525
2283,Ella Ellis,JR,2011-12,F,Army,Patriot,30,915,161,391,.412,98,215,63,176,.358,140,169,.828,43,104,147,63,25,12,71,58,525
2284,James Gist,SR,2007-08,F,Maryland,ACC,33,1056,194,391,.496,172,320,22,71,.310,115,156,.737,60,200,260,45,42,77,90,101,525
2285,Javonte Green,SR,2014-15,F,Radford,Big South,34,891,185,340,.544,184,331,1,9,.111,154,221,.697,97,210,307,43,65,29,69,85,525
2286,Venky Jois,SR,2015-16,F,Eastern Washington,Big Sky,32,1060,220,324,.679,220,324,0,0,,85,181,.470,59,219,278,79,32,56,82,78,525
2287,DaVonte Lacy,SR,2014-15,G,Washington State,Pac-12,31,1005,158,389,.406,90,183,68,206,.330,141,183,.770,22,59,81,66,20,4,56,68,525
2290,Michael Lee,SR,2007-08,F,St. Bonaventure,A-10,30,1088,193,397,.486,161,313,32,84,.381,107,152,.704,68,172,240,43,44,16,86,64,525
2291,Elfrid Payton,SO,2012-13,G,Louisiana,Sun Belt,33,1171,187,394,.475,171,344,16,50,.320,135,210,.643,46,138,184,181,80,21,113,76,525
2292,Ryan Schneider,SR,2008-09,F,Marist,MAAC,33,1239,161,425,.379,73,184,88,241,.365,115,137,.839,41,230,271,45,47,23,81,59,525
2293,Mike Singletary,JR,2009-10,F,Texas Tech,Big 12,35,1209,167,372,.449,145,298,22,74,.297,169,238,.710,51,188,239,80,43,26,97,95,525
2294,Willie Warren,FR,2008-09,G,Oklahoma,Big 12,36,1128,172,364,.473,105,184,67,180,.372,114,146,.781,18,62,80,113,41,2,80,81,525
2295,Tremont Waters,FR,2017-18,G,Louisiana State,SEC,33,1089,168,403,.417,96,198,72,205,.351,117,146,.801,10,101,111,198,67,3,96,74,525
2296,Matt Webster,SR,2006-07,F,Evansville,MVC,31,864,150,299,.502,132,262,18,37,.486,207,282,.734,50,116,166,63,23,6,95,99,525
2297,Lonzo Ball,FR,2016-17,G,UCLA,Pac-12,36,1263,189,343,.551,109,149,80,194,.412,66,98,.673,33,183,216,274,66,28,89,65,524
2298,Bryce Brown,JR,2017-18,G,Auburn,SEC,33,1031,169,421,.401,62,141,107,280,.382,79,102,.775,19,46,65,55,32,7,43,55,524
2299,Jordan Caroline,SO,2016-17,F,Nevada,MWC,35,1230,174,376,.463,146,293,28,83,.337,148,251,.590,122,199,321,68,39,11,62,83,524
2300,Marcus Colbert,SR,2015-16,G,Montana State,Big Sky,31,1040,188,445,.422,135,294,53,151,.351,95,130,.731,26,69,95,158,34,3,83,96,524
2301,Toney Douglas,JR,2007-08,G,Florida State,ACC,34,1205,178,414,.430,116,240,62,174,.356,106,131,.809,25,83,108,98,90,11,95,90,524
2302,Phil Fayne,SR,2018-19,F,Illinois State,MVC,33,954,199,367,.542,199,366,0,1,.000,126,193,.653,98,110,208,26,36,40,57,108,524
2303,Jimmy Hall,JR,2015-16,F,Kent State,MAC,32,960,212,434,.488,206,414,6,20,.300,94,134,.701,93,161,254,72,20,18,97,87,524
2304,J.C. Hampton,JR,2015-16,G,Lipscomb,A-Sun,33,1087,170,424,.401,99,223,71,201,.353,113,136,.831,29,91,120,90,38,4,64,62,524
2305,Ricky Hickman,JR,2005-06,G,North Carolina-Greensboro,Southern,28,985,170,404,.421,108,221,62,183,.339,122,179,.682,46,73,119,68,77,7,91,78,524
2306,Matt Lojeski,SR,2006-07,G,Hawaii,WAC,31,1122,193,357,.541,149,241,44,116,.379,94,116,.810,48,129,177,139,52,22,92,61,524
2307,Phil Martin,SR,2011-12,G,UC-Riverside,Big West,30,1056,191,449,.425,152,338,39,111,.351,103,128,.805,36,131,167,31,15,13,73,53,524
2308,Frantz Massenat,SR,2013-14,G,Drexel,CAA,30,1105,161,398,.405,119,279,42,119,.353,160,222,.721,17,96,113,142,23,12,57,83,524
2309,Lotanna Nwogbo,SR,2015-16,F,Longwood,Big South,33,987,194,328,.591,193,326,1,2,.500,135,206,.655,104,168,272,19,16,43,84,102,524
2312,J.P. Primm,SR,2011-12,G,North Carolina-Asheville,Big South,34,1088,158,367,.431,83,162,75,205,.366,133,158,.842,18,94,112,142,64,2,81,84,524
2313,Jordon Talley,SR,2017-18,G,North Carolina-Wilmington,CAA,31,939,179,423,.423,104,236,75,187,.401,91,113,.805,16,71,87,176,30,2,78,94,524
2314,Charlie Westbrook,SR,2011-12,G,South Dakota,Summit,28,907,183,394,.464,146,299,37,95,.389,121,158,.766,23,89,112,62,48,24,71,62,524
2315,Josh Williams,SO,2014-15,G,Lipscomb,A-Sun,31,978,177,369,.480,108,193,69,176,.392,101,138,.732,50,102,152,61,42,5,72,87,524
2316,Emmy Andujar,SR,2014-15,F,Manhattan,MAAC,32,1019,192,375,.512,188,359,4,16,.250,135,192,.703,86,157,243,111,65,7,131,93,523
2317,Daniel Bejarano,JR,2013-14,G,Colorado State,MWC,32,1084,164,450,.364,103,260,61,190,.321,134,169,.793,73,194,267,105,35,18,58,59,523
2318,Kerry Blackshear,JR,2018-19,F,Virginia Tech,ACC,35,1050,184,362,.508,163,299,21,63,.333,134,182,.736,108,156,264,83,23,28,63,114,523
2319,Jarrell Brown,JR,2006-07,G,Army,Patriot,31,868,179,429,.417,92,215,87,214,.407,78,91,.857,16,58,74,46,25,1,42,38,523
2320,Bryant Crawford,JR,2017-18,G,Wake Forest,ACC,31,987,164,397,.413,107,238,57,159,.358,138,159,.868,12,79,91,152,48,5,101,74,523
2321,Dwayne Curtis,SR,2007-08,C,Mississippi,SEC,35,1089,212,335,.633,212,335,0,0,,99,147,.673,154,183,337,35,28,10,58,82,523
2322,Lenny Daniel,SR,2010-11,F,Cal State Northridge,Big West,32,911,185,328,.564,185,328,0,0,,153,265,.577,114,187,301,22,13,38,85,93,523
2323,Michael Haddix,SR,2006-07,C,Siena,MAAC,32,952,205,365,.562,205,365,0,0,,113,168,.673,94,146,240,27,21,22,51,87,523
2324,Pierre Jackson,JR,2011-12,G,Baylor,Big 12,38,1172,174,378,.460,105,209,69,169,.408,106,129,.822,33,77,110,223,68,3,134,88,523
2325,Janari Joesaar,SO,2014-15,F,Texas-Rio Grande Valley,WAC,31,1053,157,341,.460,95,177,62,164,.378,147,180,.817,67,139,206,75,39,18,86,80,523
2326,Stanley Johnson,FR,2014-15,F,Arizona,Pac-12,38,1081,174,390,.446,131,274,43,116,.371,132,178,.742,75,172,247,63,57,15,82,100,523
2327,David Kool,SO,2007-08,G,Western Michigan,MAC,32,1032,158,378,.418,87,189,71,189,.376,136,159,.855,12,91,103,75,27,2,78,68,523
2328,Rickey McGill,SR,2018-19,G,Iona,MAAC,33,1228,173,366,.473,126,232,47,134,.351,130,171,.760,31,117,148,160,78,9,92,84,523
2329,Rodney McGruder,JR,2011-12,G,Kansas State,Big 12,33,1085,188,406,.463,138,276,50,130,.385,97,121,.802,75,98,173,46,38,9,50,63,523
2330,Jerel McNeal,JR,2007-08,G,Marquette,Big East,35,1056,198,434,.456,163,319,35,115,.304,92,131,.702,56,115,171,124,76,15,98,109,523
2331,Johnny O'Bryant,JR,2013-14,F,Louisiana State,SEC,34,1020,202,409,.494,201,406,1,3,.333,118,186,.634,102,160,262,55,17,31,108,108,523
2334,Femi Olujobi,JR,2017-18,F,North Carolina A&T,MEAC,32,1022,185,345,.536,167,283,18,62,.290,135,174,.776,54,191,245,37,14,22,80,85,523
2335,Earl Pettis,SR,2011-12,G,La Salle,A-10,34,1064,199,429,.464,141,267,58,162,.358,67,84,.798,14,122,136,75,64,12,53,83,523
2336,Payton Pritchard,SO,2017-18,G,Oregon,Pac-12,36,1265,178,398,.447,93,192,85,206,.413,82,106,.774,18,120,138,171,51,0,76,88,523
2337,Levi Randolph,SR,2014-15,G,Alabama,SEC,34,1200,169,351,.481,130,239,39,112,.348,146,174,.839,32,142,174,84,50,6,48,72,523
2338,Ahmaad Rorie,SR,2018-19,G,Montana,Big Sky,35,1215,194,416,.466,131,239,63,177,.356,72,89,.809,18,125,143,142,32,2,54,63,523
2339,Josh Scott,SR,2015-16,F,Colorado,Pac-12,32,979,187,352,.531,184,343,3,9,.333,146,195,.749,87,195,282,58,20,51,40,56,523
2340,Wayne Selden,JR,2015-16,G,Kansas,Big 12,38,1134,189,399,.474,115,210,74,189,.392,71,116,.612,30,101,131,100,28,11,71,77,523
2341,Bryce Taylor,JR,2006-07,G,Oregon,Pac-10,37,1211,180,348,.517,126,220,54,128,.422,109,132,.826,61,109,170,64,37,7,55,78,523
2342,Kellen Thornton,SR,2012-13,F,Tennessee State,OVC,33,1025,211,393,.537,190,329,21,64,.328,80,113,.708,96,169,265,35,31,22,75,106,523
2343,Reggie Upshaw,SR,2016-17,F,Middle Tennessee,CUSA,36,1152,199,379,.525,166,275,33,104,.317,92,127,.724,79,166,245,85,40,31,55,81,523
2344,Billy Wampler,JR,2018-19,F,Wright State,Horizon,35,970,169,397,.426,91,183,78,214,.364,107,132,.811,24,95,119,41,19,5,38,72,523
2345,Kirk Williams,JR,2007-08,F,Longwood,Ind,31,1017,195,438,.445,159,321,36,117,.308,97,152,.638,69,131,200,72,53,12,109,101,523
2346,V.J. Beachem,SR,2016-17,F,Notre Dame,ACC,36,1230,187,443,.422,100,202,87,241,.361,61,73,.836,23,123,146,31,33,38,40,46,522
2347,Beau Beech,SR,2015-16,G,North Florida,A-Sun,34,1082,168,369,.455,71,140,97,229,.424,89,113,.788,40,177,217,67,42,17,55,100,522
2348,Jeff Beverly,JR,2016-17,F,Texas-San Antonio,CUSA,33,889,183,461,.397,161,366,22,95,.232,134,178,.753,76,118,194,33,13,6,77,96,522
2349,T.J. Carter,SR,2007-08,G,North Carolina-Wilmington,CAA,33,1061,173,403,.429,140,278,33,125,.264,143,167,.856,55,126,181,135,44,14,93,91,522
2350,Will Clyburn,SR,2012-13,G,Iowa State,Big 12,35,1104,166,375,.443,125,242,41,133,.308,149,194,.768,71,168,239,73,32,13,92,53,522
2351,Jerome Frink,SR,2016-17,F,Long Island University,NEC,31,1012,200,423,.473,171,337,29,86,.337,93,146,.637,69,206,275,72,30,31,91,84,522
2352,Ashton Gibbs,JR,2010-11,G,Pittsburgh,Big East,31,1016,170,363,.468,68,155,102,208,.490,80,90,.889,11,62,73,86,13,0,51,41,522
2353,Hillary Haley,JR,2010-11,G,Maryland-Eastern Shore,MEAC,31,924,171,415,.412,121,255,50,160,.313,130,179,.726,58,122,180,22,22,6,51,67,522
2356,Murphy Holloway,SR,2012-13,F,Mississippi,SEC,36,1131,214,385,.556,213,377,1,8,.125,93,171,.544,126,224,350,45,58,25,75,86,522
2357,Quinton Hosley,JR,2005-06,G,Fresno State,WAC,28,982,169,414,.408,122,277,47,137,.343,137,183,.749,92,165,257,38,58,31,69,74,522
2358,Paul Jackson,JR,2017-18,G,Eastern Michigan,MAC,35,1225,193,469,.412,161,361,32,108,.296,104,143,.727,12,62,74,162,48,2,99,83,522
2359,Jazz Johnson,SO,2016-17,G,Portland,WCC,33,1158,177,399,.444,116,252,61,147,.415,107,130,.823,11,83,94,75,27,2,78,76,522
2360,Bronson Koenig,SR,2016-17,G,Wisconsin,Big Ten,36,1129,181,432,.419,78,170,103,262,.393,57,63,.905,6,71,77,73,23,12,51,61,522
2361,Shane Larkin,SO,2012-13,G,Miami (FL),ACC,36,1311,183,382,.479,114,212,69,170,.406,87,112,.777,17,121,138,164,71,4,82,59,522
2362,Courtney Lee,SO,2005-06,G,Western Kentucky,Sun Belt,30,932,180,399,.451,118,247,62,152,.408,100,118,.847,64,125,189,86,77,10,82,71,522
2363,Stan Okoye,SO,2010-11,F,Virginia Military Institute,Big South,31,901,193,376,.513,159,280,34,96,.354,102,143,.713,85,164,249,52,35,24,70,78,522
2364,Albert Owens,JR,2016-17,C,Oral Roberts,Summit,30,934,206,419,.492,203,407,3,12,.250,107,147,.728,68,99,167,29,14,37,61,67,522
2365,Rodney Pryor,JR,2015-16,G,Robert Morris,NEC,29,931,178,410,.434,129,241,49,169,.290,117,136,.860,52,179,231,48,42,25,83,73,522
2366,Braylon Rayson,JR,2015-16,G,Central Michigan,MAC,32,1024,181,433,.418,100,222,81,211,.384,79,96,.823,21,96,117,55,29,0,60,57,522
2367,Drake Reed,SO,2006-07,F,Austin Peay,OVC,33,1102,207,399,.519,205,388,2,11,.182,106,169,.627,79,120,199,56,32,13,86,84,522
2368,Jonathan Rodriguez,SR,2009-10,F,Campbell,A-Sun,30,978,163,339,.481,140,267,23,72,.319,173,222,.779,72,170,242,60,45,15,75,70,522
2369,D'Vauntes Smith-Rivera,JR,2014-15,G,Georgetown,Big East,32,1102,157,373,.421,85,187,72,186,.387,136,158,.861,26,108,134,101,51,6,52,67,522
2370,Marreese Speights,SO,2007-08,C,Florida,SEC,36,874,216,346,.624,216,346,0,0,,90,130,.692,93,197,290,34,15,49,62,82,522
2371,Vernon Teel,JR,2009-10,G,Loyola Marymount,WCC,34,1195,171,350,.489,153,305,18,45,.400,162,239,.678,62,117,179,190,61,21,118,90,522
2372,Aaron Thomas,SO,2013-14,G,Florida State,ACC,36,1135,172,379,.454,133,274,39,105,.371,139,172,.808,36,116,152,65,57,11,88,88,522
2373,Sedrick Barefield,SR,2018-19,G,Utah,Pac-12,31,999,167,409,.408,74,169,93,240,.388,94,114,.825,10,55,65,118,29,0,81,65,521
2374,Jaycee Carroll,SO,2005-06,G,Utah State,WAC,32,1065,184,396,.465,91,190,93,206,.451,60,76,.789,17,96,113,83,31,4,55,59,521
2375,Tim Clifford,SR,2007-08,C,Holy Cross,Patriot,29,928,205,359,.571,191,317,14,42,.333,97,124,.782,85,73,158,35,21,67,73,100,521
2376,Brandon Edwards,SR,2013-14,F,Texas-Arlington,Sun Belt,32,1104,173,335,.516,132,221,41,114,.360,134,171,.784,114,200,314,26,24,55,43,84,521
2377,Robert Franks,JR,2017-18,F,Washington State,Pac-12,30,989,175,368,.476,109,205,66,163,.405,105,123,.854,49,148,197,58,15,29,70,85,521
2378,Tobias Harris,FR,2010-11,F,Tennessee,SEC,34,993,185,402,.460,162,326,23,76,.303,128,170,.753,67,180,247,44,24,29,62,70,521
2379,Austin Kenon,SO,2008-09,G,Virginia Military Institute,Big South,32,1017,171,398,.430,52,93,119,305,.390,60,84,.714,29,77,106,78,45,0,54,74,521
2380,Dedric Lawson,FR,2015-16,F,Memphis,AAC,33,1062,182,445,.409,154,365,28,80,.350,129,182,.709,104,203,307,84,39,55,104,86,521
2381,Brook Lopez,SO,2007-08,F,Stanford,Pac-10,27,831,184,393,.468,184,387,0,6,.000,153,194,.789,77,144,221,37,16,56,58,66,521
2382,Skip Mills,JR,2005-06,F,Ball State,MAC,28,987,178,394,.452,118,227,60,167,.359,105,142,.739,56,94,150,69,41,4,71,60,521
2383,Tasmin Mitchell,SR,2009-10,F,Louisiana State,SEC,31,1157,196,453,.433,164,359,32,94,.340,97,133,.729,94,198,292,59,41,16,69,70,521
2384,Luke Nelson,JR,2015-16,G,UC-Irvine,Big West,38,1178,177,412,.430,94,180,83,232,.358,84,97,.866,12,98,110,149,48,4,67,66,521
2385,Georges Niang,JR,2014-15,F,Iowa State,Big 12,34,1045,187,406,.461,141,291,46,115,.400,101,125,.808,35,149,184,117,17,16,91,96,521
2386,L.J. Peak,JR,2016-17,F,Georgetown,Big East,32,1051,168,349,.481,135,248,33,101,.327,152,191,.796,33,89,122,111,34,12,86,88,521
2387,Kendrick Perry,SO,2011-12,G,Youngstown State,Horizon,31,1078,177,367,.482,123,215,54,152,.355,113,160,.706,17,85,102,121,74,8,64,58,521
2388,Wesley Person,SO,2015-16,G,Troy,Sun Belt,31,1089,171,403,.424,75,146,96,257,.374,83,109,.761,17,92,109,46,7,5,38,42,521
2389,Jalen Pickett,FR,2018-19,G,Siena,MAAC,33,1225,184,422,.436,119,235,65,187,.348,88,118,.746,43,109,152,221,66,29,80,77,521
2390,Sylvester Seay,JR,2008-09,F,Fresno State,WAC,34,1018,177,396,.447,127,261,50,135,.370,117,169,.692,60,136,196,39,35,58,82,95,521
2391,Mike Smith,JR,2008-09,F,East Tennessee State,A-Sun,34,1188,175,387,.452,131,265,44,122,.361,127,164,.774,50,213,263,72,46,17,63,104,521
2392,Max Strus,JR,2017-18,G,DePaul,Big East,31,1104,171,419,.408,90,176,81,243,.333,98,122,.803,48,127,175,85,40,16,82,90,521
2393,Isiah Williams,JR,2010-11,G,Utah Valley,GWC,30,921,169,425,.398,87,207,82,218,.376,101,119,.849,11,70,81,56,13,3,56,69,521
2394,Eric Wise,SO,2009-10,F,UC-Irvine,Big West,32,1044,190,420,.452,184,393,6,27,.222,135,193,.699,73,134,207,97,30,15,67,80,521
2395,Brandon Young,SR,2013-14,G,DePaul,Big East,32,1114,178,411,.433,149,297,29,114,.254,136,201,.677,20,115,135,113,57,9,99,61,521
2398,Cole Aldrich,SO,2008-09,C,Kansas,Big 12,35,1037,199,333,.598,199,333,0,0,,122,154,.792,106,281,387,36,21,94,56,90,520
2399,Corey Allmond,SR,2009-10,G,Sam Houston State,Southland,33,1022,183,419,.437,87,162,96,257,.374,58,79,.734,13,65,78,77,32,0,45,36,520
2400,Francis Alonso,SO,2016-17,G,North Carolina-Greensboro,Southern,35,1007,152,338,.450,50,117,102,221,.462,114,130,.877,11,55,66,71,29,2,64,83,520
2401,Dee Bost,SR,2011-12,G,Mississippi State,SEC,33,1197,159,406,.392,84,189,75,217,.346,127,166,.765,18,92,110,183,66,7,100,73,520
2402,Brandon Bowdry,JR,2009-10,F,Eastern Michigan,MAC,32,1024,196,402,.488,185,361,11,41,.268,117,184,.636,89,230,319,36,35,14,74,95,520
2403,Denzel Bowles,JR,2009-10,F,James Madison,CAA,25,819,203,342,.594,203,342,0,0,,114,172,.663,80,150,230,62,13,36,86,72,520
2404,David Brown,SR,2014-15,G,Western Michigan,MAC,34,1119,165,389,.424,80,152,85,237,.359,105,143,.734,13,103,116,73,45,4,63,94,520
2405,William Buford,JR,2010-11,G,Ohio State,Big Ten,36,1167,200,433,.462,139,295,61,138,.442,59,70,.843,35,106,141,106,29,11,66,78,520
2406,Garrett Callahan,JR,2008-09,G,South Dakota State,Summit,33,1125,163,369,.442,84,184,79,185,.427,115,137,.839,21,80,101,63,26,2,82,69,520
2407,Bill Clark,SR,2010-11,G,Duquesne,A-10,32,993,162,350,.463,87,152,75,198,.379,121,162,.747,67,132,199,80,47,16,63,100,520
2408,Tyler Davis,JR,2017-18,C,Texas A&M,SEC,35,1018,206,352,.585,199,327,7,25,.280,101,162,.623,123,190,313,44,12,47,70,90,520
2409,Bobby Dixon,SR,2005-06,G,Troy,Sun Belt,29,1003,176,394,.447,86,157,90,237,.380,78,106,.736,30,124,154,192,88,3,95,53,520
2410,Rahmon Fletcher,JR,2009-10,G,Green Bay,Horizon,33,997,191,420,.455,140,281,51,139,.367,87,115,.757,9,55,64,97,55,2,102,80,520
2411,Jeremy Hunt,SR,2006-07,G,Memphis,CUSA,37,885,161,386,.417,72,153,89,233,.382,109,152,.717,25,83,108,50,50,13,50,70,520
2412,Courtney Lee,JR,2006-07,G,Western Kentucky,Sun Belt,30,918,187,396,.472,130,254,57,142,.401,89,106,.840,45,94,139,57,45,23,83,78,520
2413,Gerald Lee,SR,2009-10,C,Old Dominion,CAA,36,1055,192,355,.541,185,343,7,12,.583,129,170,.759,66,106,172,46,20,23,66,88,520
2414,E.C. Matthews,JR,2016-17,G,Rhode Island,A-10,35,1024,172,403,.427,108,213,64,190,.337,112,154,.727,23,128,151,50,18,12,66,59,520
2415,Jordan Murphy,SR,2018-19,F,Minnesota,Big Ten,36,1120,174,357,.487,166,327,8,30,.267,164,240,.683,118,279,397,93,21,29,79,99,520
2416,Mike Myers,SR,2014-15,F,Maryland-Eastern Shore,MEAC,33,871,169,285,.593,168,279,1,6,.167,181,282,.642,87,145,232,45,39,12,105,111,520
2417,Divine Myles,SR,2017-18,G,Stetson,A-Sun,31,1076,190,381,.499,156,272,34,109,.312,106,145,.731,24,115,139,130,49,4,49,53,520
2420,James Nunnally,JR,2010-11,F,UC-Santa Barbara,Big West,32,1055,167,358,.466,105,190,62,168,.369,124,150,.827,22,161,183,57,14,8,68,59,520
2421,Clifford Reed,SO,2009-10,G,Bethune-Cookman,MEAC,33,1236,180,492,.366,138,343,42,149,.282,118,155,.761,24,106,130,137,47,3,125,63,520
2422,Steven Rush,JR,2006-07,G,North Carolina A&T,MEAC,30,820,157,379,.414,42,92,115,287,.401,91,106,.858,10,61,71,39,18,1,49,49,520
2423,Parker Smith,SR,2012-13,G,North Florida,A-Sun,32,1034,160,375,.427,44,107,116,268,.433,84,96,.875,9,100,109,50,18,2,66,49,520
2424,Brandon Taylor,SR,2015-16,F,Penn State,Big Ten,32,1032,188,434,.433,137,292,51,142,.359,93,128,.727,51,156,207,50,19,17,80,94,520
2425,Reed Timmer,SO,2015-16,G,Drake,MVC,31,1025,166,359,.462,126,260,40,99,.404,148,182,.813,13,99,112,78,19,0,75,61,520
2426,Mike Trimboli,SO,2006-07,G,Vermont,AEC,33,1168,170,427,.398,105,242,65,185,.351,115,138,.833,23,90,113,166,62,9,112,64,520
2427,Kyle Vinales,FR,2011-12,G,Central Connecticut State,NEC,29,1007,179,456,.393,108,272,71,184,.386,91,108,.843,10,47,57,105,34,2,89,54,520
2428,Jordan Walker,JR,2018-19,G,Morehead State,OVC,33,1089,168,399,.421,96,218,72,181,.398,112,142,.789,29,87,116,85,39,4,76,84,520
2429,Kyle Wilson,SR,2015-16,G,Army,Patriot,33,1074,175,470,.372,75,169,100,301,.332,70,87,.805,12,63,75,55,13,9,58,56,520
2430,Matthew Wright,SR,2013-14,G,St. Bonaventure,A-10,32,1117,164,401,.409,96,213,68,188,.362,124,144,.861,28,72,100,101,35,2,90,66,520
2431,Justin Bibbins,SR,2017-18,G,Utah,Pac-12,35,1222,154,337,.457,61,125,93,212,.439,118,135,.874,13,91,104,163,45,4,71,88,519
2432,Rodney Bullock,JR,2016-17,F,Providence,Big East,33,1082,177,406,.436,131,261,46,145,.317,119,159,.748,45,166,211,47,38,27,81,76,519
2433,D.J. Fenner,JR,2015-16,G,Nevada,MWC,38,1283,174,476,.366,121,299,53,177,.299,118,138,.855,27,147,174,74,42,18,65,107,519
2434,Marcus Gilbert,SR,2015-16,F,Fairfield,MAAC,31,1020,165,385,.429,87,176,78,209,.373,111,142,.782,24,138,162,45,29,19,67,71,519
2435,Jeremy Green,JR,2010-11,G,Stanford,Pac-10,31,1011,173,409,.423,85,204,88,205,.429,85,107,.794,18,87,105,30,16,4,66,73,519
2436,Taurean Green,SO,2005-06,G,Florida,SEC,39,1302,130,355,.366,42,126,88,229,.384,171,193,.886,15,100,115,184,51,5,124,63,519
2437,Montrezl Harrell,SO,2013-14,F,Louisville,AAC,37,1083,223,366,.609,221,363,2,3,.667,71,153,.464,120,191,311,45,38,49,53,89,519
2438,Brandon Hazzard,JR,2008-09,G,Troy,Sun Belt,32,954,181,378,.479,98,193,83,185,.449,74,96,.771,10,62,72,53,25,0,47,42,519
2439,Tyler Herro,FR,2018-19,G,Kentucky,SEC,37,1207,186,403,.462,126,234,60,169,.355,87,93,.935,15,151,166,91,40,12,60,47,519
2442,Cory Jefferson,SR,2013-14,F,Baylor,Big 12,38,1103,184,368,.500,170,330,14,38,.368,137,214,.640,107,205,312,37,15,49,51,83,519
2443,Chavaughn Lewis,SO,2012-13,G,Marist,MAAC,31,1090,190,453,.419,165,379,25,74,.338,114,182,.626,46,130,176,85,63,17,110,82,519
2444,Aleks Maric,SR,2007-08,C,Nebraska,Big 12,33,968,191,332,.575,190,326,1,6,.167,136,207,.657,131,204,335,64,44,57,79,80,519
2445,Jack McClinton,SO,2006-07,G,Miami (FL),ACC,31,976,163,403,.404,72,196,91,207,.440,102,114,.895,14,63,77,66,22,1,74,70,519
2446,Kevin Pangos,JR,2013-14,G,Gonzaga,WCC,36,1239,159,370,.430,75,166,84,204,.412,117,134,.873,8,110,118,128,37,1,60,70,519
2447,Kendrick Perry,JR,2012-13,G,Youngstown State,Horizon,30,1061,158,359,.440,108,219,50,140,.357,153,181,.845,31,133,164,122,56,13,60,82,519
2448,Desi Rodriguez,JR,2016-17,F,Seton Hall,Big East,33,1054,192,437,.439,142,296,50,141,.355,85,133,.639,43,128,171,58,27,14,69,83,519
2449,Kyle Roemer,JR,2007-08,F,Colgate,Patriot,32,1059,170,413,.412,88,207,82,206,.398,97,128,.758,37,106,143,49,42,5,79,68,519
2450,JaJuan Smith,SR,2007-08,G,Tennessee,SEC,36,992,174,377,.462,81,134,93,243,.383,78,102,.765,26,108,134,81,61,1,61,88,519
2451,Marques Townes,SR,2018-19,G,Loyola (IL),MVC,34,1146,192,412,.466,153,299,39,113,.345,96,126,.762,17,153,170,124,36,8,76,48,519
2452,Ken Williams,SO,2014-15,G,South Alabama,Sun Belt,33,1087,165,439,.376,78,204,87,235,.370,102,129,.791,13,108,121,80,24,9,76,66,519
2453,Christian Wood,SO,2014-15,F,Nevada-Las Vegas,MWC,33,1078,187,376,.497,162,288,25,88,.284,120,163,.736,94,235,329,43,11,90,79,86,519
2454,Dion Wright ,SR,2015-16,F,St. Bonaventure,A-10,31,1150,199,426,.467,175,350,24,76,.316,97,122,.795,90,192,282,38,30,23,45,87,519
2455,Eddie Ard,SO,2005-06,G,Lipscomb,A-Sun,32,944,187,376,.497,146,279,41,97,.423,103,126,.817,54,119,173,50,58,19,99,97,518
2456,J.J. Avila,SR,2014-15,F,Colorado State,MWC,31,995,206,373,.552,197,336,9,37,.243,97,153,.634,91,140,231,88,62,11,84,81,518
2457,Ike Azotam,SR,2013-14,F,Quinnipiac,MAAC,32,1068,196,408,.480,196,407,0,1,.000,126,201,.627,132,195,327,31,10,35,63,90,518
2458,Mike Black,SR,2012-13,G,Albany (NY),AEC,35,1130,160,401,.399,104,253,56,148,.378,142,186,.763,27,84,111,84,36,2,101,67,518
2459,James Blackmon,FR,2014-15,G,Indiana,Big Ten,33,989,177,421,.420,100,222,77,199,.387,87,108,.806,53,123,176,50,21,2,53,51,518
2460,Garfield Blair,SR,2008-09,G,Stetson,A-Sun,30,987,187,432,.433,148,322,39,110,.355,105,147,.714,62,170,232,63,33,18,94,75,518
2461,Tyrone Brazelton,SR,2007-08,G,Western Kentucky,Sun Belt,36,986,174,389,.447,105,228,69,161,.429,101,150,.673,21,78,99,134,39,2,101,108,518
2464,De'Mon Brooks,SO,2011-12,F,Davidson,Southern,33,752,202,381,.530,181,324,21,57,.368,93,129,.721,80,126,206,26,33,17,56,107,518
2465,Mike Caffey,JR,2013-14,G,Cal State Long Beach,Big West,32,1106,185,452,.409,143,307,42,145,.290,106,160,.663,51,90,141,136,45,4,98,66,518
2466,Ajay Calvin,SR,2006-07,F,Drake,MVC,32,1043,208,405,.514,191,353,17,52,.327,85,126,.675,80,116,196,25,21,5,55,53,518
2467,Brandon Clarke,SO,2016-17,F,San Jose State,MWC,30,957,219,370,.592,218,367,1,3,.333,79,138,.572,89,172,261,69,35,77,53,78,518
2468,Karl Cochran,JR,2013-14,G,Wofford,Southern,33,1011,193,465,.415,115,261,78,204,.382,54,80,.675,20,144,164,100,55,19,64,74,518
2469,Mike Daum,FR,2015-16,F,South Dakota State,Summit,34,706,172,311,.553,143,246,29,65,.446,145,176,.824,71,136,207,27,17,11,56,71,518
2470,Dontaye Draper,JR,2005-06,G,College of Charleston,Southern,28,985,180,416,.433,118,230,62,186,.333,96,131,.733,24,48,72,90,62,12,97,73,518
2471,Malik Fitts,SO,2018-19,F,Saint Mary's (CA),WCC,34,1045,183,385,.475,125,242,58,143,.406,94,122,.770,61,196,257,32,39,7,53,95,518
2472,Chris Fowler,JR,2014-15,G,Central Michigan,MAC,32,1093,183,361,.507,163,295,20,66,.303,132,194,.680,16,83,99,194,49,7,91,77,518
2473,Kellan Grady,SO,2018-19,G,Davidson,A-10,30,1127,194,430,.451,136,260,58,170,.341,72,98,.735,12,122,134,57,31,5,50,46,518
2474,Dusty Hannahs,SR,2016-17,G,Arkansas,SEC,36,890,168,383,.439,94,192,74,191,.387,108,119,.908,20,42,62,43,16,4,60,63,518
2475,Venky Jois,JR,2014-15,F,Eastern Washington,Big Sky,31,966,210,344,.610,207,334,3,10,.300,95,176,.540,82,156,238,63,37,69,71,75,518
2476,MoMo Jones,JR,2011-12,G,Iona,MAAC,33,1132,197,429,.459,144,279,53,150,.353,71,91,.780,25,83,108,95,40,2,71,64,518
2477,Tyler Kohl,JR,2017-18,G,Central Connecticut State,NEC,31,1080,180,427,.422,137,279,43,148,.291,115,146,.788,59,195,254,128,42,4,114,61,518
2478,Nate Mason,JR,2016-17,G,Minnesota,Big Ten,34,1174,169,450,.376,115,300,54,150,.360,126,156,.808,22,102,124,169,46,4,65,55,518
2479,James Michael McAdoo,SO,2012-13,F,North Carolina,ACC,36,1079,209,470,.445,209,468,0,2,.000,100,173,.578,89,174,263,41,54,14,96,84,518
2480,Ben McCauley,SO,2006-07,F,North Carolina State,ACC,36,1243,211,361,.584,211,359,0,2,.000,96,147,.653,86,161,247,115,36,22,90,97,518
2481,Jordan McRae,JR,2012-13,G,Tennessee,SEC,33,1107,170,402,.423,110,233,60,169,.355,118,153,.771,31,105,136,66,26,29,93,77,518
2482,Markieff Morris,JR,2010-11,C,Kansas,Big 12,38,926,195,331,.589,170,272,25,59,.424,103,153,.673,103,213,316,53,30,43,78,108,518
2483,Chamberlain Oguchi,SR,2008-09,G,Illinois State,MVC,34,1076,162,394,.411,72,165,90,229,.393,104,127,.819,34,151,185,44,34,14,52,86,518
2484,Anthony Raffa,JR,2011-12,G,Coastal Carolina,Big South,31,962,184,383,.480,139,257,45,126,.357,105,144,.729,42,74,116,63,57,2,67,71,518
2485,DeWayne Reed,SR,2009-10,G,Auburn,SEC,32,1059,167,426,.392,118,276,49,150,.327,135,190,.711,13,70,83,139,43,7,102,69,518
2486,Marcellus Sommerville,SR,2005-06,F,Bradley,MVC,33,1050,183,450,.407,124,286,59,164,.360,93,119,.782,68,158,226,23,26,13,78,82,518
2487,Steven Spieth,SR,2016-17,G,Brown,Ivy,30,1037,153,314,.487,103,191,50,123,.407,162,184,.880,43,137,180,100,43,11,101,85,518
2488,Malik Story,SR,2012-13,G,Nevada,MWC,31,1027,173,425,.407,90,193,83,232,.358,89,120,.742,6,99,105,69,36,3,73,84,518
2489,Frank Turner,SR,2009-10,G,Canisius,MAAC,32,1226,172,365,.471,149,294,23,71,.324,151,211,.716,24,139,163,182,66,3,106,80,518
2490,Lindell Wigginton,FR,2017-18,G,Iowa State,Big 12,31,1022,171,413,.414,102,241,69,172,.401,107,162,.660,20,96,116,88,28,13,92,78,518
2491,Michael Young,JR,2015-16,F,Pittsburgh,ACC,33,971,189,352,.537,185,340,4,12,.333,136,175,.777,76,152,228,77,11,18,81,54,518
2492,Nick Young,SO,2005-06,F,Southern California,Pac-10,30,1017,191,409,.467,168,340,23,69,.333,113,141,.801,74,124,198,49,31,7,67,77,518
2493,Scott Bamforth,SR,2012-13,G,Weber State,Big Sky,37,1150,163,337,.484,60,111,103,226,.456,88,102,.863,7,135,142,87,38,2,47,64,517
2494,Ryan Broekhoff,SR,2012-13,G,Valparaiso,Horizon,33,1062,158,353,.448,75,154,83,199,.417,118,134,.881,40,200,240,75,34,27,64,46,517
2495,Darrell Brown,JR,2018-19,G,Bradley,MVC,35,1178,164,416,.394,85,238,79,178,.444,110,149,.738,7,60,67,111,33,3,84,74,517
2496,Deonte Burton,SO,2011-12,G,Nevada,WAC,35,1152,147,366,.402,89,210,58,156,.372,165,207,.797,13,78,91,148,38,13,71,82,517
2497,Eric Devendorf,SO,2006-07,G,Syracuse,Big East,35,1081,172,417,.412,118,264,54,153,.353,119,150,.793,15,79,94,145,43,11,109,93,517
2498,Weyinmi Efejuku,SR,2008-09,G,Providence,Big East,33,974,165,353,.467,125,250,40,103,.388,147,186,.790,46,86,132,77,48,7,74,52,517
2499,Muhammad El-Amin,SR,2009-10,G,Stony Brook,AEC,31,942,180,448,.402,125,290,55,158,.348,102,128,.797,28,76,104,59,33,5,71,65,517
2500,Brandon Ewing,JR,2007-08,G,Wyoming,MWC,30,1140,162,376,.431,102,208,60,168,.357,133,161,.826,18,89,107,121,38,3,103,64,517
2501,Ethan Happ,SO,2016-17,F,Wisconsin,Big Ten,37,1033,218,372,.586,218,372,0,0,,81,162,.500,117,215,332,104,67,43,80,102,517
2502,Chris Hass,SR,2015-16,G,Bucknell,Patriot,30,945,163,385,.423,103,203,60,182,.330,131,158,.829,24,97,121,48,34,14,63,65,517
2503,Nigel Hayes,SR,2016-17,F,Wisconsin,Big Ten,37,1190,180,394,.457,158,324,22,70,.314,135,230,.587,82,163,245,100,28,14,63,67,517
2506,Derrick Henry,SR,2015-16,G,The Citadel,Southern,32,838,152,358,.425,111,218,41,140,.293,172,218,.789,34,96,130,43,37,0,51,63,517
2507,Travis Holmes,SR,2008-09,F,Virginia Military Institute,Big South,27,850,172,346,.497,136,227,36,119,.303,137,174,.787,38,128,166,117,87,17,81,73,517
2508,Chris Lofton,SO,2005-06,G,Tennessee,SEC,30,957,174,373,.466,60,112,114,261,.437,55,60,.917,30,76,106,56,60,3,36,55,517
2509,Chris Lykes,SO,2018-19,G,Miami (FL),ACC,32,1082,171,421,.406,110,229,61,192,.318,114,146,.781,14,72,86,103,43,1,93,72,517
2510,Kelan Martin,SO,2015-16,F,Butler,Big East,33,935,183,409,.447,137,287,46,122,.377,105,138,.761,52,172,224,36,25,18,54,88,517
2511,Nate Mason,SR,2017-18,G,Minnesota,Big Ten,31,1057,168,428,.393,91,231,77,197,.391,104,134,.776,18,95,113,130,34,2,47,60,517
2512,Ramone Moore,JR,2010-11,G,Temple,A-10,34,1151,178,398,.447,137,291,41,107,.383,120,151,.795,25,118,143,105,40,8,82,64,517
2513,Nile Murry,SR,2005-06,G,Texas Christian,MWC,31,1048,157,422,.372,90,239,67,183,.366,136,165,.824,45,86,131,82,53,2,87,86,517
2514,Matt Nelson,SR,2007-08,F,Boise State,WAC,33,971,202,312,.647,202,311,0,1,.000,113,181,.624,82,159,241,70,21,8,74,98,517
2515,Marcus Posley,JR,2014-15,G,St. Bonaventure,A-10,31,1114,170,445,.382,94,209,76,236,.322,101,129,.783,14,77,91,66,38,1,64,71,517
2516,Mike Rosario,FR,2008-09,G,Rutgers,Big East,32,1040,184,470,.391,108,218,76,252,.302,73,87,.839,39,72,111,45,34,6,94,74,517
2517,Alex Ruoff,SR,2008-09,G,West Virginia,Big East,33,1176,165,384,.430,77,148,88,236,.373,99,124,.798,29,89,118,112,55,11,69,80,517
2518,Corey Sanders,JR,2017-18,G,Rutgers,Big Ten,34,1127,205,511,.401,183,413,22,98,.224,85,120,.708,18,129,147,106,44,9,76,54,517
2519,John Caleb Sanders,JR,2012-13,G,Liberty,Big South,36,1088,165,385,.429,120,259,45,126,.357,142,183,.776,41,100,141,131,34,3,95,94,517
2520,Justin Simmons,JR,2012-13,G,Omaha,Summit,31,879,196,414,.473,153,307,43,107,.402,82,105,.781,26,99,125,64,37,20,93,42,517
2521,Ivy Smith,SO,2017-18,G,Grambling,SWAC,31,1089,149,373,.399,124,304,25,69,.362,194,241,.805,25,114,139,154,67,5,110,94,517
2522,Jonathan Tavernari,JR,2008-09,F,Brigham Young,MWC,33,1042,195,451,.432,110,228,85,223,.381,42,55,.764,34,205,239,58,49,11,44,77,517
2523,Darius Thompson,SR,2017-18,G,Western Kentucky,CUSA,38,1354,177,382,.463,123,230,54,152,.355,109,148,.736,23,136,159,181,58,18,66,69,517
2524,B.A. Walker,SR,2006-07,G,Virginia Commonwealth,CAA,35,1131,179,389,.460,87,167,92,222,.414,67,79,.848,32,69,101,66,35,7,43,66,517
2525,Rashad West,SR,2007-08,G,Hampton,MEAC,30,945,160,421,.380,98,227,62,194,.320,135,187,.722,20,73,93,86,39,0,102,49,517
2528,Isaiah Wilkerson,SR,2011-12,F,NJIT,GWC,32,994,179,412,.434,135,294,44,118,.373,115,141,.816,87,125,212,66,56,6,53,89,517
2529,Chris Wright,JR,2009-10,G,Georgetown,Big East,34,1194,183,389,.470,140,261,43,128,.336,108,139,.777,18,83,101,138,51,9,77,76,517
2530,Ron Baker,JR,2014-15,G,Wichita State,MVC,35,1145,171,395,.433,91,186,80,209,.383,94,124,.758,31,126,157,88,45,27,39,60,516
2531,Keith Benson,SO,2008-09,C,Oakland,Summit,36,999,191,307,.622,191,306,0,1,.000,134,201,.667,92,188,280,25,20,87,38,116,516
2532,Michael Buchanan,SR,2016-17,C,South Carolina Upstate,A-Sun,32,744,207,332,.623,207,332,0,0,,102,193,.528,117,187,304,37,17,20,71,86,516
2533,T.T. Carey,JR,2012-13,G,Longwood,Big South,33,1126,189,446,.424,108,224,81,222,.365,57,79,.722,30,138,168,58,73,19,62,76,516
2534,Kameron Chatman,JR,2017-18,G,Detroit Mercy,Horizon,29,945,183,388,.472,123,243,60,145,.414,90,106,.849,41,199,240,60,36,11,59,75,516
2535,Cameron Clark,SR,2013-14,G,Oklahoma,Big 12,33,915,190,411,.462,153,326,37,85,.435,99,124,.798,44,139,183,37,34,13,43,87,516
2536,Xavier Cooks,SR,2017-18,G,Winthrop,Big South,30,894,194,385,.504,173,319,21,66,.318,107,160,.669,64,199,263,108,30,64,98,72,516
2537,Keith Cothran,SR,2009-10,G,Rhode Island,A-10,36,1101,189,443,.427,145,304,44,139,.317,94,138,.681,45,79,124,75,61,17,53,59,516
2538,Allen Crabbe,SO,2011-12,G,University of California,Pac-12,34,1158,179,415,.431,96,207,83,208,.399,75,89,.843,32,162,194,71,18,20,53,48,516
2539,Noah Dahlman,SO,2008-09,F,Wofford,Southern,29,873,193,321,.601,193,317,0,4,.000,130,182,.714,99,86,185,14,21,10,37,53,516
2540,Aubrey Dawkins,JR,2018-19,G,Central Florida,AAC,33,1101,181,391,.463,108,210,73,181,.403,81,97,.835,33,133,166,46,34,10,54,73,516
2541,Nick Garth,SR,2018-19,G,Lamar,Southland,31,964,167,394,.424,85,174,82,220,.373,100,119,.840,11,63,74,73,38,3,47,71,516
2542,Kyle Gibson,JR,2008-09,G,Louisiana Tech,WAC,32,1144,154,343,.449,78,168,76,175,.434,132,180,.733,27,88,115,88,33,6,97,74,516
2543,Manny Harris,FR,2007-08,G,Michigan,Big Ten,32,1057,159,417,.381,117,285,42,132,.318,156,191,.817,34,101,135,86,45,7,115,65,516
2544,Stephen Holt ,SR,2013-14,G,Saint Mary's (CA),WCC,34,1275,148,328,.451,90,197,58,131,.443,162,195,.831,39,89,128,134,26,0,65,79,516
2545,Stefan Jankovic,JR,2015-16,F,Hawaii,Big West,33,817,172,317,.543,139,233,33,84,.393,139,180,.772,57,161,218,39,20,40,58,100,516
2546,Killian Larson,SR,2013-14,C,Grand Canyon,WAC,30,980,180,333,.541,179,330,1,3,.333,155,210,.738,115,233,348,24,14,6,76,96,516
2547,Maodo Lo,JR,2014-15,G,Columbia,Ivy,28,957,181,370,.489,97,175,84,195,.431,70,91,.769,13,109,122,65,43,16,69,62,516
2550,Tymell Murphy,SR,2013-14,F,Florida International,CUSA,31,1066,198,338,.586,185,292,13,46,.283,107,163,.656,67,163,230,70,60,47,91,90,516
2551,Ahmad Nivins,SO,2006-07,F,Saint Joseph's,A-10,31,1105,176,279,.631,176,278,0,1,.000,164,242,.678,105,130,235,11,32,32,77,89,516
2552,Elijah Pittman,JR,2012-13,F,Marshall,CUSA,32,1032,169,348,.486,104,173,65,175,.371,113,161,.702,50,85,135,50,24,24,77,70,516
2553,Justin Robinson,SR,2010-11,G,Rider,MAAC,34,1141,164,386,.425,76,180,88,206,.427,100,110,.909,13,84,97,130,35,4,89,69,516
2554,Nike Sibande,SO,2018-19,G,Miami (OH),MAC,32,960,165,419,.394,89,188,76,231,.329,110,158,.696,28,134,162,38,27,13,64,61,516
2555,Andrew Strait,SO,2005-06,F,Montana,Big Sky,31,1001,223,363,.614,221,360,2,3,.667,68,112,.607,68,129,197,47,19,27,45,54,516
2556,Demetrius Treadwell,SR,2013-14,F,Akron,MAC,34,1131,181,395,.458,180,385,1,10,.100,153,253,.605,113,180,293,63,33,29,85,60,516
2557,Valdas Vasylius,SR,2006-07,F,Old Dominion,CAA,33,885,158,325,.486,133,249,25,76,.329,175,231,.758,75,125,200,31,22,16,58,92,516
2558,Jamarco Warren,SO,2008-09,G,Charleston Southern,Big South,29,959,168,408,.412,69,159,99,249,.398,81,105,.771,10,70,80,82,27,2,68,63,516
2559,Chaz Williams,SR,2013-14,G,Massachusetts,A-10,33,1163,162,402,.403,108,253,54,149,.362,138,183,.754,27,65,92,229,52,7,113,97,516
2560,Curtis Withers,SR,2005-06,F,Charlotte,A-10,32,1088,181,403,.449,163,343,18,60,.300,136,234,.581,136,226,362,80,32,28,100,99,516
2561,Bryce Alford,JR,2015-16,G,UCLA,Pac-12,32,1159,157,408,.385,84,209,73,199,.367,128,154,.831,9,113,122,167,23,0,63,41,515
2562,Donte Clark,SO,2015-16,G,Massachusetts,A-10,32,995,157,383,.410,95,200,62,183,.339,139,185,.751,19,103,122,73,28,9,71,105,515
2563,Jordan Downing,SR,2014-15,G,Presbyterian,Big South,31,1007,184,445,.413,115,251,69,194,.356,78,102,.765,21,112,133,36,19,5,63,67,515
2564,Kris Dunn,SO,2014-15,G,Providence,Big East,33,1123,185,390,.474,158,313,27,77,.351,118,172,.686,28,152,180,247,90,10,138,101,515
2565,Bryant Dunston,SO,2005-06,F,Fordham,A-10,32,1003,174,325,.535,155,286,19,39,.487,148,220,.673,83,159,242,52,26,76,79,103,515
2566,Al Fisher,SR,2008-09,G,Kent State,MAC,34,1089,172,424,.406,127,285,45,139,.324,126,149,.846,17,98,115,120,56,4,112,77,515
2567,Martez Harrison,FR,2013-14,G,Kansas City,WAC,30,973,159,362,.439,126,270,33,92,.359,164,257,.638,22,78,100,114,50,0,92,89,515
2568,Frank Hassell,SR,2010-11,F,Old Dominion,CAA,34,997,196,350,.560,196,349,0,1,.000,123,167,.737,127,194,321,38,29,43,70,61,515
2569,Ian Hummer,JR,2011-12,F,Princeton,Ivy,32,1028,190,407,.467,171,347,19,60,.317,116,173,.671,69,166,235,101,46,39,89,70,515
2572,James Johnson,JR,2010-11,G,Quinnipiac,NEC,32,1086,176,442,.398,92,224,84,218,.385,79,97,.814,29,104,133,112,51,2,48,69,515
2573,Jason McLeish,SR,2005-06,G,Eastern Kentucky,OVC,29,920,168,338,.497,111,219,57,119,.479,122,151,.808,31,47,78,58,43,6,63,59,515
2574,Jonathon Modica,SR,2005-06,G,Arkansas,SEC,32,990,178,376,.473,123,219,55,157,.350,104,142,.732,58,70,128,53,36,1,66,50,515
2575,A.J. Price,SR,2008-09,G,Connecticut,Big East,35,1112,170,417,.408,88,213,82,204,.402,93,129,.721,20,102,122,164,24,0,94,44,515
2576,Malcolm Riley ,SR,2015-16,F,Texas Southern,SWAC,33,1051,173,383,.452,96,173,77,210,.367,92,117,.786,53,135,188,29,15,5,48,64,515
2577,Nike Sibande,FR,2017-18,G,Miami (OH),MAC,34,1117,171,413,.414,94,193,77,220,.350,96,131,.733,28,118,146,42,39,5,72,63,515
2578,Isaiah Sykes,SR,2013-14,G,Central Florida,AAC,30,958,198,417,.475,186,385,12,32,.375,107,198,.540,88,129,217,105,51,5,110,80,515
2579,Jaylin Walker,JR,2017-18,G,Kent State,MAC,31,1043,171,450,.380,87,194,84,256,.328,89,113,.788,38,82,120,62,32,4,80,49,515
2580,Wink Adams,SO,2006-07,G,Nevada-Las Vegas,MWC,37,1147,165,430,.384,98,243,67,187,.358,117,155,.755,37,105,142,85,55,5,71,74,514
2581,Seth Allen,JR,2015-16,G,Virginia Tech,ACC,35,985,150,381,.394,106,224,44,157,.280,170,219,.776,9,97,106,88,33,9,102,79,514
2582,Nick Barbour,JR,2010-11,G,High Point,Big South,29,865,160,395,.405,92,207,68,188,.362,126,160,.788,15,71,86,30,28,3,68,84,514
2583,Kyle Barone,SR,2012-13,C,Idaho,WAC,30,1021,178,299,.595,178,298,0,1,.000,158,202,.782,100,191,291,54,10,36,57,69,514
2584,Matt Bouldin,SR,2009-10,G,Gonzaga,WCC,33,1176,165,366,.451,108,210,57,156,.365,127,148,.858,15,139,154,132,46,6,75,70,514
2585,De'Mon Brooks,SR,2013-14,F,Davidson,Southern,27,724,173,295,.586,159,264,14,31,.452,154,207,.744,60,131,191,37,18,22,60,94,514
2586,Richard Carter,SR,2013-14,G,Drake,MVC,31,969,157,367,.428,115,237,42,130,.323,158,214,.738,16,82,98,117,55,0,76,75,514
2587,Nico Carvacho,JR,2018-19,C,Colorado State,MWC,32,1021,216,365,.592,216,363,0,2,.000,82,167,.491,125,287,412,67,19,21,68,88,514
2588,Will Clyburn,JR,2010-11,G,Utah,MWC,30,1040,163,362,.450,101,208,62,154,.403,126,166,.759,51,182,233,31,34,7,75,68,514
2589,Marvin Dominique,JR,2013-14,F,Saint Peter's,MAAC,31,1040,190,400,.475,156,301,34,99,.343,100,133,.752,92,183,275,20,29,27,72,81,514
2590,Corey Fisher,SR,2010-11,G,Villanova,Big East,33,1101,165,394,.419,113,235,52,159,.327,132,168,.786,19,72,91,159,49,2,75,78,514
2591,Jerome Frink,JR,2015-16,F,Long Island University,NEC,31,1006,197,392,.503,160,294,37,98,.378,83,124,.669,96,182,278,39,39,39,83,97,514
2592,C.J. Garner,SR,2012-13,G,Long Island University,NEC,32,1121,180,358,.503,153,297,27,61,.443,127,175,.726,43,89,132,80,51,11,68,52,514
2593,Isaac Haas,SR,2017-18,C,Purdue,Big Ten,35,818,185,300,.617,185,300,0,0,,144,190,.758,60,141,201,26,5,46,58,85,514
2594,Randal Holt,SR,2012-13,G,Kent State,MAC,35,1132,164,433,.379,75,202,89,231,.385,97,114,.851,21,90,111,84,44,3,77,53,514
2595,Peter Jok,JR,2015-16,G,Iowa,Big Ten,32,887,171,397,.431,91,198,80,199,.402,92,108,.852,28,84,112,46,40,1,46,76,514
2596,Tim Kempton,JR,2015-16,C,Lehigh,Patriot,29,864,182,328,.555,177,312,5,16,.313,145,192,.755,69,207,276,41,20,13,84,90,514
2597,Austin Kenon,SR,2010-11,G,Virginia Military Institute,Big South,28,841,151,345,.438,58,123,93,222,.419,119,141,.844,27,70,97,91,27,1,55,61,514
2598,Ross Mouton,SR,2006-07,G,Louisiana,Sun Belt,30,979,190,459,.414,122,271,68,188,.362,66,91,.725,41,94,135,45,17,7,67,63,514
2599,Matt Murrer,SR,2006-07,F,Virginia Military Institute,Big South,31,860,195,386,.505,132,184,63,202,.312,61,80,.763,61,118,179,30,28,58,41,105,514
2600,Jordan Parks,SR,2014-15,G,North Carolina Central,MEAC,33,1042,212,321,.660,206,305,6,16,.375,84,126,.667,87,186,273,22,35,31,61,98,514
2601,Rico Pickett,JR,2009-10,G,Manhattan,MAAC,29,912,201,457,.440,153,313,48,144,.333,64,90,.711,32,81,113,29,38,6,59,63,514
2602,Victor Rudd,SR,2013-14,F,South Florida,AAC,32,1085,180,431,.418,147,304,33,127,.260,121,164,.738,21,197,218,59,19,18,69,69,514
2603,Amu Saaka,SR,2010-11,F,Furman,Southern,33,1043,167,362,.461,117,223,50,139,.360,130,149,.872,68,145,213,35,24,10,58,84,514
2604,Josh Slater,JR,2009-10,G,Lipscomb,A-Sun,30,922,157,345,.455,114,229,43,116,.371,157,225,.698,54,109,163,155,58,11,87,65,514
2605,D.J. Thompson,SR,2006-07,G,Appalachian State,Southern,33,1075,153,390,.392,71,172,82,218,.376,126,161,.783,25,83,108,163,85,1,99,67,514
2606,Matt Tiby,SR,2015-16,F,Milwaukee,Horizon,33,993,155,340,.456,112,225,43,115,.374,161,195,.826,60,212,272,66,11,10,68,78,514
2607,Cameron Wells,SO,2008-09,G,The Citadel,Southern,33,1137,190,415,.458,165,336,25,79,.316,109,135,.807,26,135,161,100,44,14,88,75,514
2608,Derek Williams,SR,2009-10,G,Southern Methodist,CUSA,31,1129,168,384,.438,130,260,38,124,.306,140,185,.757,15,83,98,114,29,3,76,56,514
2609,Reggie Williams,SO,2005-06,F,Virginia Military Institute,Big South,27,893,172,372,.462,128,233,44,139,.317,126,168,.750,53,135,188,69,27,4,76,45,514
2610,Jeff Xavier,SO,2005-06,G,Manhattan,MAAC,31,1080,179,412,.434,102,192,77,220,.350,79,99,.798,49,133,182,60,70,7,78,82,514
2611,Anthony Adger,SR,2018-19,G,Florida Atlantic,CUSA,33,1068,154,423,.364,61,152,93,271,.343,112,136,.824,20,120,140,85,33,2,69,53,513
2614,Rion Brown,SR,2013-14,G,Miami (FL),ACC,33,1167,174,403,.432,111,204,63,199,.317,102,135,.756,47,146,193,76,27,4,51,62,513
2615,Dane Brumagin,JR,2007-08,F,Kansas City,Summit,30,889,168,364,.462,89,189,79,175,.451,98,113,.867,53,90,143,36,38,1,57,94,513
2616,Marqueze Coleman,SR,2015-16,G,Nevada,MWC,34,1003,151,369,.409,121,272,30,97,.309,181,243,.745,24,121,145,111,41,5,88,92,513
2617,Dave Dudzinski,SR,2013-14,F,Holy Cross,Patriot,34,1057,184,393,.468,158,319,26,74,.351,119,157,.758,87,164,251,21,24,26,65,82,513
2618,Scott Eatherton,SR,2014-15,F,Northeastern,CAA,35,1054,197,333,.592,189,302,8,31,.258,111,160,.694,63,161,224,53,19,43,71,92,513
2619,Osiris Eldridge,SR,2009-10,G,Illinois State,MVC,33,1102,173,432,.400,100,226,73,206,.354,94,118,.797,24,109,133,83,50,11,84,71,513
2620,Marcus Foster,FR,2013-14,G,Kansas State,Big 12,33,969,177,418,.423,98,218,79,200,.395,80,109,.734,26,80,106,84,19,7,73,79,513
2621,Tony Gallo,SR,2011-12,G,Coppin State,MEAC,30,1015,149,375,.397,69,149,80,226,.354,135,178,.758,9,72,81,112,40,2,66,64,513
2622,Kenny Hasbrouck,SO,2006-07,G,Siena,MAAC,32,979,182,383,.475,141,271,41,112,.366,108,137,.788,22,61,83,84,50,4,84,78,513
2623,Adnan Hodzic,SO,2008-09,C,Lipscomb,A-Sun,30,810,210,358,.587,210,358,0,0,,93,125,.744,69,143,212,20,10,8,87,70,513
2624,James Johnson,SR,2011-12,G,Quinnipiac,NEC,31,1119,173,454,.381,104,265,69,189,.365,98,133,.737,20,81,101,108,39,4,77,73,513
2625,DeAndre Kane,SO,2010-11,G,Marshall,CUSA,34,1076,170,397,.428,121,243,49,154,.318,124,196,.633,40,149,189,117,32,3,115,99,513
2626,Loudon Love,SO,2018-19,F,Wright State,Horizon,34,918,209,420,.498,209,420,0,0,,95,152,.625,120,160,280,33,20,32,81,93,513
2627,Bryant McAllister,SR,2005-06,G,Duquesne,A-10,26,874,160,378,.423,108,239,52,139,.374,141,174,.810,18,73,91,125,33,2,96,57,513
2628,Malcolm Miller,SO,2012-13,G,Southern,SWAC,33,863,184,364,.505,94,165,90,199,.452,55,77,.714,46,148,194,28,39,21,33,64,513
2629,Divine Myles,JR,2016-17,G,Stetson,A-Sun,31,1045,189,372,.508,159,294,30,78,.385,105,147,.714,26,120,146,122,29,3,65,63,513
2630,Damier Pitts,SR,2011-12,G,Marshall,CUSA,35,1191,180,433,.416,108,221,72,212,.340,81,114,.711,18,66,84,149,36,2,111,87,513
2631,Jordan Potts,JR,2015-16,G,Bethune-Cookman,MEAC,32,1207,156,448,.348,71,183,85,265,.321,116,149,.779,19,82,101,138,50,3,90,76,513
2632,Chris Quinn,SR,2005-06,G,Notre Dame,Big East,29,1160,174,387,.450,104,220,70,167,.419,95,109,.872,24,85,109,187,45,3,77,61,513
2633,Josh Richardson,SR,2014-15,G,Tennessee,SEC,32,1162,184,399,.461,138,271,46,128,.359,99,124,.798,28,115,143,115,67,16,85,79,513
2636,Jaelan Sanford,SR,2018-19,G,Toledo,MAC,33,1104,192,452,.425,138,285,54,167,.323,75,89,.843,31,108,139,106,12,5,61,55,513
2637,A.J. Slaughter,JR,2008-09,G,Western Kentucky,Sun Belt,32,1107,171,410,.417,99,212,72,198,.364,99,129,.767,21,78,99,114,43,1,68,57,513
2638,Jimmie Taylor,SR,2016-17,G,Rider,MAAC,33,1180,170,399,.426,103,214,67,185,.362,106,141,.752,46,115,161,61,37,9,48,86,513
2639,Colton Weisbrod,JR,2016-17,F,Lamar,Southland,34,1066,177,339,.522,176,333,1,6,.167,158,222,.712,89,186,275,31,19,7,87,75,513
2640,Delon Wright,JR,2013-14,G,Utah,Pac-12,33,1202,174,310,.561,162,256,12,54,.222,153,193,.793,42,182,224,174,82,43,84,61,513
2641,Peyton Aldridge,SO,2015-16,F,Davidson,A-10,33,1143,179,364,.492,130,231,49,133,.368,105,124,.847,68,147,215,74,19,33,47,86,512
2642,Trevon Bluiett,SO,2015-16,F,Xavier,Big East,34,1042,170,401,.424,92,205,78,196,.398,94,122,.770,49,160,209,74,31,11,56,79,512
2643,Roy Bright,JR,2006-07,F,Delaware State,MEAC,33,1170,187,425,.440,130,251,57,174,.328,81,102,.794,50,111,161,33,27,18,56,60,512
2644,Alec Burks,FR,2009-10,G,Colorado,Big 12,30,907,172,320,.538,153,266,19,54,.352,149,193,.772,58,92,150,53,35,12,58,74,512
2645,Glen Davis,JR,2006-07,F,Louisiana State,SEC,29,1016,178,368,.484,161,319,17,49,.347,139,195,.713,113,190,303,66,32,28,82,67,512
2646,Matthew Dellavedova,JR,2011-12,G,Saint Mary's (CA),WCC,33,1236,157,352,.446,97,183,60,169,.355,138,161,.857,19,90,109,212,28,2,96,57,512
2647,Mikey Dixon,FR,2016-17,G,Quinnipiac,MAAC,31,924,171,377,.454,111,215,60,162,.370,110,128,.859,35,81,116,72,23,2,68,59,512
2648,Jordan Dykstra,SR,2013-14,F,South Dakota State,Summit,32,1021,156,344,.453,105,217,51,127,.402,149,178,.837,56,186,242,60,20,6,55,82,512
2649,Zach Filzen,JR,2010-11,G,Buffalo,MAC,34,1150,178,426,.418,68,159,110,267,.412,46,54,.852,9,91,100,39,26,0,57,40,512
2650,Will Franklin,SR,2006-07,G,Bradley,MVC,35,1225,174,411,.423,86,208,88,203,.433,76,93,.817,26,76,102,140,48,0,69,48,512
2651,Kenny Hasbrouck,SR,2008-09,G,Siena,MAAC,35,1078,192,472,.407,135,308,57,164,.348,71,108,.657,25,96,121,99,69,6,80,68,512
2652,Cameron Healy,FR,2018-19,G,Albany (NY),AEC,32,1103,166,393,.422,62,142,104,251,.414,76,86,.884,11,110,121,78,22,3,70,54,512
2653,Peter Hooley,SO,2013-14,G,Albany (NY),AEC,33,1157,143,359,.398,72,176,71,183,.388,155,182,.852,10,79,89,87,27,0,67,51,512
2654,Xavier Johnson,FR,2018-19,G,Pittsburgh,ACC,33,1028,159,383,.415,122,278,37,105,.352,157,209,.751,38,90,128,149,43,4,132,89,512
2655,Andre Jones,SR,2011-12,G,Winthrop,Big South,32,1109,182,421,.432,129,265,53,156,.340,95,119,.798,21,81,102,54,37,9,77,66,512
2658,Kevin Jones,SO,2009-10,F,West Virginia,Big East,38,1254,199,382,.521,157,278,42,104,.404,72,109,.661,135,137,272,41,22,34,41,70,512
2659,Jamaal King,SR,2018-19,G,Saint Francis (PA),NEC,33,1058,176,403,.437,122,255,54,148,.365,106,141,.752,10,65,75,134,51,1,88,75,512
2660,Khris Lane,JR,2016-17,F,Longwood,Big South,30,1034,208,387,.537,176,292,32,95,.337,64,93,.688,49,169,218,37,24,34,69,83,512
2661,Cameron Long,SR,2010-11,G,George Mason,CAA,34,1121,181,378,.479,121,239,60,139,.432,90,120,.750,40,119,159,97,47,8,67,56,512
2662,Mark Lyons,JR,2011-12,G,Xavier,A-10,34,1086,176,414,.425,118,266,58,148,.392,102,134,.761,10,100,110,94,45,10,74,96,512
2663,E'Twaun Moore,SO,2008-09,G,Purdue,Big Ten,37,1222,188,445,.422,132,279,56,166,.337,80,105,.762,39,131,170,111,40,16,97,91,512
2664,Juwan Morgan,JR,2017-18,F,Indiana,Big Ten,31,912,195,337,.579,179,284,16,53,.302,106,168,.631,84,144,228,47,37,44,51,77,512
2665,Brian Parker,JR,2017-18,G,Marist,MAAC,30,972,165,350,.471,136,260,29,90,.322,153,216,.708,27,132,159,101,14,3,121,75,512
2666,Tajuan Porter,FR,2006-07,G,Oregon,Pac-10,35,1140,161,391,.412,51,139,110,252,.437,80,88,.909,14,54,68,71,29,0,88,54,512
2667,Nik Raivio,JR,2008-09,G,Portland,WCC,32,989,181,398,.455,132,262,49,136,.360,101,150,.673,44,165,209,76,40,6,71,66,512
2668,Chasson Randle,FR,2011-12,G,Stanford,Pac-12,37,1127,169,385,.439,84,191,85,194,.438,89,117,.761,21,98,119,76,42,2,83,111,512
2669,Alex Ruoff,JR,2007-08,G,West Virginia,Big East,37,1179,169,353,.479,71,114,98,239,.410,76,92,.826,32,96,128,103,57,12,62,77,512
2670,David Schneider,SR,2009-10,G,William & Mary,CAA,33,1099,148,425,.348,49,136,99,289,.343,117,146,.801,38,159,197,97,48,2,49,76,512
2671,Sean Singletary,SO,2005-06,G,Virginia,ACC,29,982,168,420,.400,117,273,51,147,.347,125,148,.845,34,94,128,121,54,3,104,65,512
2672,Anthony Smith,JR,2007-08,G,Liberty,Big South,32,1097,189,367,.515,105,162,84,205,.410,50,81,.617,37,124,161,36,32,6,49,70,512
2673,Tyler Stone,JR,2012-13,F,Southeast Missouri State,OVC,33,1063,205,417,.492,194,371,11,46,.239,91,115,.791,57,200,257,39,25,43,50,72,512
2674,Mike Trimboli,SR,2008-09,G,Vermont,AEC,32,1130,163,356,.458,114,221,49,135,.363,137,171,.801,33,82,115,153,63,2,87,77,512
2675,Joel Berry,SO,2015-16,G,North Carolina,ACC,40,1228,176,396,.444,108,218,68,178,.382,91,105,.867,25,108,133,151,58,9,62,89,511
2676,James Blackmon,JR,2016-17,G,Indiana,Big Ten,30,915,174,365,.477,83,150,91,215,.423,72,86,.837,29,115,144,56,21,1,58,54,511
2677,Jahsha Bluntt,JR,2005-06,G,Delaware State,MEAC,35,1245,165,400,.413,74,167,91,233,.391,90,119,.756,50,117,167,41,39,12,62,73,511
2680,Jordan Clarkson,SO,2011-12,G,Tulsa,CUSA,31,1052,167,384,.435,124,269,43,115,.374,134,171,.784,35,85,120,79,29,17,83,73,511
2681,Ryan Daly,FR,2016-17,G,Delaware,CAA,32,1072,189,445,.425,127,262,62,183,.339,71,104,.683,67,171,238,66,27,8,39,66,511
2682,Johnny Dee,SO,2012-13,G,San Diego,WCC,34,1062,172,396,.434,92,184,80,212,.377,87,98,.888,18,88,106,32,26,1,45,49,511
2683,Rob Edwards,SO,2016-17,G,Cleveland State,Horizon,31,964,167,404,.413,104,226,63,178,.354,114,149,.765,29,110,139,53,41,5,95,68,511
2684,Vince Edwards,SR,2017-18,F,Purdue,Big Ten,35,1106,180,378,.476,129,250,51,128,.398,100,120,.833,71,188,259,101,18,21,71,62,511
2685,Carrick Felix,SR,2012-13,G,Arizona State,Pac-12,35,1235,189,378,.500,137,239,52,139,.374,81,122,.664,73,212,285,57,50,39,70,105,511
2686,Brian Fisk,JR,2005-06,G,Lipscomb,A-Sun,32,1011,182,425,.428,133,293,49,132,.371,98,126,.778,28,97,125,98,59,9,93,69,511
2687,Nana Foulland,JR,2016-17,C,Bucknell,Patriot,34,938,203,322,.630,203,322,0,0,,105,187,.561,77,187,264,41,26,72,71,95,511
2688,Troy Gillenwater,JR,2010-11,F,New Mexico State,WAC,27,818,173,377,.459,136,275,37,102,.363,128,171,.749,40,130,170,16,11,26,61,60,511
2689,David Gonzalvez,SR,2009-10,G,Richmond,A-10,35,1208,171,379,.451,95,171,76,208,.365,93,132,.705,27,121,148,82,65,8,57,74,511
2690,Javontae Hawkins,JR,2015-16,G,Eastern Kentucky,OVC,30,866,182,363,.501,149,264,33,99,.333,114,149,.765,40,103,143,63,29,13,82,95,511
2691,Eric Hicks,SR,2005-06,F,Cincinnati,Big East,34,1169,192,401,.479,179,374,13,27,.481,114,173,.659,148,181,329,29,19,113,53,78,511
2692,Stephan Hicks,SR,2014-15,G,Cal State Northridge,Big West,32,1072,167,333,.502,151,293,16,40,.400,161,198,.813,61,112,173,46,30,15,60,75,511
2693,Matt Lander,SR,2010-11,G,Western Illinois,Summit,30,1085,153,373,.410,112,250,41,123,.333,164,215,.763,8,62,70,80,28,7,93,65,511
2694,Shawn Long,FR,2012-13,F,Louisiana,Sun Belt,33,1025,195,453,.430,162,347,33,106,.311,88,127,.693,102,235,337,32,27,65,86,95,511
2695,Josh Mayo,SR,2008-09,G,Illinois-Chicago,Horizon,30,1063,160,407,.393,88,221,72,186,.387,119,138,.862,19,62,81,102,34,1,73,55,511
2696,John Murry,SR,2016-17,G,Austin Peay,OVC,30,908,165,346,.477,124,227,41,119,.345,140,173,.809,15,66,81,46,22,3,73,49,511
2697,Derek Needham,SR,2012-13,G,Fairfield,MAAC,35,1157,175,440,.398,97,201,78,239,.326,83,108,.769,20,99,119,110,48,2,94,97,511
2698,Cameron Oliver,FR,2015-16,F,Nevada,MWC,38,1118,201,396,.508,181,335,20,61,.328,89,134,.664,103,242,345,30,23,99,79,116,511
2699,Romero Osby,SR,2012-13,F,Oklahoma,Big 12,32,912,174,331,.526,165,314,9,17,.529,154,194,.794,66,159,225,40,20,27,42,78,511
2700,Gary Payton,SR,2015-16,G,Oregon State,Pac-12,32,1096,205,422,.486,183,352,22,70,.314,79,123,.642,77,174,251,161,80,16,74,85,511
2701,Casey Prather,SR,2013-14,F,Florida,SEC,37,1034,190,315,.603,188,310,2,5,.400,129,190,.679,72,112,184,60,37,20,80,78,511
2702,Keith Rendleman,SR,2012-13,F,North Carolina-Wilmington,CAA,30,1017,187,347,.539,179,326,8,21,.381,129,218,.592,126,188,314,22,53,47,62,99,511
2703,Wes Washpun,SR,2015-16,G,Northern Iowa,MVC,36,1241,177,379,.467,151,290,26,89,.292,131,182,.720,9,138,147,190,42,25,93,94,511
2704,Jaytornah Wisseh,SR,2009-10,G,Long Island University,NEC,29,1045,159,402,.396,129,299,30,103,.291,163,196,.832,21,100,121,164,45,1,122,55,511
2705,Desmond Yates,SO,2007-08,F,Middle Tennessee,Sun Belt,32,1022,200,348,.575,180,309,20,39,.513,91,113,.805,53,88,141,30,20,18,50,110,511
2706,Gabe York,SR,2015-16,G,Arizona,Pac-12,34,1133,177,419,.422,79,186,98,233,.421,59,78,.756,19,90,109,76,30,9,71,70,511
2707,Antoine Young,JR,2010-11,G,Creighton,MVC,39,1393,172,434,.396,133,311,39,123,.317,128,171,.749,16,85,101,195,37,2,82,51,511
2708,Darrell Arthur,SO,2007-08,F,Kansas,Big 12,40,989,214,394,.543,212,382,2,12,.167,80,114,.702,92,158,250,33,20,53,75,118,510
2709,Kyle Austin,JR,2009-10,F,UC-Riverside,Big West,29,996,180,401,.449,155,331,25,70,.357,125,200,.625,96,118,214,49,19,9,65,62,510
2710,Courtney Bradley,SR,2006-07,F,Jacksonville State,OVC,30,982,187,405,.462,155,313,32,92,.348,104,134,.776,76,134,210,35,43,7,87,94,510
2711,Jason Carter,SO,2018-19,F,Ohio,MAC,31,962,180,374,.481,157,307,23,67,.343,127,177,.718,65,143,208,61,20,21,55,77,510
2712,Karl Cochran,SR,2014-15,G,Wofford,Southern,35,1091,182,468,.389,84,200,98,268,.366,48,74,.649,29,176,205,94,63,36,57,67,510
2713,Jay Couisnard,SR,2010-11,F,Kansas City,Summit,29,971,171,350,.489,126,227,45,123,.366,123,193,.637,53,108,161,47,37,18,92,90,510
2714,A.J. Davis,JR,2011-12,G,James Madison,CAA,32,1038,169,387,.437,116,227,53,160,.331,119,162,.735,38,112,150,61,55,9,85,62,510
2715,Anthony Drmic,JR,2013-14,G,Boise State,MWC,32,1048,171,388,.441,110,209,61,179,.341,107,137,.781,32,112,144,55,36,3,60,87,510
2716,Ian Dubose,SO,2018-19,G,Houston Baptist,Southland,30,911,173,356,.486,120,235,53,121,.438,111,157,.707,45,133,178,103,47,8,80,78,510
2717,Kahlil Dukes,JR,2016-17,G,Niagara,MAAC,33,1113,170,413,.412,105,256,65,157,.414,105,114,.921,8,89,97,136,32,1,82,55,510
2718,Skyler Flatten,SR,2018-19,G,South Dakota State,Summit,33,1205,185,358,.517,101,167,84,191,.440,56,82,.683,9,116,125,73,41,13,44,53,510
2719,Olivier Hanlan,FR,2012-13,G,Boston College,ACC,33,1129,167,364,.459,117,237,50,127,.394,126,168,.750,26,111,137,75,38,2,73,66,510
2722,Robert Hines,JR,2006-07,F,St. Francis (NY),NEC,31,1090,175,458,.382,147,352,28,106,.264,132,173,.763,72,111,183,75,30,19,119,82,510
2723,Denzel Ingram,SR,2016-17,G,North Carolina-Wilmington,CAA,35,1171,173,435,.398,64,139,109,296,.368,55,78,.705,19,57,76,189,47,3,60,66,510
2724,Matt Klinewski,SR,2017-18,F,Lafayette,Patriot,31,831,177,351,.504,126,232,51,119,.429,105,129,.814,35,144,179,46,14,22,61,74,510
2725,Jeremiah Martin,JR,2017-18,G,Memphis,AAC,27,936,157,354,.444,106,198,51,156,.327,145,185,.784,20,95,115,103,61,17,73,52,510
2726,Matt Morgan,FR,2015-16,G,Cornell,Ivy,27,829,159,384,.414,89,170,70,214,.327,122,151,.808,11,74,85,53,38,10,52,46,510
2727,Travis Munnings,JR,2017-18,F,Louisiana-Monroe,Sun Belt,32,1106,185,394,.470,115,213,70,181,.387,70,97,.722,53,180,233,76,40,6,53,80,510
2728,Eli Pemberton,JR,2018-19,G,Hofstra,CAA,34,1203,153,341,.449,110,218,43,123,.350,161,210,.767,45,119,164,78,29,3,59,77,510
2729,Tim Pollitz,SR,2007-08,F,Miami (OH),MAC,33,1171,215,402,.535,209,384,6,18,.333,74,111,.667,78,156,234,101,39,18,91,84,510
2730,Javon Randolph,JR,2005-06,G,Savannah State,Ind,30,994,170,397,.428,112,244,58,153,.379,112,142,.789,36,68,104,41,36,6,85,61,510
2731,J.R. Reynolds,JR,2005-06,G,Virginia,ACC,30,997,161,396,.407,101,226,60,170,.353,128,165,.776,19,75,94,92,24,3,84,72,510
2732,John Roberson,JR,2009-10,G,Texas Tech,Big 12,35,1258,148,348,.425,77,176,71,172,.413,143,179,.799,16,63,79,190,40,1,100,92,510
2733,Richard Roby,SO,2005-06,G,Colorado,Big 12,30,905,172,408,.422,109,231,63,177,.356,103,140,.736,46,118,164,74,62,27,64,52,510
2734,Lodrick Stewart,SR,2006-07,G,Southern California,Pac-10,37,1152,186,406,.458,109,231,77,175,.440,61,84,.726,15,114,129,45,39,14,61,70,510
2735,Joah Tucker,SR,2005-06,F,Milwaukee,Horizon,31,948,179,389,.460,145,272,34,117,.291,118,181,.652,64,120,184,53,19,8,93,85,510
2736,Maalik Wayns,JR,2011-12,G,Villanova,Big East,29,975,162,391,.414,117,240,45,151,.298,141,158,.892,15,95,110,133,28,1,87,78,510
2737,Chaz Williams,JR,2012-13,G,Massachusetts,A-10,33,1165,166,383,.433,123,254,43,129,.333,135,172,.785,25,112,137,242,66,5,114,96,510
2738,Elijah Wilson,SR,2016-17,G,Coastal Carolina,Sun Belt,39,1182,174,493,.353,74,188,100,305,.328,62,83,.747,36,89,125,49,38,2,71,75,510
2739,Kris Yanku,SO,2014-15,G,Northern Arizona,Big Sky,37,1111,130,393,.331,110,325,20,68,.294,230,289,.796,22,143,165,189,43,1,115,94,510
2740,Deng Adel,JR,2017-18,F,Louisville,ACC,34,1126,178,397,.448,128,254,50,143,.350,103,131,.786,22,154,176,94,21,11,77,49,509
2741,Blake Ahearn,SR,2006-07,G,Missouri State,MVC,33,1023,152,326,.466,58,124,94,202,.465,111,120,.925,7,66,73,70,21,1,65,48,509
2744,Jeff Ayres,SR,2008-09,F,Arizona State,Pac-10,35,1139,198,300,.660,198,299,0,1,.000,113,145,.779,87,200,287,31,17,30,43,94,509
2745,Jared Brownridge,SO,2014-15,G,Santa Clara,WCC,32,1079,161,365,.441,68,150,93,215,.433,94,109,.862,12,80,92,81,34,4,47,58,509
2746,Jon Davis,JR,2017-18,G,Charlotte,CUSA,29,1051,159,406,.392,111,260,48,146,.329,143,181,.790,25,85,110,160,27,9,114,44,509
2747,Eric Eaves,SR,2016-17,G,South Carolina State,MEAC,31,921,175,377,.464,140,268,35,109,.321,124,180,.689,40,84,124,78,20,11,60,51,509
2748,Alex Francis,SO,2011-12,F,Bryant,NEC,30,979,185,361,.512,172,323,13,38,.342,126,189,.667,63,159,222,46,22,5,143,65,509
2749,Anthony Gill,SR,2015-16,F,Virginia,ACC,37,1037,189,326,.580,187,324,2,2,1.000,129,173,.746,80,147,227,28,24,21,42,85,509
2750,AJ Green,FR,2018-19,G,Northern Iowa,MVC,34,1017,184,449,.410,113,245,71,204,.348,70,81,.864,13,90,103,77,21,2,94,69,509
2751,Tyree Griffin,JR,2017-18,G,Southern Mississippi,CUSA,34,1207,181,420,.431,126,266,55,154,.357,92,132,.697,25,113,138,201,59,3,89,58,509
2752,Cezar Guerrero,SO,2013-14,G,Fresno State,MWC,39,1140,163,396,.412,92,190,71,206,.345,112,128,.875,16,113,129,137,52,3,82,95,509
2753,Maurice Hampton,SR,2005-06,G,Austin Peay,OVC,31,1025,153,370,.414,96,195,57,175,.326,146,170,.859,13,74,87,84,55,4,58,72,509
2754,Tucker Haymond,JR,2015-16,G,Western Michigan,MAC,32,1019,169,398,.425,137,275,32,123,.260,139,196,.709,61,125,186,73,21,1,74,70,509
2755,Anthony Johnson,JR,2008-09,G,Montana,Big Sky,29,907,164,326,.503,145,271,19,55,.345,162,186,.871,14,66,80,90,20,5,85,54,509
2756,B.J. Johnson,JR,2016-17,F,La Salle,A-10,29,945,168,374,.449,104,197,64,177,.362,109,130,.838,39,144,183,28,33,14,68,71,509
2757,Adreian Payne,SR,2013-14,C,Michigan State,Big Ten,31,870,178,354,.503,134,250,44,104,.423,109,138,.790,48,177,225,41,15,28,63,80,509
2758,MaCio Teague,FR,2016-17,G,North Carolina-Asheville,Big South,33,1124,169,361,.468,99,207,70,154,.455,101,114,.886,18,133,151,90,36,7,31,46,509
2759,Kendall Timmons,SO,2010-11,G,Tulane,CUSA,30,1082,176,396,.444,154,340,22,56,.393,135,210,.643,62,187,249,98,58,17,87,80,509
2760,Ed Tyson,SO,2006-07,G,Maryland-Eastern Shore,MEAC,31,1119,172,460,.374,115,280,57,180,.317,108,154,.701,48,84,132,52,32,1,86,76,509
2761,Harold Washington,JR,2011-12,G,Canisius,MAAC,30,1049,182,411,.443,155,336,27,75,.360,118,152,.776,39,89,128,83,31,1,94,50,509
2762,Sonny Weems,SR,2007-08,F,Arkansas,SEC,34,1067,197,425,.464,143,279,54,146,.370,61,76,.803,56,96,152,89,45,8,96,74,509
2763,Delon Wright,SR,2014-15,G,Utah,Pac-12,35,1165,165,324,.509,139,251,26,73,.356,153,183,.836,34,139,173,178,73,34,68,49,509
2766,Josh Young,JR,2008-09,G,Drake,MVC,33,1105,141,370,.381,82,186,59,184,.321,168,198,.848,37,88,125,45,34,1,69,51,509
2767,Brian Beard,JR,2017-18,G,Florida International,CUSA,31,1114,167,411,.406,131,265,36,146,.247,138,213,.648,6,114,120,178,90,0,100,77,508
2768,Ryan Broekhoff,JR,2011-12,G,Valparaiso,Horizon,34,1107,161,328,.491,95,159,66,169,.391,120,151,.795,62,228,290,79,45,21,57,67,508
2769,Bobby Brown,JR,2005-06,G,Cal State Fullerton,Big West,29,1013,182,427,.426,110,236,72,191,.377,72,99,.727,13,63,76,132,45,6,96,60,508
2770,Earl Brown,SR,2014-15,F,Saint Francis (PA),NEC,32,1133,188,349,.539,171,297,17,52,.327,115,169,.680,74,181,255,61,34,31,106,59,508
2771,Marcus Burton,SR,2014-15,G,Wagner,NEC,29,979,174,434,.401,113,244,61,190,.321,99,122,.811,15,62,77,46,33,0,66,57,508
2772,Schadrac Casimir,FR,2014-15,G,Iona,MAAC,35,1201,156,365,.427,62,143,94,222,.423,102,114,.895,19,79,98,69,39,2,41,77,508
2773,Jake Cohen,SR,2012-13,F,Davidson,Southern,34,871,171,344,.497,133,246,38,98,.388,128,154,.831,48,133,181,51,23,56,59,111,508
2774,Brandon Cotton,JR,2005-06,G,Detroit Mercy,Horizon,29,1025,183,440,.416,138,320,45,120,.375,97,127,.764,10,47,57,72,21,3,61,40,508
2775,Tony Danridge,SR,2008-09,G,New Mexico,MWC,34,1091,176,364,.484,170,336,6,28,.214,150,201,.746,36,103,139,91,41,4,73,75,508
2776,Kellen Dunham,SO,2013-14,G,Butler,Big East,31,1119,164,420,.390,86,200,78,220,.355,102,127,.803,13,110,123,52,21,8,66,46,508
2777,Scott Eatherton,JR,2013-14,F,Northeastern,CAA,32,994,180,333,.541,165,299,15,34,.441,133,200,.665,103,224,327,37,17,57,86,97,508
2778,Tim Frazier,SR,2013-14,G,Penn State,Big Ten,34,1196,163,379,.430,138,293,25,86,.291,157,200,.785,31,120,151,182,53,6,92,87,508
2779,Elias Harris,FR,2009-10,F,Gonzaga,WCC,34,998,180,329,.547,157,278,23,51,.451,125,185,.676,70,171,241,38,32,16,64,88,508
2780,LaVone Holland,JR,2016-17,G,Northern Kentucky,Horizon,35,1081,172,390,.441,116,237,56,153,.366,108,164,.659,18,80,98,143,45,9,106,65,508
2781,David Hoskins,JR,2006-07,G,Kansas State,Big 12,35,967,162,359,.451,149,296,13,63,.206,171,231,.740,86,120,206,88,35,9,90,84,508
2782,Matt Janning,SR,2009-10,G,Northeastern,CAA,33,1190,175,425,.412,123,267,52,158,.329,106,141,.752,17,113,130,102,51,6,70,55,508
2783,Moses Kingsley,SO,2015-16,C,Arkansas,SEC,32,945,183,334,.548,183,334,0,0,,142,223,.637,103,196,299,39,36,76,65,94,508
2784,Jaron Martin,SR,2016-17,G,UC-Irvine,Big West,36,1082,185,422,.438,105,227,80,195,.410,58,69,.841,14,89,103,113,29,1,62,49,508
2785,Anthony Miles,SR,2011-12,G,Lamar,Southland,35,1118,149,342,.436,120,263,29,79,.367,181,222,.815,34,128,162,142,58,1,81,74,508
2788,Carlos Monroe,JR,2007-08,F,Florida Atlantic,Sun Belt,33,926,188,362,.519,184,354,4,8,.500,128,233,.549,58,254,312,33,37,8,76,90,508
2789,Lee Moore,JR,2015-16,G,Texas-El Paso,CUSA,33,1053,156,345,.452,107,212,49,133,.368,147,198,.742,50,128,178,116,46,10,70,70,508
2790,Tyler Murray,JR,2010-11,G,Wagner,NEC,30,1113,157,358,.439,98,216,59,142,.415,135,163,.828,25,113,138,107,38,8,96,51,508
2791,Jose Olivero,SR,2006-07,G,Lehigh,Patriot,31,1009,154,400,.385,108,240,46,160,.288,154,204,.755,25,80,105,71,37,0,90,89,508
2792,Gyno Pomare,JR,2007-08,C,San Diego,WCC,36,1033,188,338,.556,188,337,0,1,.000,132,184,.717,102,163,265,27,29,48,52,88,508
2793,Trevor Releford,JR,2012-13,G,Alabama,SEC,34,1130,167,351,.476,119,233,48,118,.407,126,153,.824,21,71,92,85,70,2,62,69,508
2794,Junior Robinson,JR,2016-17,G,Mount St. Mary's,NEC,36,1201,160,378,.423,90,202,70,176,.398,118,136,.868,8,50,58,103,32,4,93,75,508
2795,T.J. Robinson,SO,2009-10,F,Cal State Long Beach,Big West,33,1054,193,371,.520,193,371,0,0,,122,216,.565,117,215,332,27,19,4,79,67,508
2796,Montrael Scott,JR,2013-14,G,Prairie View,SWAC,34,1060,174,389,.447,100,212,74,177,.418,86,114,.754,49,105,154,65,45,1,77,72,508
2797,Jeff Short,SR,2015-16,G,Norfolk State,MEAC,33,955,154,375,.411,87,189,67,186,.360,133,162,.821,14,105,119,86,28,4,74,87,508
2798,TaShawn Thomas,JR,2013-14,F,Houston,AAC,33,1044,205,347,.591,204,341,1,6,.167,97,163,.595,93,173,266,63,41,90,74,66,508
2799,Giordan Watson,SR,2007-08,G,Central Michigan,MAC,31,1028,168,403,.417,104,237,64,166,.386,108,144,.750,17,57,74,138,58,7,84,74,508
2800,Mike Williams,SR,2010-11,G,Western Carolina,Southern,33,1041,190,480,.396,135,319,55,161,.342,73,92,.793,32,83,115,127,67,6,93,103,508
2801,Kyle Wilson,JR,2014-15,G,Army,Patriot,29,939,171,445,.384,97,226,74,219,.338,92,117,.786,14,69,83,54,23,3,77,51,508
2802,Jeff Withey,SR,2012-13,C,Kansas,Big 12,37,1144,185,318,.582,184,317,1,1,1.000,137,192,.714,79,236,315,35,28,146,73,77,508
2803,Emile Blackman,JR,2015-16,G,Niagara,MAAC,32,1067,185,426,.434,143,282,42,144,.292,95,118,.805,38,74,112,44,29,6,84,88,507
2804,Desonta Bradford,SR,2017-18,G,East Tennessee State,Southern,33,1075,180,380,.474,138,245,42,135,.311,105,142,.739,26,165,191,116,62,15,72,64,507
2805,Jeffrey Carroll,SR,2017-18,G,Oklahoma State,Big 12,33,1012,167,411,.406,100,209,67,202,.332,106,137,.774,52,152,204,59,27,9,64,56,507
2806,Brandon Clark,SR,2014-15,G,Santa Clara,WCC,32,1045,163,434,.376,113,257,50,177,.282,131,153,.856,12,106,118,124,28,0,68,84,507
2807,Caleb Daniels,SO,2018-19,G,Tulane,AAC,30,1018,174,391,.445,127,255,47,136,.346,112,163,.687,42,118,160,99,23,9,86,86,507
2808,James Demery,SR,2017-18,F,Saint Joseph's,A-10,30,1024,195,409,.477,173,330,22,79,.278,95,149,.638,49,116,165,33,35,9,45,48,507
2809,Tim Derksen,SR,2015-16,G,San Francisco,WCC,30,978,177,358,.494,127,245,50,113,.442,103,141,.730,74,134,208,60,21,9,47,79,507
2810,Bam Doyne,SR,2006-07,G,Mississippi,SEC,34,1043,166,408,.407,124,279,42,129,.326,133,173,.769,32,115,147,65,37,9,78,88,507
2811,Kim English,SR,2011-12,G,Missouri,Big 12,35,1175,171,328,.521,93,158,78,170,.459,87,120,.725,30,118,148,56,45,10,59,83,507
2812,Shannon Evans,SO,2014-15,G,Buffalo,MAC,33,1139,163,395,.413,97,222,66,173,.382,115,144,.799,15,89,104,153,56,10,84,69,507
2813,Marcus Gilbert,JR,2014-15,F,Fairfield,MAAC,31,1075,154,348,.443,98,177,56,171,.327,143,184,.777,49,124,173,38,25,19,67,70,507
2814,Isaac Hamilton,SR,2016-17,G,UCLA,Pac-12,36,1080,193,426,.453,119,224,74,202,.366,47,57,.825,30,98,128,99,25,6,71,63,507
2815,Sam Hauser,JR,2018-19,F,Marquette,Big East,34,1134,173,377,.459,85,158,88,219,.402,73,79,.924,35,209,244,82,22,18,46,70,507
2816,Desmond Haymon,SR,2013-14,G,Stephen F. Austin,Southland,35,1060,155,369,.420,94,202,61,167,.365,136,204,.667,42,90,132,100,29,2,58,70,507
2817,Josh Heytvelt,SR,2008-09,F,Gonzaga,WCC,34,993,186,342,.544,163,285,23,57,.404,112,156,.718,63,159,222,22,20,30,43,85,507
2818,Cameron Jackson,SR,2018-19,F,Wofford,Southern,35,815,199,347,.573,191,327,8,20,.400,101,164,.616,92,174,266,97,52,35,74,99,507
2819,Justin Johnson,SO,2015-16,F,Western Kentucky,CUSA,34,984,197,327,.602,196,318,1,9,.111,112,166,.675,102,168,270,48,16,19,58,73,507
2820,Melvin Johnson,SO,2010-11,G,Texas-San Antonio,Southland,34,914,171,410,.417,91,194,80,216,.370,85,99,.859,17,101,118,21,30,5,57,59,507
2821,Tommie Liddell,SO,2006-07,G,Saint Louis,A-10,33,1182,183,386,.474,134,278,49,108,.454,92,120,.767,52,173,225,87,27,19,99,63,507
2822,Ervin Mitchell,SR,2016-17,G,Grambling,SWAC,30,963,166,352,.472,124,246,42,106,.396,133,190,.700,26,83,109,30,39,12,66,85,507
2823,Mike Muscala,SO,2010-11,F,Bucknell,Patriot,34,944,187,362,.517,183,351,4,11,.364,129,158,.816,57,191,248,47,14,67,58,90,507
2824,Javion Ogunyemi,JR,2015-16,F,Siena,MAAC,34,1065,182,335,.543,175,312,7,23,.304,136,201,.677,113,95,208,33,14,71,66,105,507
2825,Pookie Powell,JR,2017-18,G,La Salle,A-10,30,1105,178,442,.403,122,265,56,177,.316,95,118,.805,11,114,125,130,25,4,79,55,507
2826,Frank Robinson,SR,2007-08,G,Cal State Fullerton,Big West,32,983,175,388,.451,122,233,53,155,.342,104,141,.738,68,152,220,80,39,16,74,87,507
2827,Brandon Rush,JR,2007-08,G,Kansas,Big 12,38,1127,180,414,.435,100,223,80,191,.419,67,86,.779,57,138,195,81,32,32,69,60,507
2830,Marcus Smart,FR,2012-13,G,Oklahoma State,Big 12,33,1106,151,374,.404,113,243,38,131,.290,167,215,.777,50,142,192,139,99,22,111,92,507
2831,Greg Sprink,JR,2006-07,G,Navy,Patriot,30,1026,157,346,.454,91,172,66,174,.379,127,147,.864,31,112,143,73,27,0,74,88,507
2832,James Thompson IV,JR,2017-18,,Eastern Michigan,MAC,35,1195,201,299,.672,201,299,0,0,,105,173,.607,144,249,393,11,27,67,66,115,507
2833,Deon Thompson,SR,2009-10,F,North Carolina,ACC,37,994,196,405,.484,196,403,0,2,.000,115,166,.693,106,141,247,31,40,36,65,80,507
2834,Brian Warren,JR,2018-19,G,Texas-Arlington,Sun Belt,33,986,176,443,.397,124,272,52,171,.304,103,128,.805,15,71,86,119,39,3,71,98,507
2835,Isaac Wells,SR,2006-07,F,Arkansas State,Sun Belt,32,1076,190,435,.437,157,333,33,102,.324,94,134,.701,56,208,264,74,31,33,110,71,507
2836,Brendan Winters,SR,2005-06,G,Davidson,Southern,30,957,175,408,.429,118,240,57,168,.339,100,119,.840,45,98,143,53,20,7,53,66,507
2837,Chris Wright,JR,2009-10,F,Dayton,A-10,37,1058,187,373,.501,179,335,8,38,.211,125,185,.676,92,177,269,44,37,53,87,84,507
2838,Raheem Appleby,SO,2012-13,G,Louisiana Tech,WAC,34,895,196,484,.405,144,311,52,173,.301,62,87,.713,27,64,91,42,37,7,59,32,506
2839,Ike Azotam,SO,2011-12,F,Quinnipiac,NEC,32,982,202,363,.556,202,363,0,0,,102,167,.611,116,188,304,26,26,32,51,101,506
2840,Jon Brockman,SR,2008-09,F,Washington,Pac-10,34,1036,190,361,.526,190,360,0,1,.000,126,197,.640,144,247,391,39,31,3,65,102,506
2841,Julius Brown,JR,2013-14,G,Toledo,MAC,34,1145,163,390,.418,104,224,59,166,.355,121,139,.871,10,64,74,205,39,4,94,46,506
2842,Eric Carter,SR,2018-19,F,Delaware,CAA,32,1025,190,328,.579,188,323,2,5,.400,124,168,.738,72,239,311,75,21,20,73,90,506
2843,Tyler Cook,SO,2017-18,F,Iowa,Big Ten,33,923,192,339,.566,191,332,1,7,.143,121,183,.661,72,152,224,58,21,20,82,87,506
2844,Tyron Criswell,SR,2015-16,G,Nevada,MWC,38,1150,173,340,.509,160,294,13,46,.283,147,205,.717,93,142,235,79,39,23,79,110,506
2845,Matt Farrell,JR,2016-17,G,Notre Dame,ACC,36,1238,172,384,.448,91,191,81,193,.420,81,102,.794,9,63,72,196,51,5,91,71,506
2846,Paul Harris,SO,2007-08,F,Syracuse,Big East,35,1264,161,343,.469,150,309,11,34,.324,173,237,.730,99,187,286,117,59,28,117,90,506
2847,Taveion Hollingsworth,FR,2017-18,G,Western Kentucky,CUSA,38,1312,170,354,.480,125,235,45,119,.378,121,153,.791,31,98,129,71,39,5,67,75,506
2848,Justin Hurtt,JR,2009-10,G,Tulsa,CUSA,35,1175,169,403,.419,91,203,78,200,.390,90,111,.811,20,99,119,58,22,8,66,60,506
2849,Dominic James,SO,2006-07,G,Marquette,Big East,34,1130,171,445,.384,121,261,50,184,.272,114,175,.651,20,84,104,167,64,5,89,72,506
2852,Damian Jones,SO,2014-15,C,Vanderbilt,SEC,35,1020,186,331,.562,185,326,1,5,.200,133,222,.599,76,151,227,26,20,70,76,89,506
2853,Tyrone Kent,JR,2007-08,G,Toledo,MAC,30,1064,158,435,.363,92,223,66,212,.311,124,160,.775,30,85,115,91,53,16,140,75,506
2854,Alex McLean,SR,2007-08,F,Liberty,Big South,32,1047,197,352,.560,195,342,2,10,.200,110,156,.705,90,192,282,31,13,14,62,75,506
2855,Jared Mintz,SR,2010-11,F,Lafayette,Patriot,32,971,168,331,.508,165,318,3,13,.231,167,205,.815,67,119,186,69,20,7,62,83,506
2856,Matt Morgan,SO,2016-17,G,Cornell,Ivy,28,906,165,362,.456,79,133,86,229,.376,90,105,.857,13,116,129,60,22,6,71,60,506
2857,Dominique Morrison,SO,2009-10,F,Oral Roberts,Summit,33,1161,164,395,.415,121,275,43,120,.358,135,162,.833,35,133,168,85,29,13,60,88,506
2858,Steffphon Pettigrew,JR,2009-10,F,Western Kentucky,Sun Belt,34,1119,196,400,.490,159,287,37,113,.327,77,125,.616,81,118,199,40,28,15,58,85,506
2859,Courtney Pigram,JR,2007-08,G,East Tennessee State,A-Sun,32,1060,186,462,.403,125,278,61,184,.332,73,97,.753,19,82,101,109,45,4,97,74,506
2860,Dwight Powell,JR,2012-13,F,Stanford,Pac-12,34,1032,179,383,.467,164,350,15,33,.455,133,167,.796,72,213,285,72,26,39,83,104,506
2861,Samardo Samuels,SO,2009-10,F,Louisville,Big East,33,968,176,336,.524,176,336,0,0,,154,218,.706,106,125,231,39,20,37,82,87,506
2862,Jaleen Smith,SR,2016-17,G,New Hampshire,AEC,32,1158,179,384,.466,131,250,48,134,.358,100,128,.781,42,163,205,137,29,20,95,85,506
2863,Domonic Tilford,SR,2008-09,G,South Alabama,Sun Belt,31,1077,168,411,.409,85,205,83,206,.403,87,104,.837,11,74,85,92,29,1,80,36,506
2864,Josh Williams,SR,2018-19,G,Robert Morris,NEC,35,1131,162,414,.391,59,142,103,272,.379,79,103,.767,19,81,100,83,35,5,82,69,506
2865,Trey Zeigler,FR,2010-11,G,Central Michigan,MAC,31,1067,191,484,.395,165,405,26,79,.329,98,173,.566,41,126,167,67,42,29,102,83,506
2866,Mohamed Abukar,SR,2006-07,F,San Diego State,MWC,32,1061,185,392,.472,166,329,19,63,.302,116,140,.829,44,141,185,51,15,19,69,83,505
2867,Jordan Adams,FR,2012-13,G,UCLA,Pac-12,33,999,165,369,.447,119,219,46,150,.307,129,153,.843,21,106,127,58,73,12,40,69,505
2868,KeVaughn Allen,SO,2016-17,G,Florida,SEC,36,1029,168,384,.438,90,173,78,211,.370,91,103,.883,8,78,86,53,45,10,46,56,505
2869,Ryan Anderson,SR,2015-16,F,Arizona,Pac-12,33,963,174,319,.545,172,312,2,7,.286,155,208,.745,99,235,334,26,23,20,63,70,505
2870,Devon Andrews,JR,2018-19,F,Florida International,CUSA,33,866,179,363,.493,143,262,36,101,.356,111,156,.712,40,127,167,46,56,15,60,82,505
2871,George Beamon,SO,2010-11,G,Manhattan,MAAC,31,1141,180,412,.437,174,372,6,40,.150,139,188,.739,73,116,189,41,45,15,64,90,505
2874,Zack Bryant,SO,2018-19,G,Alabama-Birmingham,CUSA,34,1136,181,416,.435,132,263,49,153,.320,94,138,.681,17,102,119,134,62,13,77,78,505
2875,Deonte Burton,JR,2012-13,G,Nevada,MWC,31,1057,159,354,.449,125,241,34,113,.301,153,213,.718,18,56,74,112,42,14,73,61,505
2876,Omar Carter,JR,2010-11,G,Appalachian State,Southern,31,1042,184,395,.466,146,300,38,95,.400,99,131,.756,51,129,180,40,26,7,52,57,505
2877,Will Cherry,JR,2011-12,G,Montana,Big Sky,32,1082,161,362,.445,110,225,51,137,.372,132,169,.781,20,104,124,105,83,11,90,80,505
2878,Darell Combs,JR,2015-16,G,IUPUI,Summit,31,950,165,386,.427,107,247,58,139,.417,117,155,.755,12,58,70,68,31,1,101,93,505
2879,Chris Daniels,SR,2006-07,C,Texas A&M-Corpus Christi,Southland,33,849,194,329,.590,186,304,8,25,.320,109,158,.690,60,160,220,25,24,53,72,98,505
2880,Boo Davis,SR,2005-06,G,Milwaukee,Horizon,31,845,159,385,.413,68,151,91,234,.389,96,125,.768,44,113,157,38,46,5,52,58,505
2881,Justin Dentmon,SR,2008-09,G,Washington,Pac-10,35,992,160,353,.453,97,200,63,153,.412,122,148,.824,30,66,96,86,53,5,66,65,505
2882,Spencer Dinwiddie,SO,2012-13,G,Colorado,Pac-12,33,1073,130,313,.415,83,174,47,139,.338,198,240,.825,9,96,105,99,44,16,73,65,505
2883,Jeff Dowtin,JR,2018-19,G,Rhode Island,A-10,33,1207,190,400,.475,144,270,46,130,.354,79,106,.745,22,90,112,122,45,15,59,48,505
2884,Matt Farrell,SR,2017-18,G,Notre Dame,ACC,31,1111,168,410,.410,70,150,98,260,.377,71,87,.816,6,69,75,169,32,2,74,46,505
2885,Bryn Forbes,SR,2015-16,G,Michigan State,Big Ten,35,982,165,343,.481,53,110,112,233,.481,63,75,.840,12,61,73,52,14,1,30,51,505
2886,Jayden Gardner,FR,2018-19,F,East Carolina,AAC,31,949,166,337,.493,164,327,2,10,.200,171,228,.750,93,169,262,39,24,14,75,88,505
2887,Malik Hairston,SR,2007-08,G,Oregon,Pac-10,31,976,176,335,.525,124,215,52,120,.433,101,138,.732,45,105,150,66,19,26,55,90,505
2888,Jeremy Harris,SR,2018-19,G,Buffalo,MAC,36,1124,194,464,.418,132,234,62,230,.270,55,76,.724,48,175,223,108,40,25,56,54,505
2889,Trevon Hughes,SR,2009-10,G,Wisconsin,Big Ten,33,1077,162,399,.406,88,212,74,187,.396,107,150,.713,40,108,148,86,55,16,68,107,505
2890,Luis Jacobo,SR,2013-14,F,Purdue-Fort Wayne,Summit,33,964,171,370,.462,97,184,74,186,.398,89,110,.809,24,135,159,45,25,9,58,57,505
2891,Matt Kingsley,SR,2008-09,C,Stephen F. Austin,Southland,32,961,213,389,.548,213,388,0,1,.000,79,123,.642,62,183,245,29,16,39,58,72,505
2892,Derrick Marks,JR,2013-14,G,Boise State,MWC,34,961,173,392,.441,154,326,19,66,.288,140,173,.809,15,99,114,89,51,10,89,99,505
2893,Devin Martin,SR,2015-16,G,Maryland-Eastern Shore,MEAC,30,987,174,410,.424,107,224,67,186,.360,90,119,.756,31,108,139,63,38,10,72,64,505
2896,Sean McGonagill,SR,2013-14,G,Brown,Ivy,29,1084,162,405,.400,69,172,93,233,.399,88,113,.779,17,108,125,109,38,1,50,72,505
2897,Shonn Miller,SR,2014-15,F,Cornell,Ivy,30,940,168,387,.434,140,283,28,104,.269,141,169,.834,28,226,254,30,38,54,53,86,505
2898,Raymar Morgan,SO,2007-08,F,Michigan State,Big Ten,36,997,187,335,.558,177,302,10,33,.303,121,180,.672,78,143,221,58,33,19,83,99,505
2899,Mark Porter,SR,2007-08,G,Wagner,NEC,31,1160,151,380,.397,111,241,40,139,.288,163,210,.776,18,132,150,172,59,28,126,55,505
2900,Dwight Powell,SR,2013-14,F,Stanford,Pac-12,36,1167,175,379,.462,165,340,10,39,.256,145,211,.687,70,177,247,112,47,30,104,113,505
2901,Maureece Rice,JR,2006-07,G,George Washington,A-10,32,1097,186,414,.449,122,265,64,149,.430,69,95,.726,35,81,116,66,43,3,56,50,505
2902,Jermaine Ruttley,JR,2014-15,G,Florida A&M,MEAC,29,956,181,401,.451,148,289,33,112,.295,110,162,.679,40,154,194,62,46,2,69,88,505
2903,Justin Rutty,JR,2009-10,F,Quinnipiac,NEC,33,1040,205,378,.542,205,378,0,0,,95,151,.629,163,196,359,29,34,18,74,96,505
2904,David Schroeder,SR,2006-07,G,Idaho State,Big Sky,30,1092,170,388,.438,91,201,79,187,.422,86,113,.761,22,142,164,44,44,3,59,62,505
2905,D.J. Strawberry,SR,2006-07,G,Maryland,ACC,34,1083,184,386,.477,149,284,35,102,.343,102,149,.685,45,106,151,119,69,14,74,87,505
2906,Stephen Thompson,JR,2017-18,G,Oregon State,Pac-12,32,1172,187,406,.461,123,222,64,184,.348,67,102,.657,25,75,100,104,55,11,67,72,505
2907,Mitchell Watt,SR,2011-12,F,Buffalo,MAC,31,937,189,341,.554,178,307,11,34,.324,116,156,.744,66,167,233,72,19,67,80,88,505
2908,Wendell White,SR,2006-07,G,Nevada-Las Vegas,MWC,35,958,210,409,.513,209,394,1,15,.067,84,125,.672,89,125,214,40,43,13,56,85,505
2909,Brenton Williams,SR,2013-14,G,South Carolina,SEC,34,1030,146,345,.423,53,127,93,218,.427,120,129,.930,15,49,64,46,37,0,41,44,505
2910,Jarvis Williams,JR,2013-14,F,Murray State,OVC,34,1105,184,284,.648,184,284,0,0,,137,208,.659,128,210,338,22,26,60,67,89,505
2911,Trey Zeigler,SO,2011-12,G,Central Michigan,MAC,32,1016,199,431,.462,188,393,11,38,.289,96,194,.495,74,141,215,79,36,22,82,81,505
2912,Zach Auguste,SR,2015-16,F,Notre Dame,ACC,36,1065,192,343,.560,192,343,0,0,,120,191,.628,122,264,386,38,23,39,88,86,504
2913,Frank Bartley,JR,2016-17,G,Louisiana,Sun Belt,33,1068,162,367,.441,94,177,68,190,.358,112,156,.718,28,114,142,85,55,3,64,80,504
2914,Kadeem Batts,JR,2012-13,F,Providence,Big East,34,1079,188,393,.478,188,390,0,3,.000,128,185,.692,101,145,246,35,22,23,72,122,504
2915,Korey Billbury,SO,2013-14,G,Oral Roberts,Southland,33,1070,174,378,.460,150,314,24,64,.375,132,182,.725,77,152,229,83,36,6,77,98,504
2916,Markel Brown,JR,2012-13,G,Oklahoma State,Big 12,33,1126,169,388,.436,117,245,52,143,.364,114,150,.760,16,130,146,80,33,26,57,70,504
2917,Trey Burke,FR,2011-12,G,Michigan,Big Ten,34,1227,177,409,.433,120,245,57,164,.348,93,125,.744,22,96,118,156,31,13,94,53,504
2918,Darren Collison,SR,2008-09,G,UCLA,Pac-10,35,1103,175,344,.509,134,240,41,104,.394,113,126,.897,16,68,84,166,57,5,87,53,504
2919,Anthony Cowan,SO,2017-18,G,Maryland,Big Ten,32,1184,144,341,.422,90,194,54,147,.367,162,191,.848,7,133,140,164,48,10,89,65,504
2920,David Dees,JR,2006-07,G,Louisiana,Sun Belt,29,1031,164,406,.404,137,299,27,107,.252,149,192,.776,55,99,154,86,30,10,67,57,504
2921,Mike DiNunno,SR,2012-13,G,Eastern Kentucky,OVC,34,1200,163,386,.422,72,152,91,234,.389,87,102,.853,11,60,71,147,64,0,91,81,504
2922,Torin Dorn,SR,2018-19,G,North Carolina State,ACC,36,1026,209,434,.482,186,358,23,76,.303,63,107,.589,80,180,260,45,36,9,52,50,504
2923,Ben Drayton,JR,2010-11,G,Georgia Southern,Southern,32,1184,185,385,.481,165,309,20,76,.263,114,159,.717,35,79,114,146,60,1,113,74,504
2924,Chris Gaston,FR,2009-10,F,Fordham,A-10,28,981,190,423,.449,188,401,2,22,.091,122,182,.670,115,204,319,43,26,50,126,73,504
2925,Taylor Johns,JR,2014-15,F,UC-Riverside,Big West,31,1067,191,411,.465,182,373,9,38,.237,113,177,.638,80,175,255,59,37,52,106,91,504
2926,Jalen Jones,SR,2015-16,G,Texas A&M,SEC,33,902,175,412,.425,141,307,34,105,.324,120,171,.702,64,172,236,21,22,9,53,94,504
2927,Derrick Marks,SO,2012-13,G,Boise State,MWC,31,934,169,363,.466,147,311,22,52,.423,144,172,.837,20,98,118,122,56,14,106,94,504
2928,Cartier Martin,JR,2005-06,F,Kansas State,Big 12,28,919,161,341,.472,111,224,50,117,.427,132,157,.841,64,122,186,52,27,6,58,68,504
2929,Cody Martin,JR,2017-18,F,Nevada,MWC,36,1284,193,374,.516,178,323,15,51,.294,103,147,.701,65,160,225,169,60,53,73,87,504
2930,Xavier Munford,JR,2012-13,G,Rhode Island,A-10,29,1027,168,426,.394,100,228,68,198,.343,100,140,.714,8,74,82,56,30,10,77,70,504
2931,D.J. Newbill,SO,2012-13,G,Penn State,Big Ten,31,1133,175,432,.405,155,357,20,75,.267,134,196,.684,48,107,155,125,36,8,120,90,504
2932,Carson Puriefoy,JR,2014-15,G,Stony Brook,AEC,35,1158,161,423,.381,110,255,51,168,.304,131,173,.757,16,95,111,118,40,10,98,74,504
2933,K.C. Rivers,SO,2006-07,G,Clemson,ACC,36,1048,183,396,.462,95,173,88,223,.395,50,68,.735,56,106,162,65,44,5,44,77,504
2934,Keston Roberts,SR,2006-07,G,Youngstown State,Horizon,31,1047,193,453,.426,148,314,45,139,.324,73,88,.830,28,76,104,52,25,12,73,62,504
2935,Tyler Sharpe,JR,2018-19,G,Northern Kentucky,Horizon,35,1125,154,363,.424,64,128,90,235,.383,106,136,.779,17,88,105,64,52,3,42,84,504
2938,Jason Smith,JR,2006-07,F,Colorado State,MWC,30,905,175,302,.579,175,299,0,3,.000,154,200,.770,98,206,304,58,16,47,102,94,504
2939,Kyle Spain,SR,2008-09,F,San Diego State,MWC,36,978,150,373,.402,83,202,67,171,.392,137,164,.835,61,128,189,52,45,11,74,73,504
2940,Christian Standhardinger,JR,2012-13,F,Hawaii,Big West,32,963,184,361,.510,169,316,15,45,.333,121,188,.644,89,163,252,43,45,15,60,69,504
2941,B.J. Taylor,SO,2016-17,G,Central Florida,AAC,29,1056,165,399,.414,117,258,48,141,.340,126,175,.720,11,105,116,101,32,1,64,60,504
2942,Steve Taylor,SR,2016-17,F,Toledo,MAC,33,1058,210,400,.525,200,350,10,50,.200,74,151,.490,78,326,404,123,10,16,117,70,504
2943,Tremont Waters,SO,2018-19,G,Louisiana State,SEC,33,1070,172,400,.430,116,229,56,171,.327,104,128,.813,10,82,92,192,96,4,114,64,504
2944,Tim Williams,JR,2009-10,G,South Alabama,Sun Belt,32,1077,188,438,.429,143,300,45,138,.326,83,127,.654,65,169,234,68,34,8,83,71,504
2945,Theron Wilson,SR,2008-09,F,Bradley,MVC,36,1094,153,331,.462,138,273,15,58,.259,183,251,.729,79,184,263,61,66,19,95,95,504
2946,Alex Zampier,SR,2009-10,G,Yale,Ivy,29,897,161,412,.391,106,228,55,184,.299,127,148,.858,6,78,84,69,59,6,89,50,504
2947,Chris Alexander,SR,2005-06,G,Southern,SWAC,32,1042,185,444,.417,138,285,47,159,.296,86,107,.804,30,76,106,46,42,3,83,52,503
2948,Darian Anderson,SO,2015-16,G,Fairleigh Dickinson,NEC,33,1090,183,446,.410,136,306,47,140,.336,90,113,.796,25,95,120,123,60,9,104,85,503
2949,D.J. Augustin,FR,2006-07,G,Texas,Big 12,35,1245,154,343,.449,109,241,45,102,.441,150,179,.838,21,78,99,233,53,3,115,81,503
2950,Patrick Christopher,SO,2007-08,G,University of California,Pac-10,33,1162,188,412,.456,143,277,45,135,.333,82,103,.796,37,82,119,65,18,3,65,74,503
2951,Angel Delgado,JR,2016-17,C,Seton Hall,Big East,33,1090,197,363,.543,197,363,0,0,,109,196,.556,166,265,431,73,21,11,99,83,503
2952,Rudy Gay,SO,2005-06,F,Connecticut,Big East,33,1015,187,406,.461,159,318,28,88,.318,101,138,.732,66,144,210,68,58,52,82,75,503
2953,Matt Kingsley,JR,2007-08,C,Stephen F. Austin,Southland,32,875,171,317,.539,171,316,0,1,.000,161,215,.749,65,118,183,19,18,31,55,89,503
2954,Cameron Krutwig,SO,2018-19,C,Loyola (IL),MVC,34,958,212,337,.629,211,334,1,3,.333,78,135,.578,56,188,244,83,19,34,72,67,503
2955,Maurice Latham,SR,2005-06,F,Campbell,A-Sun,28,908,181,339,.534,163,287,18,52,.346,123,159,.774,112,138,250,61,29,3,80,80,503
2956,Rob Marberry,SR,2018-19,F,Lipscomb,A-Sun,34,817,216,343,.630,216,342,0,1,.000,71,106,.670,50,88,138,65,17,21,29,67,503
2957,Nic Moore,SO,2013-14,G,Southern Methodist,AAC,37,1190,159,343,.464,87,178,72,165,.436,113,137,.825,10,74,84,181,54,2,87,98,503
2960,Anthony Myles,SR,2013-14,G,Rider,MAAC,31,1024,146,350,.417,86,191,60,159,.377,151,199,.759,27,106,133,69,22,10,68,74,503
2961,Luke Nevill,JR,2007-08,C,Utah,MWC,33,952,191,357,.535,191,357,0,0,,121,168,.720,72,150,222,43,17,53,73,83,503
2962,Robby Ptacek,SR,2011-12,G,Central Connecticut State,NEC,29,1072,168,408,.412,127,282,41,126,.325,126,137,.920,23,91,114,64,26,2,82,65,503
2963,Colt Ryan,SO,2010-11,G,Evansville,MVC,32,1039,153,368,.416,88,208,65,160,.406,132,151,.874,16,89,105,75,40,7,74,82,503
2964,Larry Sanders,JR,2009-10,F,Virginia Commonwealth,CAA,35,941,196,367,.534,192,351,4,16,.250,107,167,.641,106,213,319,34,26,90,58,103,503
2965,Shavon Shields,SR,2015-16,G,Nebraska,Big Ten,30,921,181,385,.470,153,308,28,77,.364,113,147,.769,39,114,153,80,38,10,72,55,503
2966,Jason Smith,SO,2005-06,F,Colorado State,MWC,31,889,178,344,.517,173,333,5,11,.455,142,186,.763,70,157,227,70,20,66,112,102,503
2967,Chris Thomas,SR,2015-16,G,Texas Southern,SWAC,33,1123,191,378,.505,176,322,15,56,.268,106,200,.530,57,112,169,143,33,12,121,102,503
2968,Ben Uzoh,JR,2008-09,G,Tulsa,CUSA,36,1287,169,386,.438,129,264,40,122,.328,125,158,.791,29,146,175,128,54,18,93,74,503
2969,Marcel White,JR,2015-16,G,Jacksonville,A-Sun,32,1022,160,380,.421,78,172,82,208,.394,101,139,.727,36,143,179,45,25,20,52,67,503
2970,Anthlon Bell,SR,2015-16,G,Arkansas,SEC,32,917,172,402,.428,83,200,89,202,.441,69,82,.841,22,71,93,39,20,7,35,70,502
2971,Vander Blue,JR,2012-13,G,Marquette,Big East,34,1123,183,403,.454,143,271,40,132,.303,96,127,.756,20,90,110,62,36,0,79,60,502
2972,J'Nathan Bullock,JR,2007-08,F,Cleveland State,Horizon,34,1026,165,364,.453,140,287,25,77,.325,147,190,.774,73,153,226,38,29,5,82,81,502
2973,Ahmad Clark,JR,2018-19,G,Albany (NY),AEC,32,984,157,423,.371,99,238,58,185,.314,130,166,.783,15,121,136,137,63,12,114,94,502
2974,Drew Crawford,SR,2013-14,G,Northwestern,Big Ten,32,1170,169,417,.405,119,264,50,153,.327,114,146,.781,40,165,205,71,18,25,69,75,502
2975,Raasean Davis,SR,2018-19,F,North Carolina Central,MEAC,34,1009,213,330,.645,213,330,0,0,,76,108,.704,116,194,310,17,29,42,71,96,502
2976,Jourdan Demunyck,SR,2012-13,G,Prairie View,SWAC,32,970,185,468,.395,149,356,36,112,.321,96,136,.706,65,144,209,47,47,6,85,73,502
2977,Ross DeRogatis,SR,2006-07,G,San Diego,WCC,32,1059,158,359,.440,60,109,98,250,.392,88,111,.793,14,69,83,94,33,2,88,76,502
2978,Sundiata Gaines,SR,2007-08,G,Georgia,SEC,34,1144,175,423,.414,132,280,43,143,.301,109,180,.606,72,132,204,143,61,3,89,83,502
2979,Donte Gennie,SR,2006-07,G,Georgia Southern,Southern,31,1052,181,403,.449,99,212,82,191,.429,58,83,.699,20,67,87,81,40,0,70,54,502
2982,Jacob Gilyard,SO,2018-19,G,Richmond,A-10,31,1155,177,375,.472,103,171,74,204,.363,74,96,.771,20,70,90,160,88,1,74,52,502
2983,Jon Goode,SR,2007-08,G,Detroit Mercy,Horizon,26,895,171,378,.452,92,201,79,177,.446,81,103,.786,16,60,76,70,24,0,75,57,502
2984,Kason Harrell,SR,2018-19,G,Purdue-Fort Wayne,Summit,33,998,196,389,.504,138,243,58,146,.397,52,77,.675,25,89,114,60,36,27,51,68,502
2985,Al Horford,JR,2006-07,F,Florida,SEC,38,1057,186,306,.608,186,304,0,2,.000,130,202,.644,96,264,360,82,28,70,68,94,502
2986,Michael Jenkins,JR,2006-07,G,Winthrop,Big South,34,1026,181,394,.459,81,153,100,241,.415,40,57,.702,26,102,128,110,44,12,71,66,502
2987,Ty Jerome,JR,2018-19,G,Virginia,ACC,37,1256,178,409,.435,99,211,79,198,.399,67,91,.736,17,140,157,202,57,1,61,64,502
2988,Daishon Knight,SR,2014-15,G,Illinois State,MVC,35,1046,178,406,.438,133,283,45,123,.366,101,117,.863,26,89,115,85,36,1,63,41,502
2989,Warren Niles,SO,2010-11,G,Oral Roberts,Summit,35,1087,167,428,.390,91,221,76,207,.367,92,113,.814,24,104,128,63,36,5,68,84,502
2990,Darryl Partin,JR,2010-11,G,Boston University,AEC,35,1118,170,420,.405,106,241,64,179,.358,98,129,.760,29,89,118,49,35,9,100,89,502
2991,Nijal Pearson,SO,2017-18,G,Texas State,Sun Belt,33,1077,172,437,.394,114,261,58,176,.330,100,141,.709,67,130,197,80,44,13,80,75,502
2992,Rian Pearson,JR,2012-13,G,Toledo,MAC,28,931,172,380,.453,166,352,6,28,.214,152,207,.734,58,131,189,48,48,3,79,60,502
2993,T.J. Price,SO,2012-13,G,Western Kentucky,Sun Belt,33,1089,170,430,.395,89,204,81,226,.358,81,116,.698,30,117,147,79,38,13,87,78,502
2994,Monty Scott,SO,2017-18,G,Kennesaw State,A-Sun,29,923,188,452,.416,134,293,54,159,.340,72,90,.800,16,53,69,65,50,6,77,66,502
2995,Ronshad Shabazz,SO,2016-17,G,Appalachian State,Sun Belt,30,929,176,442,.398,110,241,66,201,.328,84,116,.724,16,90,106,51,23,2,52,57,502
2996,Kendall Smith,JR,2016-17,G,Cal State Northridge,Big West,30,1003,171,382,.448,126,262,45,120,.375,115,151,.762,22,98,120,143,40,8,82,62,502
2997,Travis Smith,SR,2012-13,G,Mercer,A-Sun,36,1081,157,347,.452,83,176,74,171,.433,114,127,.898,16,84,100,68,28,2,73,78,502
2998,Deshon Taylor,SR,2018-19,G,Fresno State,MWC,28,996,152,341,.446,85,174,67,167,.401,131,167,.784,18,85,103,139,40,6,81,76,502
2999,Joe Trapani,SR,2010-11,F,Boston College,ACC,34,1017,173,407,.425,123,267,50,140,.357,106,150,.707,61,176,237,61,23,27,64,86,502
3000,Tai Wesley,SR,2010-11,F,Utah State,WAC,34,993,176,294,.599,171,286,5,8,.625,145,204,.711,96,175,271,73,27,36,76,108,502
3001,DaShaun Wood,JR,2005-06,G,Wright State,Horizon,28,988,165,384,.430,143,303,22,81,.272,150,188,.798,34,92,126,131,51,5,97,56,502
3004,Blake Ahearn,JR,2005-06,G,Missouri State,MVC,31,1001,155,364,.426,81,168,74,196,.378,117,125,.936,14,57,71,76,32,1,73,35,501
3005,John Carroll,JR,2017-18,F,Hartford,AEC,33,1038,174,371,.469,154,305,20,66,.303,133,186,.715,56,156,212,80,18,30,67,89,501
3006,Wendell Carter,FR,2017-18,F,Duke,ACC,37,997,179,319,.561,160,273,19,46,.413,124,168,.738,109,226,335,74,30,76,75,105,501
3007,Stacy Davis,JR,2014-15,F,Pepperdine,WCC,32,1025,165,349,.473,150,297,15,52,.288,156,193,.808,75,173,248,59,30,35,87,74,501
3008,Terence Davis,SR,2018-19,G,Mississippi,SEC,33,1024,179,403,.444,114,228,65,175,.371,78,101,.772,37,154,191,114,54,21,91,88,501
3009,Tavrion Dawson,SR,2017-18,F,Cal State Northridge,Big West,30,990,195,441,.442,168,336,27,105,.257,84,118,.712,45,152,197,60,27,22,70,64,501
3010,Tre Demps,SR,2015-16,G,Northwestern,Big Ten,32,1185,189,475,.398,117,258,72,217,.332,51,77,.662,16,98,114,104,21,1,39,28,501
3011,PJ Dozier,SO,2016-17,G,South Carolina,SEC,36,1033,191,469,.407,149,328,42,141,.298,77,129,.597,39,134,173,101,60,10,78,100,501
3012,Byron Eaton,SR,2008-09,G,Oklahoma State,Big 12,35,1110,135,321,.421,112,244,23,77,.299,208,269,.773,28,100,128,199,77,3,124,123,501
3013,Rahmon Fletcher,SR,2010-11,G,Green Bay,Horizon,32,1007,187,405,.462,136,267,51,138,.370,76,108,.704,17,61,78,98,47,3,67,79,501
3014,Michael Flowers,SO,2018-19,G,Western Michigan,MAC,32,1003,151,390,.387,86,194,65,196,.332,134,171,.784,10,114,124,104,28,4,99,77,501
3015,Warren Gillis,JR,2013-14,G,Coastal Carolina,Big South,34,1115,167,358,.466,141,289,26,69,.377,141,166,.849,21,99,120,106,56,3,94,79,501
3016,Mike Groselle,JR,2011-12,C,The Citadel,Southern,30,1059,198,335,.591,198,335,0,0,,105,154,.682,117,171,288,54,43,19,65,88,501
3017,C.J. Harris,JR,2011-12,G,Wake Forest,ACC,30,1052,153,321,.477,104,205,49,116,.422,146,173,.844,15,77,92,74,34,2,72,71,501
3018,Martin Hermannsson,SO,2015-16,G,Long Island University,NEC,31,1124,154,336,.458,118,236,36,100,.360,157,178,.882,25,109,134,146,55,8,68,65,501
3019,Darrun Hilliard,SR,2014-15,G,Villanova,Big East,35,1007,170,386,.440,91,182,79,204,.387,82,103,.796,16,93,109,74,63,12,42,78,501
3020,Damion James,SO,2007-08,F,Texas,Big 12,38,1185,193,419,.461,155,327,38,92,.413,77,135,.570,119,274,393,51,26,51,59,97,501
3021,Matej Kavas,SO,2017-18,G,Seattle,WAC,33,1038,171,361,.474,80,165,91,196,.464,68,86,.791,38,131,169,41,13,7,67,100,501
3022,Lorenzo Keeler,SR,2009-10,G,Cal Poly,Big West,31,1028,141,388,.363,85,197,56,191,.293,163,189,.862,15,70,85,84,13,2,79,61,501
3023,Willie Mangum,SR,2016-17,G,Eastern Michigan,MAC,32,793,172,421,.409,79,174,93,247,.377,64,90,.711,16,62,78,68,48,2,51,72,501
3024,Kennedy Meeks,SR,2016-17,F,North Carolina,ACC,40,973,206,371,.555,206,371,0,0,,89,143,.622,152,226,378,41,38,47,48,94,501
3025,Paul Miller,JR,2016-17,G,North Dakota State,Summit,30,998,161,358,.450,87,162,74,196,.378,105,140,.750,16,141,157,54,28,12,62,67,501
3026,Khalid Mutakabbir,SR,2012-13,G,Presbyterian,Big South,32,1192,175,410,.427,112,243,63,167,.377,88,105,.838,21,77,98,79,36,3,95,55,501
3027,Drew Neitzel,SR,2007-08,G,Michigan State,Big Ten,36,1137,165,407,.405,68,163,97,244,.398,74,86,.860,15,75,90,145,35,2,51,56,501
3028,Robert Nyakundi,JR,2010-11,F,Southern Methodist,CUSA,35,1071,166,345,.481,69,150,97,195,.497,72,80,.900,35,116,151,67,36,6,83,108,501
3029,Greg Oden,FR,2006-07,C,Ohio State,Big Ten,32,925,189,307,.616,189,307,0,0,,123,196,.628,113,193,306,21,18,105,64,87,501
3030,Otto Porter,SO,2012-13,F,Georgetown,Big East,31,1097,168,350,.480,125,248,43,102,.422,122,157,.777,55,177,232,84,57,28,47,61,501
3031,Taylor Smith,SR,2012-13,F,Stephen F. Austin,Southland,32,1083,211,304,.694,211,304,0,0,,79,167,.473,90,204,294,56,33,90,60,72,501
3032,Ladarius Tabb,JR,2014-15,G,Alabama A&M,SWAC,28,926,190,421,.451,144,262,46,159,.289,75,124,.605,91,126,217,20,35,4,49,80,501
3033,Jeffery Taylor,JR,2010-11,F,Vanderbilt,SEC,34,1078,171,381,.449,132,268,39,113,.345,120,167,.719,57,131,188,80,35,19,87,83,501
3034,Obie Trotter,SR,2005-06,G,Alabama A&M,SWAC,26,885,170,406,.419,106,227,64,179,.358,97,126,.770,25,61,86,115,87,6,89,71,501
3035,Will Walker,SR,2009-10,G,DePaul,Big East,31,1180,177,494,.358,106,263,71,231,.307,76,107,.710,23,70,93,79,48,4,52,54,501
3036,Jaylin Airington,SR,2016-17,G,Cal State Bakersfield,WAC,35,1108,161,388,.415,117,268,44,120,.367,134,168,.798,52,111,163,71,28,3,65,90,500
3037,Josh Alexander,JR,2007-08,G,Stephen F. Austin,Southland,31,1022,157,360,.436,63,131,94,229,.410,92,123,.748,56,128,184,35,45,11,45,75,500
3038,Devontae Cacok,SR,2018-19,F,North Carolina-Wilmington,CAA,33,951,203,344,.590,202,343,1,1,1.000,93,155,.600,132,273,405,21,31,22,74,115,500
3039,Eli Cain,SO,2016-17,G,DePaul,Big East,32,1059,169,425,.398,118,277,51,148,.345,111,154,.721,32,112,144,85,33,12,76,85,500
3040,Jevon Carter,JR,2016-17,G,West Virginia,Big 12,37,1184,166,378,.439,94,193,72,185,.389,96,124,.774,38,146,184,137,92,9,67,95,500
3041,Karl Cochran,SO,2012-13,G,Wofford,Southern,32,986,189,523,.361,111,270,78,253,.308,44,60,.733,18,118,136,55,63,25,74,77,500
3042,Charles Cooke,JR,2015-16,G,Dayton,A-10,32,1029,163,365,.447,104,217,59,148,.399,115,167,.689,43,144,187,58,40,38,56,61,500
3043,Louis Dabney,SO,2013-14,G,Tulane,CUSA,33,1069,160,386,.415,131,283,29,103,.282,151,214,.706,33,103,136,66,41,3,80,97,500
3046,James Daniel,SO,2014-15,G,Howard,MEAC,30,972,140,414,.338,72,176,68,238,.286,152,186,.817,15,50,65,81,55,0,108,56,500
3047,Ricky Franklin,SR,2009-10,G,Milwaukee,Horizon,34,1212,167,391,.427,93,179,74,212,.349,92,130,.708,21,123,144,132,32,6,102,91,500
3048,Taj Gibson,JR,2008-09,F,Southern California,Pac-10,35,1179,190,316,.601,190,316,0,0,,120,182,.659,123,193,316,44,34,100,72,103,500
3049,Jeremy Hollowell,SR,2016-17,F,Georgia State,Sun Belt,33,1015,175,411,.426,116,235,59,176,.335,91,121,.752,33,163,196,57,32,25,85,102,500
3050,Dorenzo Hudson,JR,2009-10,G,Virginia Tech,ACC,33,1155,174,398,.437,139,278,35,120,.292,117,155,.755,33,81,114,63,25,8,57,60,500
3051,Reginald Johnson,JR,2016-17,F,Alcorn State,SWAC,32,805,204,387,.527,177,302,27,85,.318,65,88,.739,82,144,226,25,14,12,44,53,500
3052,C.J. Leslie,SO,2011-12,F,North Carolina State,ACC,34,985,192,366,.525,188,352,4,14,.286,112,188,.596,74,175,249,37,36,54,79,87,500
3053,Maodo Lo,SO,2013-14,G,Columbia,Ivy,34,1096,172,359,.479,96,189,76,170,.447,80,96,.833,18,112,130,70,42,11,68,79,500
3054,Damon Lynn,FR,2013-14,G,NJIT,Ind,29,981,151,405,.373,44,123,107,282,.379,91,117,.778,15,65,80,60,35,1,53,32,500
3055,Jahmal McMurray,FR,2015-16,G,South Florida,AAC,33,1161,184,471,.391,111,260,73,211,.346,59,74,.797,11,80,91,81,13,4,81,61,500
3056,K.C. Rivers,JR,2007-08,G,Clemson,ACC,34,1036,188,429,.438,108,230,80,199,.402,44,65,.677,83,131,214,61,64,16,38,60,500
3057,D.J. Seeley,SR,2012-13,G,Cal State Fullerton,Big West,28,919,166,352,.472,103,199,63,153,.412,105,130,.808,26,95,121,108,56,8,75,78,500
3058,Chad Tomko,SO,2008-09,G,North Carolina-Wilmington,CAA,32,1021,183,484,.378,106,240,77,244,.316,57,63,.905,19,98,117,142,69,2,87,78,500
3059,Mikhail Torrance,SR,2009-10,G,Alabama,SEC,32,1043,163,347,.470,124,238,39,109,.358,135,156,.865,10,109,119,162,26,8,86,49,500
3060,Ekpe Udoh,JR,2009-10,C,Baylor,Big 12,36,1264,191,390,.490,184,364,7,26,.269,111,162,.685,129,222,351,97,29,133,87,87,500
3061,Kyle Weems,SR,2011-12,F,Missouri State,MVC,32,1005,182,440,.414,121,289,61,151,.404,75,96,.781,56,173,229,44,19,20,60,95,500
3062,Michael Williams,SO,2010-11,G,San Francisco,WCC,34,1104,173,403,.429,99,214,74,189,.392,80,112,.714,14,123,137,59,21,2,68,67,500
3063,Jermaine Anderson,SR,2005-06,G,Fordham,A-10,32,1102,159,371,.429,70,156,89,215,.414,92,108,.852,34,84,118,109,21,5,69,50,499
3064,Tyree Appleby,SO,2018-19,G,Cleveland State,Horizon,29,885,147,350,.420,73,160,74,190,.389,131,168,.780,10,98,108,162,42,9,100,48,499
3065,Aaron Bacote,SR,2015-16,G,Old Dominion,CUSA,38,993,157,366,.429,110,229,47,137,.343,138,169,.817,13,96,109,82,32,6,59,86,499
3068,Grant Benzinger,SR,2017-18,G,Wright State,Horizon,35,1219,156,404,.386,64,155,92,249,.369,95,107,.888,48,141,189,41,25,7,38,82,499
3069,Garfield Blair,JR,2007-08,G,Stetson,A-Sun,31,970,162,331,.489,148,292,14,39,.359,161,214,.752,48,130,178,59,32,12,109,73,499
3070,Ryan Brooks,SR,2009-10,G,Temple,A-10,35,1266,179,433,.413,123,257,56,176,.318,85,103,.825,22,126,148,82,27,3,43,51,499
3071,Jimmy Butler,JR,2009-10,G,Marquette,Big East,34,1165,148,279,.530,132,247,16,32,.500,187,244,.766,82,134,216,68,45,21,39,68,499
3072,Kevin Criswell,SR,2005-06,G,Montana,Big Sky,31,978,147,308,.477,77,138,70,170,.412,135,166,.813,22,113,135,73,41,3,52,81,499
3073,Kenneth Faried,SO,2008-09,F,Morehead State,OVC,36,1083,194,349,.556,192,344,2,5,.400,109,189,.577,153,315,468,52,68,68,80,103,499
3074,Aaron Gray,SR,2006-07,C,Pittsburgh,Big East,36,1016,204,361,.565,204,361,0,0,,91,166,.548,120,221,341,61,15,62,55,91,499
3075,Mike Green,JR,2006-07,G,Butler,Horizon,36,1247,138,333,.414,111,245,27,88,.307,196,264,.742,40,176,216,144,45,0,102,95,499
3076,Scottie James,SO,2017-18,F,Liberty,Big South,37,943,189,307,.616,174,261,15,46,.326,106,141,.752,94,235,329,41,15,33,50,80,499
3077,Matt Janning,SO,2007-08,G,Northeastern,CAA,31,1124,176,394,.447,111,221,65,173,.376,82,101,.812,31,79,110,75,40,6,84,63,499
3078,Cory Johnson,JR,2009-10,F,Valparaiso,Horizon,32,953,180,324,.556,159,283,21,41,.512,118,174,.678,68,117,185,47,33,17,76,89,499
3079,Lucky Jones,JR,2013-14,G,Robert Morris,NEC,36,1069,152,388,.392,82,193,70,195,.359,125,155,.806,59,187,246,57,45,16,76,105,499
3080,Coby Karl,JR,2005-06,G,Boise State,WAC,29,974,150,351,.427,80,174,70,177,.395,129,162,.796,22,125,147,117,30,14,105,81,499
3081,Marcus Keene,SO,2014-15,G,Youngstown State,Horizon,32,1117,167,372,.449,76,155,91,217,.419,74,94,.787,13,100,113,88,35,3,68,80,499
3082,Sergio Kerusch,SR,2010-11,F,Western Kentucky,Sun Belt,32,992,193,398,.485,147,248,46,150,.307,67,104,.644,101,152,253,15,13,12,45,89,499
3083,Dexter McClanahan,JR,2017-18,G,Savannah State,MEAC,32,945,166,407,.408,96,175,70,232,.302,97,133,.729,37,98,135,61,39,6,56,60,499
3084,Donte McGill,JR,2015-16,G,Florida International,CUSA,31,1006,189,391,.483,154,308,35,83,.422,86,108,.796,47,96,143,39,24,3,66,48,499
3085,Dan Nwaelele,SR,2006-07,F,Air Force,MWC,35,1128,163,316,.516,87,147,76,169,.450,97,119,.815,25,97,122,64,31,8,59,60,499
3086,Herb Pope,SR,2011-12,F,Seton Hall,Big East,33,1036,193,410,.471,176,362,17,48,.354,96,156,.615,113,230,343,48,36,56,87,100,499
3087,Darryl Proctor,JR,2007-08,F,Maryland-Baltimore County,AEC,33,1193,194,388,.500,193,383,1,5,.200,110,154,.714,85,193,278,51,60,9,60,91,499
3090,Patrick Richard,JR,2010-11,G,McNeese State,Southland,31,1019,163,343,.475,129,249,34,94,.362,139,182,.764,56,142,198,79,42,13,70,71,499
3091,Mike Rose,SO,2006-07,G,Eastern Kentucky,OVC,33,1084,168,380,.442,80,159,88,221,.398,75,98,.765,35,90,125,61,52,4,57,42,499
3092,Patrick Sanders,SR,2007-08,F,UC-Irvine,Big West,33,1029,178,388,.459,138,290,40,98,.408,103,124,.831,37,124,161,41,13,36,90,79,499
3093,Wesley Saunders,SR,2014-15,G,Harvard,Ivy,30,1032,164,362,.453,133,289,31,73,.425,140,181,.773,51,131,182,128,55,11,78,66,499
3094,Jamar Smith,SR,2007-08,G,Morgan State,MEAC,30,899,191,410,.466,163,325,28,85,.329,89,125,.712,60,103,163,37,29,17,60,74,499
3095,Joel Smith,SR,2012-13,G,Northeastern,CAA,31,1083,161,332,.485,78,139,83,193,.430,94,109,.862,23,98,121,88,32,8,74,74,499
3096,Ricky Soliver,SR,2005-06,G,Iona,MAAC,31,1077,169,385,.439,121,270,48,115,.417,113,150,.753,51,113,164,135,84,6,83,77,499
3097,Eric Stutz,SR,2014-15,F,Eastern Kentucky,OVC,32,1025,190,312,.609,165,259,25,53,.472,94,118,.797,61,121,182,76,27,21,68,57,499
3098,Shayne Whittington,SR,2013-14,C,Western Michigan,MAC,31,987,188,357,.527,182,324,6,33,.182,117,152,.770,74,201,275,34,24,47,58,74,499
3099,Rodney Williams,SR,2016-17,F,Drexel,CAA,32,973,184,350,.526,181,337,3,13,.231,128,190,.674,80,137,217,48,15,27,72,112,499
3100,Ricky Woods,SR,2005-06,F,Southeastern Louisiana,Southland,28,939,171,349,.490,170,344,1,5,.200,156,246,.634,108,196,304,60,57,47,82,84,499
3101,Ryan Arcidiacono,SR,2015-16,G,Villanova,Big East,40,1282,165,371,.445,89,178,76,193,.394,92,110,.836,15,102,117,169,54,1,61,60,498
3102,Isaiah Bailey,JR,2017-18,G,Bethune-Cookman,MEAC,31,998,149,352,.423,121,250,28,102,.275,172,219,.785,42,123,165,149,27,8,123,91,498
3103,Devon Baker,FR,2018-19,G,North Carolina-Asheville,Big South,31,1050,182,458,.397,146,339,36,119,.303,98,120,.817,32,53,85,93,46,5,89,55,498
3104,Trae Bell-Haynes,SR,2017-18,G,Vermont,AEC,34,1089,166,325,.511,144,262,22,63,.349,144,197,.731,21,125,146,138,38,4,106,80,498
3105,Jordan Bone,JR,2018-19,G,Tennessee,SEC,37,1219,186,400,.465,136,259,50,141,.355,76,91,.835,19,99,118,215,26,4,74,49,498
3106,Barry Brown,SR,2018-19,G,Kansas State,Big 12,34,1189,184,425,.433,142,284,42,141,.298,88,124,.710,14,125,139,96,65,5,65,73,498
3107,Jaylen Brown,FR,2015-16,F,University of California,Pac-12,34,939,163,378,.431,133,276,30,102,.294,142,217,.654,36,146,182,68,27,22,105,108,498
3108,Mario Chalmers,JR,2007-08,G,Kansas,Big 12,39,1170,164,318,.516,91,162,73,156,.468,97,130,.746,14,106,120,169,97,23,75,99,498
3109,D.J. Cooper,FR,2009-10,G,Ohio,MAC,37,1313,156,417,.374,91,213,65,204,.319,121,158,.766,67,131,198,218,93,11,99,76,498
3112,Kenny Daniels,SR,2009-10,F,Cal State Northridge,Big West,32,882,163,323,.505,135,234,28,89,.315,144,180,.800,45,88,133,61,34,4,108,84,498
3113,Cole Dickerson,SR,2013-14,F,San Francisco,WCC,33,1004,196,382,.513,151,255,45,127,.354,61,123,.496,65,188,253,57,25,13,65,94,498
3114,Reggie Dillard,SR,2017-18,G,Presbyterian,Big South,32,1074,175,401,.436,108,209,67,192,.349,81,112,.723,17,86,103,56,23,9,84,72,498
3115,Jordan Farmar,SO,2005-06,G,UCLA,Pac-10,37,1125,172,420,.410,109,231,63,189,.333,91,127,.717,21,74,95,189,41,9,135,63,498
3116,Roderick Flemings,JR,2008-09,F,Hawaii,WAC,30,1079,166,356,.466,144,285,22,71,.310,144,198,.727,79,95,174,56,35,13,77,64,498
3117,Bryn Forbes,SO,2013-14,G,Cleveland State,Horizon,32,1102,154,355,.434,73,164,81,191,.424,109,132,.826,23,76,99,54,25,1,50,50,498
3118,Shane Gibson,SO,2010-11,G,Sacred Heart,NEC,29,945,173,393,.440,98,200,75,193,.389,77,92,.837,32,84,116,45,40,18,77,68,498
3119,Grant Golden,FR,2017-18,F,Richmond,A-10,32,981,208,418,.498,186,338,22,80,.275,60,96,.625,49,166,215,69,19,39,82,79,498
3120,Zachary Hamilton,JR,2016-17,F,Prairie View,SWAC,33,1006,163,387,.421,83,187,80,200,.400,92,111,.829,27,109,136,34,40,16,43,84,498
3121,Keldon Johnson,FR,2018-19,G,Kentucky,SEC,37,1137,172,373,.461,127,255,45,118,.381,109,155,.703,49,168,217,60,28,6,60,83,498
3122,Leland King,SR,2017-18,F,UC-Santa Barbara,Big West,32,1017,186,401,.464,133,273,53,128,.414,73,97,.753,66,261,327,61,24,5,40,52,498
3123,Corey Lowe,JR,2008-09,G,Boston University,AEC,29,1060,174,405,.430,89,177,85,228,.373,65,106,.613,19,98,117,120,36,4,97,67,498
3124,Demetri McCamey,SR,2010-11,G,Illinois,Big Ten,34,1137,166,367,.452,92,203,74,164,.451,92,127,.724,17,98,115,208,35,6,100,67,498
3125,Travis McKie,SO,2011-12,F,Wake Forest,ACC,31,1070,175,366,.478,142,279,33,87,.379,115,156,.737,70,146,216,34,26,18,76,72,498
3126,Mikh McKinney,JR,2013-14,G,Sacramento State,Big Sky,30,1038,173,359,.482,135,249,38,110,.345,114,139,.820,24,89,113,138,37,6,68,71,498
3127,Cameron Moore,SR,2011-12,F,Alabama-Birmingham,CUSA,31,1111,195,404,.483,190,381,5,23,.217,103,168,.613,88,237,325,39,19,73,64,63,498
3128,Larry Nance,SR,2014-15,F,Wyoming,MWC,31,1082,185,360,.514,171,318,14,42,.333,114,145,.786,44,180,224,76,37,37,70,69,498
3129,Maurice Ndour,JR,2013-14,F,Ohio,MAC,36,1084,182,356,.511,164,302,18,54,.333,116,159,.730,58,194,252,56,22,55,89,95,498
3130,Rian Pearson,SR,2013-14,G,Toledo,MAC,34,1049,191,399,.479,162,331,29,68,.426,87,130,.669,69,111,180,59,59,4,49,56,498
3131,Jordan Roland,JR,2018-19,G,Northeastern,CAA,34,1038,167,370,.451,68,124,99,246,.402,65,72,.903,16,65,81,58,40,8,30,68,498
3132,Jauwan Scaife,SR,2012-13,G,Ball State,MAC,30,994,145,367,.395,75,156,70,211,.332,138,175,.789,16,63,79,77,29,5,72,57,498
3133,Bernard Thompson,JR,2013-14,G,Florida Gulf Coast,A-Sun,33,1013,167,388,.430,112,220,55,168,.327,109,138,.790,32,103,135,57,48,7,63,79,498
3134,Stephen Thompson,SR,2018-19,G,Oregon State,Pac-12,31,1135,183,428,.428,122,230,61,198,.308,71,94,.755,28,102,130,100,48,4,62,58,498
3135,Henry Walker,FR,2007-08,F,Kansas State,Big 12,31,846,181,389,.465,146,275,35,114,.307,101,137,.737,79,117,196,59,27,17,81,101,498
3136,Antonio Webb,SR,2005-06,G,Bethune-Cookman,MEAC,30,1018,161,437,.368,81,202,80,235,.340,96,128,.750,15,65,80,65,48,1,83,50,498
3137,Dez Wells,SO,2012-13,G,Maryland,ACC,38,1087,191,363,.526,168,294,23,69,.333,93,132,.705,33,153,186,113,34,20,108,81,498
3138,Matthew Butler,SR,2017-18,G,Tennessee-Martin,OVC,31,1169,180,450,.400,90,192,90,258,.349,47,56,.839,10,71,81,92,29,2,100,62,497
3139,Wilson Chandler,SO,2006-07,F,DePaul,Big East,34,1078,194,431,.450,155,314,39,117,.333,70,107,.654,63,172,235,48,22,47,55,96,497
3140,Justin Cobbs,JR,2012-13,G,University of California,Pac-12,33,1174,172,384,.448,146,304,26,80,.325,127,151,.841,12,102,114,158,37,6,97,60,497
3141,LaRon Dendy,SR,2011-12,F,Middle Tennessee,Sun Belt,34,937,175,330,.530,163,291,12,39,.308,135,235,.574,70,173,243,70,22,48,83,91,497
3142,Gabe DeVoe,SR,2017-18,G,Clemson,ACC,35,1202,170,379,.449,84,162,86,217,.396,71,91,.780,31,135,166,73,37,14,70,72,497
3143,Frank Elegar,JR,2006-07,C,Drexel,CAA,31,948,180,341,.528,180,341,0,0,,137,210,.652,64,144,208,22,28,37,79,93,497
3144,Danny Green,SR,2008-09,F,North Carolina,ACC,38,1040,184,391,.471,107,207,77,184,.418,52,61,.852,70,108,178,104,67,51,63,84,497
3145,Mike Green,SR,2007-08,G,Butler,Horizon,34,1144,141,327,.431,108,238,33,89,.371,182,240,.758,41,179,220,172,44,4,100,84,497
3146,Shane Hammink,SR,2016-17,F,Valparaiso,Horizon,33,1042,169,338,.500,128,214,41,124,.331,118,146,.808,30,100,130,81,34,11,84,63,497
3147,Maurice Harkless,FR,2011-12,G,St. John's (NY),Big East,32,1155,193,427,.452,176,348,17,79,.215,94,139,.676,88,188,276,47,51,45,80,74,497
3148,Joseph Harris,SR,2009-10,F,Coastal Carolina,Big South,35,1082,200,383,.522,197,376,3,7,.429,94,151,.623,110,226,336,48,65,32,53,76,497
3149,Nigel Hayes,SO,2014-15,F,Wisconsin,Big Ten,40,1319,166,334,.497,126,233,40,101,.396,125,168,.744,85,162,247,79,34,16,51,76,497
3150,Jaycen Herring,SR,2008-09,F,Southeast Missouri State,OVC,30,1104,176,404,.436,145,319,31,85,.365,114,172,.663,30,93,123,77,25,23,89,76,497
3151,Andre Hollins,SO,2012-13,G,Minnesota,Big Ten,34,1021,152,365,.416,71,171,81,194,.418,112,139,.806,21,105,126,116,36,9,79,80,497
3154,Colton Iverson,SR,2012-13,F,Colorado State,MWC,35,1033,183,307,.596,183,307,0,0,,131,222,.590,117,225,342,46,20,25,69,91,497
3155,JaJuan Johnson,SO,2008-09,F,Purdue,Big Ten,37,997,190,352,.540,190,349,0,3,.000,117,159,.736,79,127,206,26,19,78,49,65,497
3156,Jerome Jordan,JR,2008-09,C,Tulsa,CUSA,36,971,180,307,.586,180,307,0,0,,137,186,.737,88,220,308,34,14,91,87,110,497
3157,D.J. Kennedy,JR,2009-10,G,St. John's (NY),Big East,33,1037,158,351,.450,107,218,51,133,.383,130,172,.756,58,144,202,102,38,22,82,57,497
3158,Preston Knowles,SR,2010-11,G,Louisville,Big East,34,1023,169,446,.379,69,185,100,261,.383,59,73,.808,22,111,133,106,63,8,69,91,497
3159,Jeremy Lin,JR,2008-09,G,Harvard,Ivy,28,975,166,331,.502,126,231,40,100,.400,125,168,.744,24,129,153,119,68,18,106,80,497
3160,LeAntwan Luckett,SO,2013-14,F,Alcorn State,SWAC,31,924,171,404,.423,148,323,23,81,.284,132,193,.684,24,48,72,69,43,7,82,88,497
3161,Antoine Mason,FR,2011-12,G,Niagara,MAAC,33,1131,168,440,.382,132,308,36,132,.273,125,193,.648,50,101,151,70,39,2,81,84,497
3162,Kyle McAlarney,JR,2007-08,G,Notre Dame,Big East,33,1178,167,383,.436,59,138,108,245,.441,55,67,.821,8,61,69,115,26,1,66,34,497
3163,JD Notae,SO,2018-19,G,Jacksonville,A-Sun,32,933,177,415,.427,115,221,62,194,.320,81,111,.730,29,168,197,109,52,14,106,76,497
3164,Miye Oni,JR,2018-19,G,Yale,Ivy,29,898,167,379,.441,111,228,56,151,.371,107,135,.793,19,163,182,103,26,37,75,78,497
3165,Marcus Ottey,SO,2017-18,G,Illinois-Chicago,Horizon,36,1003,184,355,.518,159,282,25,73,.342,104,124,.839,19,101,120,65,32,15,69,79,497
3166,Evan Payne,FR,2013-14,G,Loyola Marymount,WCC,32,956,171,394,.434,133,284,38,110,.345,117,139,.842,33,54,87,46,42,6,86,70,497
3167,Jamal Shuler,SR,2007-08,G,Virginia Commonwealth,CAA,32,1058,172,391,.440,94,202,78,189,.413,75,94,.798,26,123,149,40,48,8,49,56,497
3168,Khyri Thomas,JR,2017-18,G,Creighton,Big East,33,1046,184,342,.538,122,191,62,151,.411,67,85,.788,35,109,144,92,56,8,59,62,497
3169,Kemba Walker,SO,2009-10,G,Connecticut,Big East,34,1197,152,377,.403,114,265,38,112,.339,155,202,.767,32,113,145,172,70,15,99,59,497
3170,Russell Westbrook,SO,2007-08,G,UCLA,Pac-10,39,1318,182,391,.465,156,314,26,77,.338,107,150,.713,61,92,153,167,63,7,96,93,497
3171,Marcus Williams,SO,2006-07,F,Arizona,Pac-10,30,987,196,397,.494,173,317,23,80,.288,82,118,.695,63,137,200,67,33,23,80,66,497
3172,Martin Zeno,SR,2007-08,G,Texas Tech,Big 12,31,1062,166,351,.473,161,322,5,29,.172,160,212,.755,31,109,140,91,43,17,87,56,497
3173,Devon Baker,SR,2010-11,G,Northwestern State,Southland,32,875,145,358,.405,78,196,67,162,.414,139,178,.781,24,53,77,65,47,0,70,76,496
3176,Jarrell Brantley,SO,2016-17,F,College of Charleston,CAA,35,1120,170,370,.459,139,286,31,84,.369,125,165,.758,61,233,294,43,39,24,90,102,496
3177,Vladimir Brodziansky,SR,2017-18,F,Texas Christian,Big 12,33,897,179,309,.579,158,247,21,62,.339,117,143,.818,68,99,167,38,10,55,41,72,496
3178,Jawan Carter,SR,2010-11,G,Delaware,CAA,31,1105,134,351,.382,50,130,84,221,.380,144,170,.847,19,95,114,74,27,1,65,75,496
3179,DeAndre Daniels,JR,2013-14,F,Connecticut,AAC,38,1103,188,401,.469,138,281,50,120,.417,70,89,.787,55,173,228,17,26,54,56,90,496
3180,Keron DeShields,SR,2015-16,G,Tennessee State,OVC,30,983,166,383,.433,118,250,48,133,.361,116,156,.744,10,88,98,91,39,5,63,74,496
3181,Gary Flowers,JR,2009-10,F,Southern Mississippi,CUSA,33,1034,203,437,.465,178,361,25,76,.329,65,98,.663,83,190,273,45,26,60,81,92,496
3182,Rashid Gaston,JR,2014-15,F,Norfolk State,MEAC,32,983,204,326,.626,204,326,0,0,,88,162,.543,106,200,306,45,8,37,66,89,496
3183,Daniel Gibson,SO,2005-06,G,Texas,Big 12,37,1228,163,402,.405,62,136,101,266,.380,69,95,.726,42,91,133,116,49,12,70,88,496
3184,Kyle Gibson,SO,2007-08,G,Louisiana Tech,WAC,30,1081,162,386,.420,97,222,65,164,.396,107,144,.743,34,115,149,39,33,9,62,84,496
3185,Marquez Haynes,JR,2008-09,G,Texas-Arlington,Southland,30,966,166,350,.474,130,246,36,104,.346,128,162,.790,47,106,153,103,36,7,94,71,496
3186,Zaid Hearst,JR,2013-14,G,Quinnipiac,MAAC,32,1067,147,334,.440,104,229,43,105,.410,159,192,.828,84,127,211,61,22,12,52,83,496
3187,Jesse Hunt,SR,2018-19,F,Eastern Washington,Big Sky,34,1102,173,355,.487,123,236,50,119,.420,100,133,.752,52,245,297,112,19,22,68,96,496
3188,Ian Johnson,SR,2005-06,F,Davidson,Southern,31,963,199,382,.521,165,302,34,80,.425,64,83,.771,49,148,197,27,10,5,38,68,496
3189,Rob Jones,SR,2011-12,F,Saint Mary's (CA),WCC,33,1110,194,415,.467,160,292,34,123,.276,74,115,.643,106,251,357,75,52,21,73,74,496
3190,Darius Jones-Gibson,SR,2015-16,G,Samford,Southern,33,1078,158,329,.480,142,283,16,46,.348,164,231,.710,15,79,94,114,32,7,101,82,496
3191,Kris Joseph,SR,2011-12,F,Syracuse,Big East,37,1192,164,390,.421,113,242,51,148,.345,117,157,.745,56,118,174,56,50,23,55,62,496
3192,Quinn McDowell,JR,2010-11,G,William & Mary,CAA,32,1078,155,326,.475,85,172,70,154,.455,116,134,.866,25,149,174,67,16,4,47,65,496
3193,Carlos Monroe,SO,2006-07,F,Florida Atlantic,Sun Belt,27,842,200,335,.597,200,335,0,0,,96,160,.600,71,183,254,28,30,5,56,75,496
3194,Zane Najdawi,SO,2016-17,F,The Citadel,Southern,33,791,157,334,.470,129,269,28,65,.431,154,185,.832,93,127,220,26,33,38,73,113,496
3195,Stefan Nastic,SR,2014-15,C,Stanford,Pac-12,37,1098,179,379,.472,179,379,0,0,,138,183,.754,90,149,239,53,13,38,75,137,496
3198,Jacob Parker,JR,2013-14,F,Stephen F. Austin,Southland,35,1010,175,325,.538,152,276,23,49,.469,123,154,.799,86,161,247,70,48,19,42,100,496
3199,J.P. Primm,JR,2010-11,G,North Carolina-Asheville,Big South,34,1125,146,366,.399,91,204,55,162,.340,149,189,.788,28,98,126,154,71,6,104,97,496
3200,Malachi Richardson,FR,2015-16,G,Syracuse,ACC,37,1272,152,412,.369,73,188,79,224,.353,113,157,.720,19,139,158,77,42,10,79,91,496
3201,Steve Santa Ana,SR,2018-19,G,Elon,CAA,31,976,167,363,.460,96,169,71,194,.366,91,129,.705,24,170,194,84,26,4,75,72,496
3202,Josh Slater,SR,2010-11,G,Lipscomb,A-Sun,30,933,151,352,.429,117,234,34,118,.288,160,222,.721,56,127,183,139,93,6,92,86,496
3203,Isaiah Sykes,JR,2012-13,G,Central Florida,CUSA,31,1079,182,398,.457,166,348,16,50,.320,116,188,.617,82,151,233,141,72,14,109,73,496
3204,Isaiah Taylor,JR,2015-16,G,Texas,Big 12,33,1019,159,379,.420,140,318,19,61,.311,159,196,.811,14,78,92,164,29,7,61,88,496
3205,Jarvis Varnado,SR,2009-10,F,Mississippi State,SEC,36,1141,184,316,.582,184,316,0,0,,128,210,.610,107,262,369,32,24,170,71,88,496
3206,Josiah Wallace,SO,2018-19,G,Eastern Illinois,OVC,32,1045,173,421,.411,112,248,61,173,.353,89,111,.802,20,105,125,92,25,7,80,48,496
3207,Johnathan Williams,SR,2017-18,F,Gonzaga,WCC,37,1079,197,350,.563,189,315,8,35,.229,94,174,.540,87,226,313,59,27,40,80,98,496
3208,Jay Youngblood,SR,2005-06,G,Kent State,MAC,34,1113,181,402,.450,136,269,45,133,.338,89,122,.730,39,82,121,75,44,22,63,77,496
3209,Charles Bassey,FR,2018-19,C,Western Kentucky,CUSA,34,1067,188,300,.627,179,280,9,20,.450,110,143,.769,99,241,340,24,27,81,97,88,495
3210,Devonte Brown,SR,2015-16,G,Indiana State,MVC,32,1051,138,372,.371,116,277,22,95,.232,197,260,.758,32,123,155,88,31,9,110,77,495
3211,Eli Carter,SR,2015-16,G,Boston College,ACC,31,1034,174,469,.371,110,240,64,229,.279,83,106,.783,11,110,121,125,37,7,107,59,495
3212,Wes Eikmeier,JR,2011-12,G,Colorado State,MWC,32,1046,166,412,.403,111,263,55,149,.369,108,123,.878,4,55,59,65,25,2,68,67,495
3213,Ryan Evanochko,SR,2006-07,G,Green Bay,Horizon,33,1207,161,416,.387,131,329,30,87,.345,143,184,.777,25,79,104,173,31,1,81,54,495
3214,Tarkus Ferguson,JR,2018-19,G,Illinois-Chicago,Horizon,32,1168,163,398,.410,63,126,100,272,.368,69,92,.750,14,202,216,166,47,26,103,72,495
3215,Jerome Garrison,JR,2013-14,G,Grand Canyon,WAC,30,1134,128,306,.418,76,176,52,130,.400,187,236,.792,18,66,84,64,14,10,60,75,495
3216,Chad Gray,SR,2010-11,F,Coastal Carolina,Big South,34,983,200,403,.496,182,344,18,59,.305,77,119,.647,87,128,215,47,34,42,67,75,495
3217,P.J. Hairston,SO,2012-13,G,North Carolina,ACC,34,804,159,369,.431,70,144,89,225,.396,88,113,.779,65,82,147,46,43,14,39,64,495
3220,Tim Hardaway,SO,2011-12,G,Michigan,Big Ten,34,1162,167,400,.418,114,213,53,187,.283,108,151,.715,26,104,130,73,16,11,66,71,495
3221,Elias Harris,SR,2012-13,F,Gonzaga,WCC,34,944,169,337,.501,161,290,8,47,.170,149,194,.768,69,184,253,53,40,19,60,67,495
3222,Andre Heard,SR,2005-06,G,Binghamton,AEC,29,1041,175,453,.386,128,294,47,159,.296,98,127,.772,45,94,139,49,56,12,60,88,495
3223,Deion Holmes,JR,2017-18,G,South Carolina Upstate,A-Sun,32,848,186,397,.469,134,244,52,153,.340,71,92,.772,48,71,119,42,16,3,85,58,495
3224,Travis Holmes,SO,2006-07,F,Virginia Military Institute,Big South,33,806,173,404,.428,102,209,71,195,.364,78,114,.684,78,85,163,107,111,19,74,85,495
3225,Zak Irvin,SR,2016-17,G,Michigan,Big Ten,38,1345,195,430,.453,141,273,54,157,.344,51,76,.671,23,149,172,113,34,2,71,46,495
3226,Christian James,SR,2018-19,G,Oklahoma,Big 12,34,1124,172,418,.411,103,219,69,199,.347,82,107,.766,38,172,210,63,40,7,63,65,495
3227,Alize Johnson,SR,2017-18,F,Missouri State,MVC,33,1028,172,400,.430,131,254,41,146,.281,110,145,.759,104,280,384,94,15,14,74,69,495
3228,Donte McGill,SR,2016-17,G,Florida International,CUSA,27,912,182,413,.441,156,334,26,79,.329,105,113,.929,50,46,96,30,37,3,58,65,495
3229,James Nunnally,SR,2011-12,F,UC-Santa Barbara,Big West,31,1044,180,383,.470,123,229,57,154,.370,78,98,.796,33,151,184,86,21,8,77,62,495
3230,Clifford Reed,FR,2008-09,G,Bethune-Cookman,MEAC,33,1224,163,466,.350,110,278,53,188,.282,116,161,.720,15,87,102,129,39,2,114,64,495
3231,Brian Roberts,SO,2005-06,G,Dayton,A-10,31,1034,175,419,.418,107,253,68,166,.410,77,97,.794,12,96,108,107,15,2,75,55,495
3232,Zack Rosen,SO,2009-10,G,Pennsylvania,Ivy,28,1039,140,319,.439,69,152,71,167,.425,144,167,.862,21,71,92,124,32,0,92,78,495
3233,Malik Story,JR,2011-12,G,Nevada,WAC,35,1087,166,384,.432,72,158,94,226,.416,69,95,.726,10,87,97,80,25,9,69,63,495
3234,Mike Taylor,JR,2006-07,G,Iowa State,Big 12,31,1086,165,439,.376,88,225,77,214,.360,88,129,.682,22,104,126,140,35,3,168,89,495
3235,Micah Williams,SR,2010-11,G,East Tennessee State,A-Sun,35,1208,166,399,.416,107,238,59,161,.366,104,140,.743,39,105,144,44,33,8,63,67,495
3236,Bam Adebayo,FR,2016-17,F,Kentucky,SEC,38,1145,170,284,.599,170,284,0,0,,154,236,.653,118,186,304,32,26,57,64,99,494
3237,Corey Brewer,SO,2005-06,F,Florida,SEC,39,1095,171,365,.468,129,245,42,120,.350,110,143,.769,51,135,186,128,61,16,108,97,494
3238,Armoni Brooks,JR,2018-19,G,Houston,AAC,37,1135,172,425,.405,51,115,121,310,.390,29,46,.630,40,194,234,32,28,11,32,61,494
3239,Jamaal Brown,SR,2005-06,F,Cal State Fullerton,Big West,29,992,193,377,.512,180,340,13,37,.351,95,132,.720,64,177,241,58,29,7,80,69,494
3240,James Carlton,SR,2014-15,G,Howard,MEAC,31,980,181,384,.471,161,305,20,79,.253,112,148,.757,59,183,242,31,31,32,84,87,494
3241,Shannon Evans,JR,2016-17,G,Arizona State,Pac-12,33,1179,161,392,.411,89,191,72,201,.358,100,120,.833,17,93,110,144,42,7,62,61,494
3242,Asante Gist,FR,2016-17,G,Eastern Kentucky,OVC,31,986,158,422,.374,94,233,64,189,.339,114,155,.735,10,69,79,118,29,1,105,96,494
3243,A.J. Hammons,SR,2015-16,C,Purdue,Big Ten,33,813,199,336,.592,193,325,6,11,.545,90,127,.709,77,193,270,37,9,84,65,78,494
3244,Sam Hauser,SO,2017-18,F,Marquette,Big East,35,1141,174,349,.499,79,154,95,195,.487,51,61,.836,35,165,200,100,35,16,42,73,494
3245,Abdulai Jalloh,SO,2005-06,G,Saint Joseph's,A-10,33,998,132,352,.375,81,203,51,149,.342,179,213,.840,40,142,182,85,41,9,91,111,494
3246,Christian Keeling,SO,2017-18,G,Charleston Southern,Big South,28,941,169,397,.426,124,254,45,143,.315,111,140,.793,22,123,145,57,37,12,67,69,494
3247,Marcelus Kemp,SO,2005-06,G,Nevada,WAC,33,859,178,385,.462,126,240,52,145,.359,86,101,.851,26,81,107,44,15,8,60,63,494
3248,Carl Krauser,SR,2005-06,G,Pittsburgh,Big East,33,1054,157,391,.402,90,209,67,182,.368,113,155,.729,26,115,141,160,53,0,103,92,494
3249,Ron Lewis,SR,2006-07,G,Ohio State,Big Ten,39,1124,152,356,.427,88,170,64,186,.344,126,162,.778,29,111,140,50,37,13,63,48,494
3250,Frantz Massenat,SO,2011-12,G,Drexel,CAA,36,1287,147,343,.429,93,223,54,120,.450,146,187,.781,17,95,112,173,32,13,77,84,494
3251,Tony Murphy,JR,2006-07,G,Norfolk State,MEAC,30,1052,170,418,.407,91,211,79,207,.382,75,96,.781,24,90,114,43,29,4,86,33,494
3252,DeMarcus Nelson,SR,2007-08,G,Duke,ACC,34,1051,172,351,.490,132,248,40,103,.388,110,183,.601,49,148,197,100,53,11,84,77,494
3253,B.J. Raymond,SR,2008-09,F,Xavier,A-10,35,1060,167,365,.458,83,160,84,205,.410,76,94,.809,18,127,145,50,18,12,55,69,494
3254,Stanley Robinson,SR,2009-10,F,Connecticut,Big East,34,1163,203,387,.525,176,308,27,79,.342,61,97,.629,91,169,260,34,30,41,77,52,494
3255,Romone Saunders ,SR,2018-19,G,Wagner,NEC,30,1038,143,386,.370,79,187,64,199,.322,144,171,.842,65,152,217,109,46,8,83,88,494
3256,Tyler Seibring,JR,2017-18,F,Elon,CAA,32,1090,183,373,.491,101,182,82,191,.429,46,65,.708,48,168,216,70,9,21,35,49,494
3257,Marcus Slaughter,JR,2005-06,F,San Diego State,MWC,30,982,151,308,.490,151,307,0,1,.000,192,252,.762,124,205,329,56,36,31,86,94,494
3258,Nick Stallings,JR,2007-08,G,Centenary (LA),Summit,31,1067,170,399,.426,134,306,36,93,.387,118,155,.761,,,151,75,45,12,81,,494
3259,Jonathan Stark,FR,2013-14,G,Tulane,CUSA,34,1264,160,384,.417,115,266,45,118,.381,129,173,.746,12,77,89,143,29,1,84,64,494
3262,Justin Strings,JR,2016-17,F,Sacramento State,Big Sky,31,1021,179,424,.422,124,267,55,157,.350,81,133,.609,37,133,170,32,12,11,47,69,494
3263,Jameel Warney,SO,2013-14,F,Stony Brook,AEC,34,1001,204,331,.616,204,331,0,0,,86,142,.606,97,176,273,66,25,42,43,75,494
3264,Jamel Waters,SR,2015-16,G,Alabama State,SWAC,31,1057,160,390,.410,84,206,76,184,.413,98,134,.731,32,102,134,134,54,2,81,65,494
3265,Antwaine Wiggins,SR,2011-12,F,College of Charleston,Southern,31,1082,176,401,.439,116,233,60,168,.357,82,142,.577,78,122,200,67,35,14,73,44,494
3266,Ruben Boykin,SR,2006-07,F,Northern Arizona,Big Sky,30,955,182,353,.516,163,309,19,44,.432,110,143,.769,74,194,268,93,23,16,74,82,493
3267,Kyle Cain,JR,2013-14,F,North Carolina-Greensboro,Southern,32,973,201,422,.476,192,391,9,31,.290,82,115,.713,77,208,285,37,22,11,64,72,493
3268,Daniel Emerson,SR,2009-10,F,Mercer,A-Sun,32,1090,162,298,.544,148,265,14,33,.424,155,210,.738,127,258,385,45,25,5,89,64,493
3269,Brandon Fields,SR,2009-10,G,Nevada,WAC,34,1150,174,404,.431,110,212,64,192,.333,81,131,.618,15,117,132,83,33,10,56,42,493
3270,Donovan Fields,SR,2018-19,G,Cal Poly,Big West,29,978,189,476,.397,149,345,40,131,.305,75,90,.833,17,55,72,118,41,10,66,70,493
3271,Keith Gabriel,SO,2009-10,G,Virginia Military Institute,Big South,28,722,165,404,.408,81,142,84,262,.321,79,115,.687,27,71,98,35,55,23,50,68,493
3272,Seth Hinrichs,SO,2012-13,G,Lafayette,Patriot,34,974,159,345,.461,81,174,78,171,.456,97,126,.770,47,119,166,60,21,5,61,49,493
3273,Tony Hooper,SO,2006-07,G,Louisiana-Monroe,Sun Belt,32,995,169,421,.401,93,199,76,222,.342,79,107,.738,28,94,122,86,53,6,101,101,493
3274,Othyus Jeffers,JR,2006-07,F,Illinois-Chicago,Horizon,32,1055,179,382,.469,177,370,2,12,.167,133,200,.665,102,174,276,82,53,7,92,83,493
3275,Brent Jones,SR,2014-15,G,St. Francis (NY),NEC,35,1188,157,396,.396,107,244,50,152,.329,129,167,.772,28,91,119,184,66,3,120,68,493
3276,Derrick Low,SR,2007-08,G,Washington State,Pac-10,35,1164,166,384,.432,74,145,92,239,.385,69,88,.784,8,54,62,55,50,3,43,60,493
3277,Myles Mack,JR,2013-14,G,Rutgers,AAC,33,1008,156,387,.403,86,198,70,189,.370,111,124,.895,19,71,90,142,54,6,87,70,493
3278,Denzel Mahoney,FR,2016-17,G,Southeast Missouri State,OVC,33,976,152,339,.448,95,188,57,151,.377,132,162,.815,47,93,140,40,23,4,45,106,493
3279,Julian Mavunga,SR,2011-12,F,Miami (OH),MAC,30,1107,150,340,.441,125,258,25,82,.305,168,229,.734,66,204,270,101,27,17,120,73,493
3280,JayQuan McCloud,JR,2018-19,G,Green Bay,Horizon,36,978,166,373,.445,89,177,77,196,.393,84,101,.832,21,77,98,82,26,12,59,76,493
3281,Nic Moore,JR,2014-15,G,Southern Methodist,AAC,34,1179,156,371,.420,79,186,77,185,.416,104,117,.889,8,70,78,175,43,1,87,64,493
3284,Vince Oliver,SR,2008-09,G,UC-Davis,Big West,32,1048,177,367,.482,134,243,43,124,.347,96,118,.814,23,76,99,85,30,2,84,63,493
3285,Richaud Pack,SR,2013-14,G,North Carolina A&T,MEAC,29,992,128,290,.441,76,154,52,136,.382,185,230,.804,44,88,132,46,19,2,50,59,493
3286,Carson Puriefoy,SR,2015-16,G,Stony Brook,AEC,33,1113,156,400,.390,73,191,83,209,.397,98,126,.778,21,85,106,103,40,13,81,75,493
3287,Mykal Riley,SR,2007-08,F,Alabama,SEC,33,1039,168,375,.448,65,137,103,238,.433,54,72,.750,46,124,170,58,54,19,58,68,493
3288,Justin Roberson,SR,2015-16,G,Louisiana-Monroe,Sun Belt,34,1128,182,384,.474,140,283,42,101,.416,87,127,.685,28,131,159,93,57,4,75,109,493
3289,Quinton Rose,SO,2017-18,G,Temple,AAC,33,1064,190,438,.434,141,296,49,142,.345,64,98,.653,24,118,142,75,49,6,80,56,493
3290,Omar Samhan,JR,2008-09,C,Saint Mary's (CA),WCC,35,1036,197,353,.558,197,352,0,1,.000,99,136,.728,134,194,328,57,14,69,64,98,493
3291,Brenton Scott,JR,2016-17,G,Indiana State,MVC,31,980,165,441,.374,92,235,73,206,.354,90,132,.682,10,141,151,74,50,5,57,63,493
3292,Josh Scott,SO,2013-14,F,Colorado,Pac-12,35,1107,159,311,.511,159,309,0,2,.000,175,216,.810,102,193,295,22,28,40,51,63,493
3293,Xavier Silas,JR,2009-10,G,Northern Illinois,MAC,25,789,141,369,.382,89,207,52,162,.321,159,196,.811,37,95,132,41,20,12,60,81,493
3294,Tony Tate,SR,2005-06,G,Florida A&M,MEAC,30,1023,149,359,.415,92,207,57,152,.375,138,167,.826,31,64,95,93,73,0,106,67,493
3295,Trey Thompkins,JR,2010-11,F,Georgia,SEC,30,937,194,403,.481,171,329,23,74,.311,82,119,.689,56,173,229,42,33,50,76,67,493
3296,Andre Walker,JR,2016-17,G,Loyola (MD),Patriot,33,1075,152,431,.353,70,215,82,216,.380,107,124,.863,19,99,118,128,50,10,110,88,493
3297,James Woodard,JR,2014-15,G,Tulsa,AAC,34,1174,158,388,.407,70,150,88,238,.370,89,126,.706,18,149,167,38,30,8,46,55,493
3298,Grayson Allen,JR,2016-17,G,Duke,ACC,34,1007,141,357,.395,60,135,81,222,.365,129,159,.811,23,104,127,119,26,2,74,78,492
3299,Darian Anderson,JR,2016-17,G,Fairleigh Dickinson,NEC,29,971,165,396,.417,108,241,57,155,.368,105,128,.820,21,89,110,94,58,7,61,75,492
3300,Aaron Broussard,SR,2011-12,F,Seattle,Ind,27,789,184,394,.467,149,287,35,107,.327,89,124,.718,77,99,176,27,43,2,48,62,492
3301,Robert Brown,JR,2014-15,G,Alabama-Birmingham,CUSA,36,1165,176,438,.402,115,251,61,187,.326,79,107,.738,29,103,132,109,37,9,75,62,492
3302,Norris Cole,SO,2008-09,G,Cleveland State,Horizon,37,1213,187,413,.453,147,282,40,131,.305,78,97,.804,38,56,94,90,44,5,56,87,492
3303,Vincent Council,JR,2011-12,G,Providence,Big East,31,1200,184,471,.391,155,372,29,99,.293,95,141,.674,30,96,126,231,39,11,109,75,492
3306,Daviyon Draper,SR,2015-16,F,Florida International,CUSA,31,1089,195,430,.453,162,346,33,84,.393,69,98,.704,44,173,217,68,31,20,85,76,492
3307,Marc Egerson,SR,2008-09,G,Delaware,CAA,32,1165,153,380,.403,96,231,57,149,.383,129,174,.741,57,274,331,84,44,6,93,70,492
3308,Evan Fisher,SR,2018-19,F,Siena,MAAC,31,1032,205,420,.488,190,355,15,65,.231,67,93,.720,34,151,185,46,6,15,52,49,492
3309,Jeremy Goode,JR,2008-09,G,Mount St. Mary's,NEC,33,1140,166,403,.412,121,282,45,121,.372,115,179,.642,34,70,104,134,62,1,78,54,492
3310,Vince Hunter,SO,2014-15,F,Texas-El Paso,CUSA,33,940,182,346,.526,178,336,4,10,.400,124,207,.599,88,217,305,55,41,34,92,98,492
3311,Ibrahim Jaaber,SR,2006-07,G,Pennsylvania,Ivy,31,1144,187,361,.518,154,249,33,112,.295,85,129,.659,52,86,138,160,90,17,91,69,492
3312,Cory Jefferson,JR,2012-13,F,Baylor,Big 12,37,1032,191,313,.610,188,304,3,9,.333,107,152,.704,99,196,295,11,17,71,30,85,492
3313,Brice Johnson,JR,2014-15,F,North Carolina,ACC,38,940,207,366,.566,207,366,0,0,,78,115,.678,89,206,295,35,26,42,58,112,492
3314,Ravern Johnson,SR,2010-11,G,Mississippi State,SEC,28,978,162,377,.430,79,171,83,206,.403,85,109,.780,22,78,100,21,12,15,36,28,492
3315,John Konchar,SO,2016-17,G,Purdue-Fort Wayne,Summit,33,1153,188,295,.637,143,208,45,87,.517,71,103,.689,79,209,288,126,55,15,51,61,492
3316,Cameron Morse,SR,2017-18,G,Youngstown State,Horizon,32,1024,174,466,.373,95,229,79,237,.333,65,83,.783,11,62,73,124,35,6,65,45,492
3317,Arnett Moultrie,JR,2011-12,F,Mississippi State,SEC,30,1073,180,328,.549,172,310,8,18,.444,124,159,.780,110,204,314,35,25,23,73,67,492
3318,Deondre Parks,JR,2014-15,G,South Dakota State,Summit,35,1113,167,391,.427,98,201,69,190,.363,89,118,.754,17,125,142,67,22,3,62,85,492
3319,Deondre Parks,SR,2015-16,G,South Dakota State,Summit,33,1069,164,388,.423,113,238,51,150,.340,113,139,.813,25,127,152,50,26,7,56,74,492
3320,Payton Pritchard,JR,2018-19,G,Oregon,Pac-12,38,1349,167,400,.418,102,202,65,198,.328,93,111,.838,33,114,147,175,68,3,75,83,492
3321,Jason Rich,SR,2007-08,G,Florida State,ACC,34,1155,183,410,.446,152,321,31,89,.348,95,123,.772,39,109,148,69,39,9,96,97,492
3322,Mike Schachtner,SO,2006-07,F,Green Bay,Horizon,33,1043,168,341,.493,116,227,52,114,.456,104,114,.912,41,90,131,20,17,6,48,71,492
3323,Jaaron Simmons,JR,2016-17,G,Ohio,MAC,31,1116,176,406,.433,139,299,37,107,.346,103,142,.725,14,96,110,200,29,2,123,72,492
3324,Justin Turner,FR,2017-18,G,Bowling Green State,MAC,31,1051,169,416,.406,119,284,50,132,.379,104,128,.813,26,87,113,81,47,9,74,56,492
3325,Michael Van Schaick,SR,2006-07,G,Fairfield,MAAC,32,1116,154,344,.448,66,122,88,222,.396,96,112,.857,51,75,126,63,38,7,48,58,492
3328,Maurice Watson,JR,2015-16,G,Creighton,Big East,35,1100,179,377,.475,160,313,19,64,.297,115,161,.714,21,97,118,228,34,1,115,89,492
3329,Justise Winslow,FR,2014-15,F,Duke,ACC,39,1135,173,356,.486,127,246,46,110,.418,100,156,.641,49,203,252,82,52,34,71,108,492
3330,Jeff Adrien,SR,2008-09,F,Connecticut,Big East,36,1245,190,376,.505,190,375,0,1,.000,111,186,.597,115,243,358,60,19,42,65,72,491
3331,Al-Farouq Aminu,SO,2009-10,F,Wake Forest,ACC,31,970,167,374,.447,149,308,18,66,.273,139,199,.698,133,199,332,41,44,44,99,91,491
3332,Darion Anderson,SO,2008-09,G,Northern Illinois,MAC,29,914,159,383,.415,113,259,46,124,.371,127,189,.672,36,121,157,70,46,4,92,70,491
3333,Ron Baker,SR,2015-16,G,Wichita State,MVC,35,1106,160,377,.424,96,194,64,183,.350,107,135,.793,19,149,168,113,53,21,54,50,491
3334,James Bell,SR,2013-14,G,Villanova,Big East,34,1004,159,373,.426,74,144,85,229,.371,88,108,.815,52,154,206,55,44,21,59,104,491
3335,Tristan Blackwood,SR,2007-08,G,Central Connecticut State,NEC,30,1078,158,390,.405,53,106,105,284,.370,70,81,.864,23,58,81,155,36,3,107,57,491
3336,Trevor Booker,JR,2008-09,F,Clemson,ACC,32,982,189,331,.571,180,309,9,22,.409,104,147,.707,107,204,311,54,47,63,59,54,491
3337,Al'lonzo Coleman,SR,2011-12,C,Presbyterian,Big South,29,883,163,302,.540,161,291,2,11,.182,163,249,.655,77,177,254,51,33,13,85,95,491
3338,Ryan Evanochko,JR,2005-06,G,Green Bay,Horizon,31,1130,170,382,.445,140,296,30,86,.349,121,155,.781,24,85,109,160,23,6,84,57,491
3339,Dwayne Evans,JR,2012-13,F,Saint Louis,A-10,35,1036,170,311,.547,165,292,5,19,.263,146,190,.768,84,186,270,37,44,25,62,92,491
3340,LJ Figueroa,SO,2018-19,G,St. John's (NY),Big East,34,1087,199,388,.513,148,255,51,133,.383,42,67,.627,52,164,216,57,61,7,45,85,491
3341,Chris Flores,SR,2012-13,G,NJIT,GWC,29,966,159,408,.390,89,207,70,201,.348,103,135,.763,26,88,114,83,69,7,82,72,491
3342,Nick George,SR,2005-06,F,Virginia Commonwealth,CAA,29,857,167,357,.468,115,246,52,111,.468,105,147,.714,44,103,147,37,37,4,86,38,491
3343,Tyrone Hamilton,SO,2006-07,G,Centenary (LA),Mid-Cont,31,1024,159,422,.377,92,231,67,191,.351,106,133,.797,,,92,103,33,3,,,491
3344,Deontae Hawkins,SR,2016-17,F,Illinois State,MVC,35,956,186,396,.470,116,238,70,158,.443,49,63,.778,60,168,228,40,26,25,50,93,491
3345,Connor Hill,SR,2014-15,G,Idaho,Big Sky,30,921,164,365,.449,56,125,108,240,.450,55,65,.846,15,53,68,20,15,0,30,56,491
3346,Brad Loesing,SR,2011-12,G,Wofford,Southern,33,1265,170,410,.415,117,247,53,163,.325,98,123,.797,12,86,98,184,36,3,114,92,491
3347,Mike Moore,JR,2010-11,G,Hofstra,CAA,33,1106,157,386,.407,95,211,62,175,.354,115,135,.852,38,141,179,73,32,6,56,76,491
3348,Kevin Murphy,SO,2009-10,G,Tennessee Tech,OVC,32,1003,170,385,.442,133,264,37,121,.306,114,151,.755,37,88,125,66,23,4,90,75,491
3349,Emmett Naar,SO,2015-16,G,Saint Mary's (CA),WCC,35,1301,171,351,.487,115,217,56,134,.418,93,107,.869,22,106,128,222,45,5,80,45,491
3350,Andrew Nicholson,SO,2009-10,F,St. Bonaventure,A-10,30,907,198,351,.564,198,351,0,0,,95,125,.760,72,141,213,15,6,55,55,90,491
3351,Victor Oladipo,JR,2012-13,G,Indiana,Big Ten,36,1021,182,304,.599,152,236,30,68,.441,97,130,.746,93,134,227,74,78,28,83,89,491
3352,Davon Reed,SR,2016-17,G,Miami (FL),ACC,33,1165,161,372,.433,82,173,79,199,.397,90,108,.833,28,130,158,79,43,16,67,52,491
3353,Kevin Rogers,SR,2008-09,F,Baylor,Big 12,39,1285,200,358,.559,200,356,0,2,.000,91,145,.628,98,198,296,42,31,31,87,98,491
3354,Earnest Ross,SR,2013-14,G,Missouri,SEC,35,1116,141,343,.411,84,160,57,183,.311,152,196,.776,42,169,211,49,46,13,66,69,491
3355,Dustin Salisbery,SR,2006-07,G,Temple,A-10,30,994,169,398,.425,113,240,56,158,.354,97,143,.678,36,115,151,73,48,11,88,104,491
3356,JaKarr Sampson,FR,2012-13,F,St. John's (NY),Big East,33,1040,202,450,.449,202,442,0,8,.000,87,136,.640,72,146,218,35,36,36,66,91,491
3357,Lavelle Scottie,JR,2018-19,F,Air Force,MWC,32,1005,202,415,.487,169,304,33,111,.297,54,89,.607,42,136,178,42,23,8,96,66,491
3358,Nate Sestina,SR,2018-19,F,Bucknell,Patriot,31,861,185,345,.536,144,237,41,108,.380,80,99,.808,61,201,262,37,11,33,66,89,491
3359,Ben Smith,SO,2007-08,G,Jacksonville,A-Sun,31,1126,127,326,.390,80,199,47,127,.370,190,224,.848,31,83,114,143,56,4,91,49,491
3360,Quinton Upshur,JR,2013-14,G,Northern Arizona,Big Sky,32,942,158,357,.443,85,166,73,191,.382,102,142,.718,11,94,105,27,52,21,61,83,491
3361,Glynn Watson,SR,2018-19,G,Nebraska,Big Ten,36,1241,178,430,.414,96,216,82,214,.383,53,67,.791,16,132,148,112,40,4,51,89,491
3362,Kyle Weems,SO,2009-10,F,Missouri State,MVC,36,1037,180,379,.475,108,202,72,177,.407,59,76,.776,39,184,223,65,49,37,38,108,491
3363,Davis Baker,SR,2009-10,G,Southern Utah,Summit,29,984,175,380,.461,146,298,29,82,.354,111,130,.854,25,131,156,27,27,6,74,54,490
3364,Levi Bradley,SR,2018-19,F,Northern Illinois,MAC,34,994,185,374,.495,155,291,30,83,.361,90,109,.826,51,127,178,44,22,9,50,89,490
3365,Corey Brewer,JR,2006-07,F,Florida,SEC,37,1053,169,356,.475,129,237,40,119,.336,112,155,.723,40,133,173,109,69,15,93,72,490
3366,Elijah Brown,JR,2017-18,G,Oregon,Pac-12,36,1050,159,382,.416,67,129,92,253,.364,80,86,.930,26,94,120,90,27,1,67,66,490
3367,Jordan Burns,SO,2018-19,G,Colgate,Patriot,30,987,167,381,.438,89,183,78,198,.394,78,95,.821,13,78,91,171,36,3,94,51,490
3370,Nik Caner-Medley,SR,2005-06,F,Maryland,ACC,32,1036,166,365,.455,139,289,27,76,.355,131,159,.824,72,128,200,68,39,16,74,59,490
3371,C.J. Carter,SR,2014-15,G,Omaha,Summit,29,995,176,388,.454,128,239,48,149,.322,90,127,.709,13,54,67,78,43,19,85,70,490
3372,Ja'Vance Coleman,JR,2005-06,G,Fresno State,WAC,28,913,152,395,.385,57,148,95,247,.385,91,114,.798,16,64,80,61,26,8,68,59,490
3373,Larry Cunningham,SR,2007-08,G,UC-Riverside,Big West,30,890,162,402,.403,109,238,53,164,.323,113,137,.825,4,86,90,42,44,9,78,61,490
3374,Jason Dunne,JR,2017-18,G,Hartford,AEC,33,1172,169,406,.416,71,132,98,274,.358,54,72,.750,17,106,123,92,42,8,74,76,490
3375,Grayson Flittner,SO,2007-08,G,Gardner-Webb,A-Sun,32,1037,146,360,.406,39,94,107,266,.402,91,112,.813,23,68,91,120,34,2,65,67,490
3376,Darrion Griffin,SR,2008-09,G,Jackson State,SWAC,33,978,159,320,.497,143,260,16,60,.267,156,213,.732,67,121,188,94,45,5,79,69,490
3377,LaDontae Henton,JR,2013-14,F,Providence,Big East,35,1299,168,377,.446,120,243,48,134,.358,106,142,.746,86,190,276,59,46,20,55,83,490
3378,Anthony Hill,SR,2010-11,F,Milwaukee,Horizon,32,900,172,325,.529,171,321,1,4,.250,145,205,.707,90,122,212,46,14,19,77,108,490
3379,Taveion Hollingsworth,SO,2018-19,G,Western Kentucky,CUSA,34,1251,175,419,.418,126,265,49,154,.318,91,118,.771,35,115,150,76,41,8,72,49,490
3380,Joe Jackson,JR,2012-13,G,Memphis,CUSA,36,1175,168,324,.519,130,239,38,85,.447,116,159,.730,17,103,120,173,60,7,102,73,490
3381,Curtis Jerrells,JR,2007-08,G,Baylor,Big 12,32,997,165,387,.426,110,222,55,165,.333,105,140,.750,20,91,111,121,42,6,68,58,490
3382,Anthony Johnson,JR,2015-16,G,Northern Colorado,Big Sky,31,896,157,353,.445,91,184,66,169,.391,110,128,.859,38,104,142,26,22,8,61,74,490
3383,James Kinney,JR,2011-12,G,San Jose State,WAC,31,963,170,420,.405,84,204,86,216,.398,64,75,.853,24,88,112,85,40,5,92,60,490
3384,Tyler Kohl,SR,2018-19,G,Central Connecticut State,NEC,27,925,155,393,.394,114,269,41,124,.331,139,164,.848,45,143,188,123,38,1,100,63,490
3385,John Konchar,JR,2017-18,G,Purdue-Fort Wayne,Summit,33,1180,177,367,.482,111,195,66,172,.384,70,108,.648,66,201,267,156,81,23,54,61,490
3386,Kyle Lofton,FR,2018-19,G,St. Bonaventure,A-10,34,1272,177,401,.441,139,286,38,115,.330,98,117,.838,30,55,85,127,48,2,64,72,490
3387,Marc Loving,JR,2015-16,F,Ohio State,Big Ten,35,1189,152,367,.414,96,202,56,165,.339,130,172,.756,43,141,184,54,22,14,82,59,490
3388,Kalin Lucas,JR,2009-10,G,Michigan State,Big Ten,33,1027,165,364,.453,130,265,35,99,.354,125,162,.772,22,40,62,131,40,2,80,49,490
3389,LeAntwan Luckett,JR,2014-15,F,Alcorn State,SWAC,30,1031,158,424,.373,111,272,47,152,.309,127,181,.702,52,51,103,52,40,13,68,86,490
3392,Troyce Manassa,SR,2016-17,G,Savannah State,MEAC,29,798,161,363,.444,97,182,64,181,.354,104,145,.717,37,111,148,84,30,7,62,73,490
3393,Davon Marshall,JR,2012-13,G,Liberty,Big South,36,1158,154,346,.445,47,98,107,248,.431,75,88,.852,9,66,75,101,27,2,73,42,490
3394,Mike Moser,SO,2011-12,F,Nevada-Las Vegas,MWC,35,1098,184,409,.450,140,276,44,133,.331,78,100,.780,92,277,369,80,68,35,102,95,490
3395,Emmanuel Omogbo,SR,2016-17,F,Colorado State,MWC,36,1095,171,355,.482,140,266,31,89,.348,117,176,.665,101,272,373,62,38,23,69,98,490
3396,Durand Scott,SO,2010-11,G,Miami (FL),ACC,36,1182,162,364,.445,135,295,27,69,.391,139,166,.837,42,110,152,112,43,4,100,93,490
3397,TJ Shorts,JR,2017-18,G,UC-Davis,Big West,33,1043,161,309,.521,151,280,10,29,.345,158,212,.745,12,111,123,146,63,8,81,69,490
3398,James Thompson IV,FR,2015-16,,Eastern Michigan,MAC,33,1058,182,282,.645,182,281,0,1,.000,126,184,.685,148,203,351,20,25,47,48,117,490
3399,Lucas Troutman,SR,2013-14,F,Elon,Southern,31,896,185,350,.529,184,349,1,1,1.000,119,168,.708,49,143,192,25,23,58,65,70,490
3400,Okaro White,SR,2013-14,F,Florida State,ACC,36,1084,166,323,.514,142,259,24,64,.375,134,168,.798,75,168,243,34,27,40,68,108,490
3401,Jeff Adrien,JR,2007-08,F,Connecticut,Big East,33,1115,173,345,.501,171,341,2,4,.500,141,229,.616,86,216,302,42,16,41,89,64,489
3402,Manny Atkins,SR,2013-14,F,Georgia State,Sun Belt,34,1136,153,324,.472,78,151,75,173,.434,108,131,.824,31,177,208,48,46,24,43,78,489
3403,Ryan Bathie,SR,2008-09,G,Nicholls State,Southland,31,944,180,362,.497,124,201,56,161,.348,73,94,.777,46,106,152,68,35,12,64,90,489
3404,Ryan Daly,SO,2017-18,G,Delaware,CAA,28,1049,178,413,.431,132,265,46,148,.311,87,137,.635,40,133,173,67,33,3,35,60,489
3405,Sam Dower,SR,2013-14,C,Gonzaga,WCC,34,898,185,324,.571,179,305,6,19,.316,113,137,.825,64,181,245,37,15,24,53,81,489
3406,Malachi Flynn,SO,2017-18,G,Washington State,Pac-12,31,1035,162,392,.413,85,164,77,228,.338,88,104,.846,22,84,106,132,49,2,66,56,489
3407,Andre Hollins,JR,2013-14,G,Minnesota,Big Ten,36,1099,137,363,.377,70,171,67,192,.349,148,176,.841,26,100,126,87,32,3,65,91,489
3408,Nick Honor,FR,2018-19,G,Fordham,A-10,32,1154,174,467,.373,104,256,70,211,.332,71,87,.816,18,58,76,95,28,0,54,60,489
3409,Cody John,JR,2018-19,G,Weber State,Big Sky,33,1049,183,379,.483,143,262,40,117,.342,83,108,.769,10,114,124,71,16,5,63,76,489
3410,Zane Johnson,JR,2010-11,G,Hawaii,WAC,31,1059,157,359,.437,59,118,98,241,.407,77,95,.811,7,90,97,58,17,4,66,83,489
3411,Marcel Jones,JR,2006-07,F,Oregon State,Pac-10,32,1000,196,435,.451,156,302,40,133,.301,57,105,.543,50,131,181,41,49,12,72,68,489
3414,Jalen Jordan,SO,2018-19,G,St. Francis (NY),NEC,33,1033,156,364,.429,67,152,89,212,.420,88,109,.807,15,103,118,48,16,8,54,51,489
3415,Mfiondu Kabengele,SO,2018-19,F,Florida State,ACC,37,798,164,327,.502,140,262,24,65,.369,137,180,.761,79,141,220,11,21,56,48,96,489
3416,Frank Mason,JR,2015-16,G,Kansas,Big 12,38,1272,155,357,.434,112,244,43,113,.381,136,184,.739,27,136,163,175,50,3,73,84,489
3417,Marcel Mosley,SR,2014-15,G,Arkansas-Pine Bluff,SWAC,28,997,145,360,.403,76,179,69,181,.381,130,159,.818,23,58,81,73,58,0,97,53,489
3418,Tyler Smith,SO,2007-08,F,Tennessee,SEC,36,1017,181,338,.536,167,301,14,37,.378,113,160,.706,94,148,242,122,50,20,79,92,489
3419,Michael Snaer,JR,2011-12,G,Florida State,ACC,35,1065,167,383,.436,100,217,67,166,.404,88,104,.846,33,99,132,68,39,13,72,69,489
3420,Michael Snaer,SR,2012-13,G,Florida State,ACC,33,1079,155,365,.425,92,201,63,164,.384,116,142,.817,22,125,147,82,33,15,91,81,489
3421,Hasheem Thabeet,JR,2008-09,C,Connecticut,Big East,36,1145,178,278,.640,178,278,0,0,,133,212,.627,133,255,388,17,22,152,68,90,489
3422,Chris Vann,SR,2007-08,G,Mount St. Mary's,NEC,34,1001,168,394,.426,80,165,88,229,.384,65,78,.833,19,81,100,40,20,0,44,81,489
3423,James Webb,JR,2015-16,F,Boise State,MWC,31,944,177,358,.494,150,249,27,109,.248,108,158,.684,74,209,283,34,44,20,49,94,489
3424,Akwasi Yeboah,SO,2017-18,G,Stony Brook,AEC,32,912,156,345,.452,97,179,59,166,.355,118,147,.803,30,132,162,44,28,7,74,81,489
3425,Tyler Bey,SO,2018-19,G,Colorado,Pac-12,36,948,184,340,.541,179,318,5,22,.227,115,147,.782,77,278,355,23,30,44,71,83,488
3426,Mario Boggan,JR,2005-06,F,Oklahoma State,Big 12,33,909,182,313,.581,173,285,9,28,.321,115,140,.821,80,107,187,33,37,27,72,100,488
3427,Ben Brust,SR,2013-14,G,Wisconsin,Big Ten,38,1318,156,373,.418,60,129,96,244,.393,80,89,.899,31,140,171,50,29,2,27,36,488
3428,Reggie Bullock,JR,2012-13,G,North Carolina,ACC,35,1100,172,356,.483,84,154,88,202,.436,56,73,.767,71,155,226,101,44,10,43,50,488
3429,Marcus Burk,SO,2017-18,G,Campbell,Big South,33,1048,173,353,.490,82,127,91,226,.403,51,60,.850,21,99,120,38,42,8,45,58,488
3430,Jackie Carmichael,JR,2011-12,F,Illinois State,MVC,35,1018,168,315,.533,166,311,2,4,.500,150,210,.714,79,259,338,35,21,50,77,94,488
3431,Charles Cooper,JR,2015-16,G,Green Bay,Horizon,36,962,160,340,.471,152,304,8,36,.222,160,232,.690,59,139,198,53,37,6,75,65,488
3432,Will Cummings,JR,2013-14,G,Temple,AAC,29,998,158,353,.448,126,249,32,104,.308,140,178,.787,30,68,98,132,43,3,65,92,488
3433,Terence Dials,SR,2005-06,F,Ohio State,Big Ten,32,974,194,347,.559,194,346,0,1,.000,100,152,.658,82,175,257,19,29,35,63,86,488
3436,Adrian Diaz,SR,2015-16,F,Florida International,CUSA,32,953,180,277,.650,180,277,0,0,,128,206,.621,102,149,251,28,20,93,68,113,488
3437,Chase Fieler,SR,2013-14,F,Florida Gulf Coast,A-Sun,35,1003,187,341,.548,169,282,18,59,.305,96,136,.706,87,173,260,55,27,32,55,109,488
3438,Seth Gearhart,SR,2014-15,F,Rice,CUSA,32,1084,143,324,.441,74,151,69,173,.399,133,163,.816,36,134,170,58,31,12,71,89,488
3439,Arlon Harper,SO,2012-13,G,Charleston Southern,Big South,32,907,166,359,.462,113,222,53,137,.387,103,138,.746,38,103,141,68,63,4,66,77,488
3440,Terrel Harris,SR,2008-09,G,Oklahoma State,Big 12,35,1110,168,344,.488,111,193,57,151,.377,95,121,.785,29,138,167,67,61,12,65,115,488
3441,Carlik Jones,SO,2018-19,G,Radford,Big South,31,1059,183,395,.463,161,306,22,89,.247,100,132,.758,17,143,160,181,52,2,84,55,488
3442,Louie Krogman,JR,2010-11,G,South Dakota,GWC,33,1043,175,411,.426,97,194,78,217,.359,60,84,.714,15,101,116,76,28,1,37,46,488
3443,Oliver Lafayette,JR,2005-06,G,Houston,CUSA,31,1019,164,451,.364,78,181,86,270,.319,74,108,.685,38,90,128,55,105,4,65,76,488
3444,Scott Machado,JR,2010-11,G,Iona,MAAC,37,1264,167,407,.410,127,282,40,125,.320,114,169,.675,32,111,143,281,49,6,131,89,488
3445,Sean Marshall,SR,2006-07,G,Boston College,ACC,33,1090,181,404,.448,131,264,50,140,.357,76,112,.679,55,93,148,64,37,9,70,63,488
3446,Patrick Miller,JR,2012-13,G,Tennessee State,OVC,33,1186,153,358,.427,111,236,42,122,.344,140,180,.778,37,104,141,190,55,9,113,92,488
3447,Luke Nevill,SO,2006-07,C,Utah,MWC,29,907,181,284,.637,181,284,0,0,,126,170,.741,72,151,223,45,13,33,63,76,488
3448,Kezie Okpala,SO,2018-19,F,Stanford,Pac-12,29,949,170,367,.463,138,280,32,87,.368,116,173,.671,34,131,165,58,29,15,83,73,488
3449,Chris Oliver,JR,2005-06,F,Radford,Big South,28,988,189,375,.504,174,329,15,46,.326,95,130,.731,114,165,279,50,41,30,53,63,488
3450,Drake Reed,JR,2007-08,F,Austin Peay,OVC,34,1103,161,352,.457,157,336,4,16,.250,162,228,.711,77,115,192,68,32,16,99,86,488
3451,Isaiah Still,SO,2016-17,G,Robert Morris,NEC,31,1011,152,396,.384,92,212,60,184,.326,124,197,.629,31,113,144,55,28,7,70,65,488
3452,Jayson Tatum,FR,2016-17,F,Duke,ACC,29,966,165,365,.452,125,248,40,117,.342,118,139,.849,39,174,213,62,39,33,76,86,488
3453,Deonta Vaughn,JR,2008-09,G,Cincinnati,Big East,32,1146,155,399,.388,74,159,81,240,.338,97,120,.808,19,108,127,149,43,0,107,82,488
3454,Aaron White,SO,2012-13,F,Iowa,Big Ten,38,1109,140,299,.468,125,233,15,66,.227,193,258,.748,88,146,234,51,41,27,62,54,488
3455,B.J. Young,FR,2011-12,G,Arkansas,SEC,32,807,177,351,.504,127,230,50,121,.413,84,113,.743,29,70,99,73,37,8,74,64,488
3456,Milton Doyle,SR,2016-17,G,Loyola (IL),MVC,32,1044,168,376,.447,127,260,41,116,.353,110,138,.797,19,142,161,142,55,22,92,77,487
3457,Demetrius Dyson,SR,2017-18,G,Samford,Southern,32,985,161,358,.450,81,168,80,190,.421,85,111,.766,34,126,160,35,30,9,68,66,487
3458,Jacob Evans,SO,2016-17,G,Cincinnati,AAC,36,1138,168,355,.473,99,190,69,165,.418,82,112,.732,53,97,150,96,46,30,45,76,487
3459,Al Fisher,JR,2007-08,G,Kent State,MAC,35,1110,164,407,.403,125,281,39,126,.310,120,144,.833,29,105,134,141,44,7,146,78,487
3460,Justin Forrest,SO,2018-19,G,Appalachian State,Sun Belt,30,870,150,369,.407,86,192,64,177,.362,123,170,.724,16,83,99,74,37,0,82,57,487
3461,Roberto Gallinat,SR,2018-19,G,Pacific,WCC,32,886,125,288,.434,67,136,58,152,.382,179,209,.856,17,81,98,18,14,5,50,83,487
3462,Paul George,FR,2008-09,F,Fresno State,WAC,34,1176,166,353,.470,103,212,63,141,.447,92,132,.697,63,149,212,63,59,34,79,92,487
3463,Paul George,SO,2009-10,F,Fresno State,WAC,29,962,154,363,.424,95,196,59,167,.353,120,132,.909,55,155,210,88,64,24,94,84,487
3464,Kevin Giltner,SR,2011-12,G,Wofford,Southern,33,1253,165,416,.397,79,175,86,241,.357,71,90,.789,21,119,140,60,29,8,65,72,487
3465,Dajuan Graf,SR,2016-17,G,North Carolina Central,MEAC,34,1207,176,360,.489,144,279,32,81,.395,103,132,.780,21,97,118,178,40,1,93,67,487
3466,Chad Gray,JR,2009-10,F,Coastal Carolina,Big South,34,800,191,371,.515,174,315,17,56,.304,88,145,.607,76,87,163,23,18,27,64,85,487
3467,Lawrence Hill,SO,2006-07,F,Stanford,Pac-10,31,977,179,352,.509,129,230,50,122,.410,79,113,.699,55,132,187,56,22,33,54,61,487
3468,Jeremy Ingram,JR,2012-13,G,North Carolina Central,MEAC,31,1031,145,331,.438,82,171,63,160,.394,134,168,.798,22,92,114,44,43,18,78,87,487
3469,Justin Jackson,SO,2015-16,F,North Carolina,ACC,40,1135,194,416,.466,159,296,35,120,.292,64,96,.667,71,85,156,113,25,17,42,69,487
3470,Alize Johnson,JR,2016-17,F,Missouri State,MVC,33,997,169,346,.488,129,243,40,103,.388,109,161,.677,110,241,351,63,20,6,76,83,487
3471,Arsalan Kazemi,SO,2010-11,F,Rice,CUSA,32,954,146,278,.525,146,278,0,0,,195,271,.720,120,231,351,43,38,26,57,85,487
3472,Robo Kreps,SR,2010-11,G,Illinois-Chicago,Horizon,31,1190,166,399,.416,95,202,71,197,.360,84,106,.792,16,115,131,90,42,2,76,51,487
3473,Cody Larson,JR,2014-15,F,South Dakota State,Summit,35,999,172,346,.497,169,337,3,9,.333,140,191,.733,71,181,252,64,22,37,65,102,487
3474,Otis Livingston,SO,2016-17,G,George Mason,A-10,34,1178,159,384,.414,114,250,45,134,.336,124,135,.919,6,101,107,102,38,0,69,52,487
3475,Dikymbe Martin,JR,2018-19,G,UC-Riverside,Big West,33,1073,177,374,.473,109,220,68,154,.442,65,76,.855,8,86,94,87,27,1,58,60,487
3478,Grant Maxey,SO,2007-08,F,Jackson State,SWAC,33,912,178,365,.488,152,291,26,74,.351,105,142,.739,72,146,218,53,49,25,80,96,487
3479,Sam McDaniel,SR,2017-18,G,Louisiana-Monroe,Sun Belt,32,1074,162,381,.425,86,196,76,185,.411,87,108,.806,38,146,184,66,33,9,70,79,487
3480,LaQuentin Miles,SR,2013-14,G,Central Arkansas,Southland,21,702,175,357,.490,164,322,11,35,.314,126,209,.603,48,109,157,58,29,9,84,42,487
3481,Harouna Mutombo,SR,2011-12,G,Western Carolina,Southern,35,1047,173,406,.426,149,321,24,85,.282,117,191,.613,63,143,206,68,50,11,77,84,487
3482,Steven Pledger,JR,2011-12,G,Oklahoma,Big 12,30,987,170,370,.459,98,197,72,173,.416,75,90,.833,41,76,117,49,30,7,57,73,487
3483,Ricardo Ratliffe,SR,2011-12,F,Missouri,Big 12,35,916,210,303,.693,210,303,0,0,,67,97,.691,110,151,261,21,21,35,56,92,487
3484,Scottie Reynolds,FR,2006-07,G,Villanova,Big East,33,978,139,359,.387,75,189,64,170,.376,145,176,.824,12,82,94,133,46,4,102,86,487
3485,Wesley Saunders,SO,2012-13,G,Harvard,Ivy,30,1120,163,311,.524,153,291,10,20,.500,151,207,.729,27,98,125,104,55,11,91,70,487
3486,David Teague,SR,2006-07,G,Purdue,Big Ten,34,1066,177,402,.440,93,198,84,204,.412,49,65,.754,50,119,169,67,24,5,63,66,487
3487,Lorrenzo Wade,JR,2007-08,F,San Diego State,MWC,33,1059,174,387,.450,151,315,23,72,.319,116,173,.671,31,119,150,119,33,20,94,85,487
3488,Anthony Beane,SO,2013-14,G,Southern Illinois,MVC,33,1126,176,374,.471,124,242,52,132,.394,82,107,.766,24,83,107,51,38,4,59,71,486
3489,Trevor Booker,SR,2009-10,F,Clemson,ACC,32,984,188,361,.521,179,327,9,34,.265,101,171,.591,89,179,268,81,43,45,62,63,486
3490,Yonel Brown,JR,2014-15,G,Kennesaw State,A-Sun,32,1184,144,350,.411,81,185,63,165,.382,135,150,.900,14,60,74,89,38,0,80,55,486
3491,Kevin Foster,FR,2008-09,G,Santa Clara,WCC,33,1000,163,396,.412,78,164,85,232,.366,75,96,.781,14,65,79,83,42,6,91,71,486
3492,Jaylen Franklin,FR,2015-16,G,Abilene Christian,Southland,30,883,176,343,.513,168,315,8,28,.286,126,206,.612,23,92,115,82,52,4,85,84,486
3493,Rashaun Freeman,SR,2006-07,C,Massachusetts,A-10,33,897,206,338,.609,206,336,0,2,.000,74,129,.574,122,151,273,27,19,14,73,111,486
3494,Anton Grady,JR,2014-15,F,Cleveland State,Horizon,34,1011,191,391,.488,187,381,4,10,.400,100,155,.645,78,190,268,59,51,47,73,104,486
3495,Chase Griffin,SR,2006-07,G,Pepperdine,WCC,31,967,158,365,.433,105,223,53,142,.373,117,145,.807,38,97,135,62,52,1,62,68,486
3496,Eric Griffin,SR,2011-12,F,Campbell,Big South,31,939,177,290,.610,166,260,11,30,.367,121,213,.568,83,185,268,46,29,73,85,100,486
3497,Justin Hare,SR,2007-08,G,Belmont,A-Sun,33,931,156,367,.425,94,202,62,165,.376,112,122,.918,22,75,97,92,32,3,65,36,486
3500,Joey Henley,SR,2008-09,F,Sacred Heart,NEC,31,949,196,313,.626,196,312,0,1,.000,94,146,.644,73,136,209,43,23,40,63,78,486
3501,Darrun Hilliard,JR,2013-14,G,Villanova,Big East,34,991,157,323,.486,87,154,70,169,.414,102,142,.718,30,94,124,90,44,17,76,68,486
3502,Tommy Hubbard,JR,2009-10,G,East Tennessee State,A-Sun,35,1172,182,408,.446,169,361,13,47,.277,109,152,.717,98,188,286,42,58,14,81,123,486
3503,Jarred Jones,SR,2016-17,G,Loyola (MD),Patriot,33,1020,181,397,.456,175,377,6,20,.300,118,160,.738,49,166,215,63,45,36,93,88,486
3504,Maurice Joseph,SR,2009-10,G,Vermont,AEC,35,1021,143,361,.396,66,155,77,206,.374,123,145,.848,20,71,91,39,17,7,53,60,486
3505,Aleksa Jugovic,JR,2016-17,G,Tennessee Tech,OVC,32,1123,148,372,.398,66,144,82,228,.360,108,119,.908,13,69,82,68,25,5,59,50,486
3506,Matthew Knight,JR,2005-06,F,Loyola Marymount,WCC,30,957,191,368,.519,191,366,0,2,.000,104,174,.598,112,187,299,25,33,23,43,60,486
3507,Patrick McCaw,SO,2015-16,G,Nevada-Las Vegas,MWC,33,1113,168,361,.465,100,175,68,186,.366,82,106,.774,38,131,169,128,81,13,68,73,486
3508,Erik McCree,JR,2015-16,F,Louisiana Tech,CUSA,30,955,165,373,.442,117,235,48,138,.348,108,151,.715,39,184,223,38,20,16,74,68,486
3509,Nick McGlynn,SR,2018-19,F,Drake,MVC,32,926,184,341,.540,168,273,16,68,.235,102,135,.756,59,206,265,44,16,53,58,70,486
3510,Malcolm McMillan,SR,2015-16,G,Canisius,MAAC,33,1132,132,313,.422,91,186,41,127,.323,181,218,.830,17,85,102,135,22,17,60,79,486
3511,Tyrell Nelson,SO,2014-15,F,Gardner-Webb,Big South,35,966,195,320,.609,195,318,0,2,.000,96,152,.632,101,128,229,29,22,29,56,107,486
3512,Julysses Nobles,SR,2013-14,G,Jackson State,SWAC,31,1096,153,396,.386,117,275,36,121,.298,144,205,.702,14,116,130,112,44,4,98,79,486
3513,Kyle Ohman,JR,2008-09,G,Liberty,Big South,35,1173,155,365,.425,55,124,100,241,.415,76,99,.768,30,165,195,93,44,13,72,85,486
3514,Evan Payne,SO,2014-15,G,Loyola Marymount,WCC,27,764,160,361,.443,123,256,37,105,.352,129,163,.791,21,55,76,45,21,5,63,42,486
3515,Nick Rakocevic,JR,2018-19,F,Southern California,Pac-12,33,991,190,347,.548,190,343,0,4,.000,106,156,.679,109,199,308,44,28,47,55,106,486
3516,Gerald Robinson,FR,2007-08,G,Tennessee State,OVC,32,943,187,403,.464,127,225,60,178,.337,52,71,.732,27,60,87,41,53,4,55,65,486
3517,Admiral Schofield,JR,2017-18,G,Tennessee,SEC,35,982,177,396,.447,113,234,64,162,.395,68,90,.756,56,168,224,52,34,15,63,102,486
3518,Damon Sherman-Newsome,SR,2014-15,G,Colgate,Patriot,33,1026,175,380,.461,107,198,68,182,.374,68,100,.680,18,93,111,60,20,5,60,51,486
3519,Chris Silva,SR,2018-19,F,South Carolina,SEC,32,853,150,295,.508,127,249,23,46,.500,163,219,.744,85,159,244,30,28,62,73,114,486
3522,Patrick Sullivan,SR,2009-10,C,Southeastern Louisiana,Southland,31,928,194,363,.534,193,358,1,5,.200,97,139,.698,70,199,269,64,30,102,83,92,486
3523,Nic Thomas,JR,2018-19,G,Norfolk State,MEAC,34,1010,137,366,.374,51,148,86,218,.394,126,156,.808,24,87,111,55,27,2,72,85,486
3524,Derrick Williams,FR,2009-10,F,Arizona,Pac-10,31,875,162,282,.574,158,266,4,16,.250,158,232,.681,68,151,219,22,19,20,60,78,486
3525,Sean Baptiste,SR,2009-10,G,Fairleigh Dickinson,NEC,30,1048,167,396,.422,105,224,62,172,.360,89,128,.695,37,131,168,33,26,8,64,81,485
3526,Bruce Beckford,JR,2014-15,F,North Carolina A&T,MEAC,32,1063,167,378,.442,141,281,26,97,.268,125,152,.822,70,163,233,45,28,22,88,85,485
3527,Patrick Beverley,FR,2006-07,G,Arkansas,SEC,35,1203,150,351,.427,77,162,73,189,.386,112,138,.812,39,117,156,110,61,14,70,77,485
3528,Jacobi Boykins,SR,2017-18,G,Louisiana Tech,CUSA,33,1008,145,343,.423,47,95,98,248,.395,97,106,.915,18,142,160,50,33,11,39,73,485
3529,Rodney Bullock,SR,2017-18,F,Providence,Big East,34,1120,164,377,.435,117,236,47,141,.333,110,149,.738,50,148,198,39,27,33,66,85,485
3530,Ricky Cadell,SR,2010-11,G,St. Francis (NY),NEC,30,939,154,398,.387,89,197,65,201,.323,112,143,.783,23,88,111,54,33,0,74,69,485
3531,Ian Chiles,SR,2013-14,C,Morgan State,MEAC,31,882,185,337,.549,185,337,0,0,,115,173,.665,77,126,203,28,14,92,48,93,485
3532,DeMar DeRozan,FR,2008-09,F,Southern California,Pac-10,35,1168,192,367,.523,186,331,6,36,.167,95,147,.646,84,117,201,51,31,13,73,73,485
3533,Justin Edwards,SO,2012-13,G,Maine,AEC,29,950,175,400,.438,148,301,27,99,.273,108,158,.684,50,100,150,99,56,12,119,83,485
3534,Tim Hardaway,FR,2010-11,G,Michigan,Big Ten,35,1074,159,379,.420,83,172,76,207,.367,91,119,.765,27,106,133,59,34,5,45,68,485
3535,Mustapha Heron,FR,2016-17,G,Auburn,SEC,32,901,152,344,.442,108,240,44,104,.423,137,178,.770,52,143,195,43,27,6,77,87,485
3536,Carlos Johnson,JR,2018-19,G,Grand Canyon,WAC,34,826,166,339,.490,134,241,32,98,.327,121,155,.781,47,91,138,53,32,5,92,89,485
3537,Melvin Johnson,SR,2013-14,G,Arkansas State,Sun Belt,32,947,156,330,.473,68,146,88,184,.478,85,112,.759,15,126,141,42,27,2,65,62,485
3538,Kris Joseph,JR,2010-11,F,Syracuse,Big East,34,1101,156,342,.456,111,219,45,123,.366,128,180,.711,38,140,178,74,51,22,73,63,485
3539,Cyril Langevine,JR,2018-19,F,Rhode Island,A-10,33,1071,178,314,.567,178,312,0,2,.000,129,215,.600,111,217,328,29,24,46,99,98,485
3540,Maarty Leunen,SR,2007-08,F,Oregon,Pac-10,32,1110,157,281,.559,98,161,59,120,.492,112,142,.789,69,224,293,90,28,11,50,78,485
3541,Scottie Lindsey,SR,2017-18,G,Northwestern,Big Ten,32,1026,169,424,.399,90,206,79,218,.362,68,82,.829,24,99,123,54,15,14,52,82,485
3544,Jordan Loveridge,SO,2013-14,F,Utah,Pac-12,33,1136,163,388,.420,119,244,44,144,.306,115,143,.804,46,184,230,77,25,15,65,59,485
3545,Roman Martinez,SR,2009-10,F,New Mexico,MWC,35,1122,160,365,.438,61,125,99,240,.413,66,88,.750,75,132,207,50,51,19,33,88,485
3546,Stephen Maxwell,SR,2014-15,F,Cal State Northridge,Big West,33,1111,171,350,.489,171,350,0,0,,143,194,.737,108,155,263,19,25,5,67,88,485
3547,Eric Maynor,SO,2006-07,G,Virginia Commonwealth,CAA,35,1214,161,380,.424,138,321,23,59,.390,140,180,.778,22,126,148,224,48,7,73,75,485
3548,A.J. Mosby,SR,2017-18,G,Alcorn State,SWAC,32,1030,178,354,.503,120,209,58,145,.400,71,82,.866,14,136,150,124,46,4,64,56,485
3549,Aaric Murray,SO,2010-11,C,La Salle,A-10,32,899,186,384,.484,166,327,20,57,.351,93,123,.756,89,156,245,41,31,72,75,99,485
3550,Earl Potts,SO,2015-16,F,Fairleigh Dickinson,NEC,33,1054,181,360,.503,115,195,66,165,.400,57,79,.722,46,163,209,47,36,10,46,113,485
3551,Cam Reddish,FR,2018-19,F,Duke,ACC,36,1069,154,432,.356,65,165,89,267,.333,88,114,.772,20,113,133,70,56,21,96,86,485
3552,Nick Ward,FR,2016-17,F,Michigan State,Big Ten,35,694,181,306,.592,181,306,0,0,,123,200,.615,97,130,227,14,12,54,58,98,485
3553,Charlie Westbrook,JR,2010-11,G,South Dakota,GWC,30,855,187,390,.479,167,320,20,70,.286,91,134,.679,31,110,141,36,34,18,69,74,485
3554,Khalil Ahmad,JR,2017-18,G,Cal State Fullerton,Big West,32,1002,170,407,.418,113,229,57,178,.320,87,105,.829,17,104,121,52,39,7,78,68,484
3555,Chaisson Allen,SR,2010-11,G,Northeastern,CAA,29,1077,156,374,.417,94,211,62,163,.380,110,157,.701,40,136,176,106,61,2,56,56,484
3556,Jarvis Bradley,JR,2006-07,C,McNeese State,Southland,32,1017,187,363,.515,187,362,0,1,.000,110,167,.659,92,143,235,24,28,33,91,103,484
3557,Torrion Brummitt,SR,2015-16,F,Western Carolina,Southern,34,956,184,362,.508,175,318,9,44,.205,107,171,.626,67,184,251,47,31,27,98,128,484
3558,Chase Budinger,FR,2006-07,F,Arizona,Pac-10,31,1024,176,363,.485,126,227,50,136,.368,82,97,.845,56,123,179,62,37,13,49,53,484
3559,Bradford Burgess,SR,2011-12,G,Virginia Commonwealth,CAA,36,1164,142,389,.365,61,168,81,221,.367,119,150,.793,42,138,180,56,39,11,45,81,484
3560,A'uston Calhoun,SR,2012-13,F,Bowling Green State,MAC,32,1090,183,412,.444,162,353,21,59,.356,97,124,.782,74,154,228,25,12,16,71,61,484
3561,Angelo Caloiaro,SR,2011-12,F,San Francisco,WCC,34,1046,147,300,.490,91,157,56,143,.392,134,169,.793,51,152,203,80,56,8,57,66,484
3562,Devin Cannady,JR,2017-18,G,Princeton,Ivy,29,1064,164,363,.452,84,160,80,203,.394,76,86,.884,17,140,157,49,24,2,44,54,484
3563,Donald Copeland,SR,2005-06,G,Seton Hall,Big East,30,1068,147,367,.401,76,186,71,181,.392,119,141,.844,16,75,91,135,41,0,72,59,484
3564,Olek Czyz,SR,2011-12,F,Nevada,WAC,35,994,180,333,.541,164,279,16,54,.296,108,172,.628,76,151,227,32,23,9,85,78,484
3565,Tyler Dorsey,FR,2015-16,G,Oregon,Pac-12,36,1083,153,347,.441,86,182,67,165,.406,111,156,.712,48,107,155,71,29,7,69,76,484
3566,Tyreek Duren,JR,2012-13,G,La Salle,A-10,34,1173,161,354,.455,114,232,47,122,.385,115,148,.777,20,77,97,111,56,13,67,64,484
3567,Shaq Goodwin,SR,2015-16,F,Memphis,AAC,33,976,162,338,.479,159,326,3,12,.250,157,216,.727,77,172,249,49,33,61,65,105,484
3568,Blake Griffin,FR,2007-08,F,Oklahoma,Big 12,33,937,184,324,.568,184,322,0,2,.000,116,197,.589,108,193,301,61,33,28,76,82,484
3569,Justin Hare,SO,2005-06,G,Belmont,A-Sun,31,993,164,343,.478,111,207,53,136,.390,103,132,.780,24,100,124,90,34,3,63,73,484
3570,Connor Hill,JR,2013-14,G,Idaho,WAC,34,1071,164,373,.440,66,131,98,242,.405,58,77,.753,5,82,87,41,24,0,27,66,484
3571,Mathieu Kamba,SR,2017-18,G,Central Arkansas,Southland,35,1059,171,330,.518,142,249,29,81,.358,113,172,.657,70,144,214,80,39,35,80,81,484
3572,Tiwian Kendley,JR,2016-17,G,Morgan State,MEAC,23,744,139,373,.373,91,218,48,155,.310,158,201,.786,42,80,122,29,28,10,99,64,484
3573,Tyrone Kent,SR,2008-09,G,Toledo,MAC,32,1056,168,415,.405,115,236,53,179,.296,95,140,.679,48,117,165,67,42,17,107,79,484
3574,Aurimas Majauskas,JR,2015-16,F,Sam Houston State,Southland,34,811,158,288,.549,141,231,17,57,.298,151,190,.795,62,128,190,54,8,15,51,123,484
3575,Naji Marshall,SO,2018-19,F,Xavier,Big East,33,1186,166,421,.394,118,248,48,173,.277,104,144,.722,29,208,237,112,37,7,108,89,484
3576,James Michael McAdoo,JR,2013-14,F,North Carolina,ACC,34,1023,173,378,.458,173,371,0,7,.000,138,257,.537,90,140,230,59,45,31,48,92,484
3577,Orlando Mendez-Valdez,SR,2008-09,G,Western Kentucky,Sun Belt,34,1138,161,360,.447,60,120,101,240,.421,61,78,.782,44,97,141,140,39,7,72,79,484
3578,Monte Morris,JR,2015-16,G,Iowa State,Big 12,35,1331,188,386,.487,150,280,38,106,.358,70,96,.729,26,112,138,241,62,9,57,55,484
3579,J.D. Paige,SR,2018-19,G,Colorado State,MWC,31,1052,172,376,.457,107,209,65,167,.389,75,93,.806,11,97,108,95,39,7,51,52,484
3580,Justin Ravenel,SR,2018-19,G,Florida A&M,MEAC,31,1093,157,342,.459,53,118,104,224,.464,66,77,.857,10,60,70,39,24,3,41,56,484
3581,Glenn Robinson,SO,2013-14,F,Michigan,Big Ten,37,1194,182,373,.488,149,265,33,108,.306,87,115,.757,54,110,164,44,35,11,46,55,484
3582,Kenny Thomas,SR,2008-09,G,Radford,Big South,33,1102,158,377,.419,79,173,79,204,.387,89,121,.736,29,131,160,71,44,4,88,82,484
3583,Al Thornton,JR,2005-06,G,Florida State,ACC,30,871,171,330,.518,151,288,20,42,.476,122,164,.744,87,121,208,37,29,9,73,75,484
3586,Frank Turner,JR,2008-09,G,Canisius,MAAC,31,1175,180,427,.422,162,363,18,64,.281,106,164,.646,35,102,137,124,36,3,126,68,484
3587,Kwame Vaughn,JR,2011-12,G,Cal State Fullerton,Big West,31,975,157,343,.458,98,192,59,151,.391,111,131,.847,17,124,141,116,28,4,83,77,484
3588,Brett Bailey,SR,2016-17,F,San Diego,WCC,31,1050,155,357,.434,122,262,33,95,.347,140,185,.757,58,157,215,52,23,11,70,83,483
3589,Jermaine Beal,SR,2009-10,G,Vanderbilt,SEC,33,1071,159,360,.442,87,170,72,190,.379,93,116,.802,7,74,81,103,32,3,52,48,483
3590,Bilal Benn,JR,2008-09,F,Niagara,MAAC,35,1203,180,419,.430,140,292,40,127,.315,83,117,.709,125,201,326,93,84,17,102,93,483
3591,Tim Coleman,JR,2015-16,F,NJIT,A-Sun,35,967,165,352,.469,118,238,47,114,.412,106,139,.763,43,219,262,82,51,32,76,109,483
3592,Garret Covington,JR,2015-16,G,Western Illinois,Summit,27,911,159,358,.444,82,176,77,182,.423,88,111,.793,12,99,111,53,23,5,59,47,483
3593,Josh Cunningham,JR,2017-18,F,Dayton,A-10,31,981,186,288,.646,178,254,8,34,.235,103,149,.691,79,182,261,54,16,13,71,96,483
3594,Zach Graham,SR,2010-11,G,Mississippi,SEC,34,1037,164,384,.427,117,242,47,142,.331,108,124,.871,46,107,153,51,27,17,51,48,483
3595,Erick Green,JR,2011-12,G,Virginia Tech,ACC,31,1071,170,388,.438,128,276,42,112,.375,101,122,.828,18,83,101,88,41,4,46,52,483
3596,Jorge Gutierrez,JR,2010-11,G,University of California,Pac-10,33,1104,143,348,.411,107,239,36,109,.330,161,201,.801,20,104,124,148,53,8,100,89,483
3597,Shaquille Harrison,SR,2015-16,G,Tulsa,AAC,32,1033,174,367,.474,166,326,8,41,.195,127,201,.632,33,144,177,132,60,7,67,69,483
3598,Xavier Henry,FR,2009-10,G,Kansas,Big 12,36,990,162,354,.458,93,189,69,165,.418,90,115,.783,43,114,157,53,54,18,69,66,483
3599,Robert Jarvis,JR,2007-08,G,Oral Roberts,Summit,30,888,147,360,.408,62,152,85,208,.409,104,122,.852,7,66,73,61,31,2,60,53,483
3600,Deon Jones,JR,2013-14,G,Monmouth,MAAC,32,973,150,336,.446,123,255,27,81,.333,156,202,.772,69,152,221,43,39,21,88,77,483
3601,Brian Lillis,SR,2007-08,G,Albany (NY),AEC,30,964,177,376,.471,168,342,9,34,.265,120,173,.694,46,134,180,106,48,22,98,95,483
3602,Daryl Macon,JR,2016-17,G,Arkansas,SEC,36,908,141,311,.453,76,143,65,168,.387,136,157,.866,19,76,95,80,41,2,65,65,483
3603,Jermaine Marrow,FR,2016-17,G,Hampton,MEAC,31,961,160,467,.343,118,315,42,152,.276,121,159,.761,25,73,98,94,21,1,103,79,483
3604,Terrell Miller,SR,2017-18,F,Murray State,OVC,32,979,178,355,.501,108,181,70,174,.402,57,79,.722,34,241,275,50,26,16,59,80,483
3605,Nick Minnerath,SR,2012-13,F,Detroit Mercy,Horizon,33,977,177,383,.462,126,241,51,142,.359,78,99,.788,59,137,196,32,28,14,44,98,483
3608,Daniel Mullings,SO,2012-13,G,New Mexico State,WAC,35,1202,167,355,.470,147,301,20,54,.370,129,170,.759,63,118,181,91,79,16,105,64,483
3609,Menji Mundadi,SR,2009-10,G,Alabama State,SWAC,31,959,150,345,.435,56,111,94,234,.402,89,119,.748,26,94,120,27,31,4,53,41,483
3610,Tony Murphy,SO,2005-06,G,Norfolk State,MEAC,31,1021,170,428,.397,109,241,61,187,.326,82,110,.745,32,78,110,34,32,1,70,32,483
3611,Jake O'Brien,SO,2009-10,F,Boston University,AEC,35,1158,165,416,.397,114,271,51,145,.352,102,132,.773,70,155,225,16,22,42,61,109,483
3612,Trayvon Palmer,SR,2016-17,G,Chicago State,WAC,32,1151,172,379,.454,147,290,25,89,.281,114,158,.722,95,207,302,49,48,20,92,103,483
3613,Anthony Randolph,FR,2007-08,F,Louisiana State,SEC,31,1016,183,394,.464,181,375,2,19,.105,115,166,.693,86,177,263,38,35,70,92,85,483
3614,Marvin Roberts,JR,2009-10,F,Florida International,Sun Belt,31,920,169,405,.417,125,256,44,149,.295,101,149,.678,33,117,150,52,43,18,88,68,483
3615,Joe Rosga,JR,2017-18,G,Denver,Summit,30,1025,155,322,.481,82,156,73,166,.440,100,111,.901,19,105,124,88,22,2,65,50,483
3616,Shay Shine,SR,2011-12,G,High Point,Big South,31,973,157,345,.455,95,189,62,156,.397,107,132,.811,37,130,167,92,36,14,72,79,483
3617,Diamon Simpson,SR,2008-09,F,Saint Mary's (CA),WCC,35,1145,162,321,.505,159,305,3,16,.188,156,267,.584,125,252,377,21,61,57,56,70,483
3618,Kendall Stephens,SR,2017-18,G,Nevada,MWC,37,1020,155,350,.443,29,58,126,292,.432,47,51,.922,15,61,76,21,17,24,28,90,483
3619,Will Walker,JR,2008-09,G,DePaul,Big East,33,1136,180,433,.416,109,240,71,193,.368,52,79,.658,26,60,86,49,55,6,44,57,483
3620,Sherrod Wright,SR,2013-14,G,George Mason,A-10,31,958,162,362,.448,134,274,28,88,.318,131,186,.704,21,79,100,25,26,5,76,67,483
3621,Demetric Bennett,JR,2006-07,G,South Alabama,Sun Belt,31,1011,171,373,.458,90,187,81,186,.435,59,85,.694,42,129,171,70,53,2,64,52,482
3622,Sharaud Curry,SR,2009-10,G,Providence,Big East,31,989,148,364,.407,88,190,60,174,.345,126,144,.875,22,40,62,105,36,1,65,57,482
3623,David DuBois,SR,2008-09,G,Western Illinois,Summit,27,976,200,413,.484,183,373,17,40,.425,65,93,.699,63,95,158,32,35,13,55,87,482
3624,Michael Frazier,SO,2013-14,G,Florida,SEC,39,1188,158,344,.459,40,79,118,265,.445,48,57,.842,22,115,137,43,43,7,46,62,482
3625,James Holmes,SR,2005-06,G,South Florida,Big East,29,1119,171,447,.383,103,249,68,198,.343,72,109,.661,23,66,89,65,53,1,115,81,482
3626,Paris Horne,SO,2008-09,G,St. John's (NY),Big East,33,1142,181,416,.435,120,234,61,182,.335,59,87,.678,50,61,111,71,53,17,68,72,482
3627,A.J. Jackson,SR,2007-08,F,Robert Morris,NEC,34,968,172,404,.426,123,280,49,124,.395,89,112,.795,62,130,192,30,38,27,64,90,482
3630,Shakur Juiston,JR,2017-18,F,Nevada-Las Vegas,MWC,33,1002,218,341,.639,216,339,2,2,1.000,44,86,.512,89,240,329,64,30,21,84,93,482
3631,Acie Law,JR,2005-06,G,Texas A&M,Big 12,30,1042,174,388,.448,137,276,37,112,.330,97,127,.764,20,81,101,119,50,1,74,77,482
3632,Clifton Lee,SR,2005-06,F,Northwestern State,Southland,34,905,189,366,.516,154,277,35,89,.393,69,111,.622,61,151,212,60,25,18,60,65,482
3633,Jairus Lyles,SO,2015-16,G,Maryland-Baltimore County,AEC,21,761,170,360,.472,132,249,38,111,.342,104,149,.698,27,89,116,59,53,0,62,59,482
3634,Jermaine Marshall,SR,2013-14,G,Arizona State,Pac-12,32,1013,162,360,.450,80,157,82,203,.404,76,106,.717,11,88,99,45,24,15,48,76,482
3635,Tre'Larenz Nottingham,SR,2018-19,G,Texas State,Sun Belt,34,1069,146,410,.356,59,129,87,281,.310,103,134,.769,14,119,133,70,42,3,77,80,482
3636,Ryan Pearson,JR,2010-11,F,George Mason,CAA,34,1030,163,319,.511,145,274,18,45,.400,138,195,.708,64,165,229,40,32,20,53,88,482
3637,Will Rayman,SO,2017-18,F,Colgate,Patriot,33,1052,160,358,.447,94,200,66,158,.418,96,119,.807,62,159,221,38,34,28,54,83,482
3638,Kahiem Seawright,SR,2008-09,F,Rhode Island,A-10,34,1044,173,345,.501,173,344,0,1,.000,136,195,.697,92,162,254,74,29,34,73,89,482
3639,Tyrone Shelley,FR,2007-08,G,Pepperdine,WCC,32,839,167,414,.403,119,255,48,159,.302,100,131,.763,65,121,186,29,52,17,86,101,482
3640,Justin Strings,SO,2015-16,F,Sacramento State,Big Sky,31,976,174,354,.492,114,202,60,152,.395,74,96,.771,51,158,209,30,20,25,29,86,482
3641,Michael Thompson,JR,2009-10,G,Northwestern,Big Ten,34,1281,151,357,.423,63,143,88,214,.411,92,111,.829,13,50,63,139,36,4,59,95,482
3642,Mychel Thompson,SR,2010-11,F,Pepperdine,WCC,33,1061,167,462,.361,114,286,53,176,.301,95,123,.772,54,140,194,62,36,33,58,64,482
3643,Ryan Woolridge,SO,2017-18,G,North Texas,CUSA,38,1391,190,383,.496,173,329,17,54,.315,85,168,.506,35,162,197,221,52,17,130,80,482
3644,Brock Young,JR,2009-10,G,East Carolina,CUSA,31,1081,146,381,.383,114,266,32,115,.278,158,193,.819,18,95,113,171,48,0,134,77,482
3645,Shaddean Aaron,SR,2007-08,G,Mercer,A-Sun,30,984,168,377,.446,114,225,54,152,.355,91,111,.820,52,85,137,48,40,19,55,69,481
3646,Tavarus Alston,SR,2009-10,G,North Carolina A&T,MEAC,33,997,167,415,.402,117,235,50,180,.278,97,139,.698,15,67,82,128,45,6,92,64,481
3647,Keith Appling,JR,2012-13,G,Michigan State,Big Ten,36,1208,156,376,.415,115,248,41,128,.320,128,171,.749,14,109,123,120,46,20,84,83,481
3648,Askia Booker,JR,2013-14,G,Colorado,Pac-12,35,1069,166,427,.389,129,291,37,136,.272,112,137,.818,20,111,131,116,45,2,88,62,481
3649,Greg Brunner,SR,2005-06,F,Iowa,Big Ten,34,1087,164,361,.454,152,320,12,41,.293,141,203,.695,98,216,314,60,33,20,84,86,481
3652,Anthony Campbell,SO,2009-10,F,Austin Peay,OVC,31,1073,160,329,.486,103,176,57,153,.373,104,129,.806,34,131,165,50,35,8,84,49,481
3653,Matt Carlino,JR,2013-14,G,Brigham Young,WCC,35,954,164,426,.385,104,249,60,177,.339,93,135,.689,19,99,118,151,61,5,70,63,481
3654,Jawan Carter,SO,2008-09,G,Delaware,CAA,32,1095,141,352,.401,79,165,62,187,.332,137,176,.778,24,54,78,83,34,0,79,72,481
3655,Kevin Coble,JR,2008-09,F,Northwestern,Big Ten,31,1060,179,379,.472,132,260,47,119,.395,76,99,.768,22,126,148,76,41,19,43,48,481
3656,Geno Crandall,SO,2016-17,G,North Dakota,Big Sky,31,1006,163,324,.503,125,217,38,107,.355,117,156,.750,24,99,123,136,64,10,102,99,481
3657,Bennet Davis,SR,2006-07,F,Northeastern,CAA,32,1101,174,405,.430,154,357,20,48,.417,113,169,.669,65,146,211,71,28,67,82,77,481
3658,Paul Delaney,JR,2006-07,G,Alabama-Birmingham,CUSA,31,1150,157,342,.459,138,268,19,74,.257,148,209,.708,32,118,150,160,59,10,110,81,481
3659,Jon Diebler,JR,2009-10,G,Ohio State,Big Ten,37,1376,148,338,.438,32,62,116,276,.420,69,79,.873,9,93,102,54,42,3,38,65,481
3660,Dion Dixon,SR,2011-12,G,Cincinnati,Big East,37,1266,159,429,.371,112,249,47,180,.261,116,166,.699,67,59,126,76,60,17,67,45,481
3661,Frank Eaves,JR,2014-15,G,Appalachian State,Sun Belt,29,959,138,361,.382,76,184,62,177,.350,143,176,.813,33,80,113,49,38,0,73,63,481
3662,D.J. Fenner,SR,2016-17,G,Nevada,MWC,35,1052,156,346,.451,92,199,64,147,.435,105,126,.833,34,93,127,58,20,12,63,102,481
3663,Reginald Gee,SO,2017-18,G,Alabama State,SWAC,31,931,152,349,.436,92,201,60,148,.405,117,151,.775,39,105,144,30,20,14,48,63,481
3664,Drew Gordon,SR,2011-12,F,New Mexico,MWC,35,1078,188,347,.542,186,345,2,2,1.000,103,137,.752,108,280,388,43,39,35,82,78,481
3665,Devonte' Graham,JR,2016-17,G,Kansas,Big 12,36,1269,157,367,.428,63,125,94,242,.388,73,92,.793,17,95,112,149,55,7,64,56,481
3666,Kyle Guy,SO,2017-18,G,Virginia,ACC,34,1102,178,429,.415,95,217,83,212,.392,42,51,.824,13,76,89,50,35,1,42,41,481
3667,Tyrone Hamilton,JR,2007-08,G,Centenary (LA),Summit,30,990,153,392,.390,67,174,86,218,.394,89,120,.742,,,101,81,37,1,112,,481
3668,Chris Hansen,JR,2013-14,G,Idaho State,Big Sky,29,1001,150,352,.426,70,152,80,200,.400,101,131,.771,16,97,113,54,31,5,53,60,481
3669,D'Angelo Harrison,SO,2012-13,G,St. John's (NY),Big East,27,945,155,393,.394,97,209,58,184,.315,113,147,.769,29,87,116,61,37,8,59,71,481
3670,Troy Huff,JR,2012-13,G,North Dakota,Big Sky,25,804,174,388,.448,137,284,37,104,.356,96,145,.662,59,114,173,30,59,7,56,38,481
3671,Matt Klinewski,JR,2016-17,F,Lafayette,Patriot,30,825,195,380,.513,195,378,0,2,.000,91,118,.771,48,131,179,36,14,16,76,80,481
3672,Corey Lowe,SR,2009-10,G,Boston University,AEC,32,1068,159,424,.375,84,204,75,220,.341,88,134,.657,31,112,143,136,40,13,134,80,481
3673,Makai Mason,SO,2015-16,G,Yale,Ivy,30,981,161,377,.427,106,223,55,154,.357,104,129,.806,15,68,83,115,25,2,91,55,481
3674,Leonard Mendez,JR,2007-08,G,Georgia State,CAA,30,1031,173,399,.434,103,226,70,173,.405,65,94,.691,27,80,107,39,38,4,59,38,481
3675,Eddie Miller,SR,2007-08,G,Fresno State,WAC,32,1112,156,380,.411,43,101,113,279,.405,56,70,.800,17,77,94,33,31,15,39,37,481
3676,Xavier Moon,SR,2016-17,G,Morehead State,OVC,30,1051,164,378,.434,93,205,71,173,.410,82,92,.891,12,94,106,139,35,9,59,58,481
3677,Tayler Persons,JR,2017-18,G,Ball State,MAC,32,953,187,406,.461,149,304,38,102,.373,69,103,.670,17,90,107,137,26,5,94,78,481
3678,Neal Pitt,FR,2008-09,F,Maryland-Eastern Shore,MEAC,30,975,173,370,.468,155,308,18,62,.290,117,194,.603,99,144,243,28,25,11,90,95,481
3679,Leslie Robinson,SR,2007-08,G,Florida A&M,MEAC,32,989,159,382,.416,56,118,103,264,.390,60,72,.833,20,83,103,37,36,4,65,60,481
3680,Avery Smith,JR,2006-07,G,Milwaukee,Horizon,31,883,178,409,.435,142,302,36,107,.336,89,115,.774,41,78,119,83,36,12,72,83,481
3681,Delvin Thompson,JR,2005-06,G,Alcorn State,SWAC,28,923,160,372,.430,120,235,40,137,.292,121,180,.672,29,93,122,65,48,3,111,74,481
3682,Phil Valenti,JR,2015-16,F,Canisius,MAAC,33,1036,170,366,.464,123,245,47,121,.388,94,122,.770,60,141,201,65,31,15,51,89,481
3683,Colton Weisbrod,SR,2017-18,F,Lamar,Southland,33,1124,171,371,.461,153,327,18,44,.409,121,182,.665,95,171,266,61,37,6,66,81,481
3684,Jordan Woodard,JR,2015-16,G,Oklahoma,Big 12,37,1102,151,363,.416,71,187,80,176,.455,99,123,.805,33,78,111,124,59,7,60,89,481
3685,Dominic Artis,SR,2016-17,G,Texas-El Paso,CUSA,32,1168,175,400,.438,138,274,37,126,.294,93,146,.637,18,189,207,187,60,4,99,75,480
3686,DaQuan Bracey,JR,2018-19,G,Louisiana Tech,CUSA,31,964,174,408,.426,127,257,47,151,.311,85,135,.630,28,70,98,124,40,4,67,63,480
3687,Darien Brothers,SR,2012-13,G,Richmond,A-10,34,994,143,348,.411,59,152,84,196,.429,110,126,.873,16,65,81,41,33,6,44,67,480
3688,Matthew Butler,JR,2016-17,G,Tennessee-Martin,OVC,35,1253,172,415,.414,90,196,82,219,.374,54,76,.711,9,92,101,129,21,1,110,84,480
3689,Keith Clanton,JR,2011-12,F,Central Florida,CUSA,33,1085,176,382,.461,137,266,39,116,.336,89,152,.586,98,168,266,61,34,59,79,92,480
3690,Denis Clemente,JR,2008-09,G,Kansas State,Big 12,32,952,167,412,.405,108,251,59,161,.366,87,109,.798,19,59,78,112,27,0,84,76,480
3691,D.J. Cooper,SR,2012-13,G,Ohio,MAC,34,1075,150,354,.424,74,145,76,209,.364,104,148,.703,15,94,109,242,68,6,119,53,480
3694,Nicchaeus Doaks,SR,2008-09,F,Chattanooga,Southern,35,1021,162,317,.511,145,257,17,60,.283,139,221,.629,92,210,302,49,24,35,87,95,480
3695,Mike Efevberha,JR,2005-06,G,Cal State Northridge,Big West,28,772,153,391,.391,96,232,57,159,.358,117,142,.824,25,67,92,57,33,14,87,72,480
3696,Alonzo Gee,JR,2007-08,F,Alabama,SEC,33,994,169,403,.419,133,287,36,116,.310,106,156,.679,94,130,224,44,51,13,63,77,480
3697,Alonzo Gee,SR,2008-09,F,Alabama,SEC,32,1027,176,398,.442,149,324,27,74,.365,101,161,.627,91,140,231,41,29,21,73,61,480
3698,Darrion Griffin,JR,2007-08,G,Jackson State,SWAC,34,946,155,318,.487,126,246,29,72,.403,141,206,.684,51,77,128,80,23,4,81,76,480
3699,Kevon Harris,SO,2017-18,F,Stephen F. Austin,Southland,33,863,159,331,.480,101,195,58,136,.426,104,153,.680,70,112,182,43,34,7,60,54,480
3700,Desmond Holloway,JR,2010-11,G,Coastal Carolina,Big South,26,832,162,323,.502,138,255,24,68,.353,132,173,.763,42,138,180,45,34,9,63,57,480
3701,Tramaine Isabell,SR,2018-19,G,Saint Louis,A-10,35,1139,164,399,.411,110,233,54,166,.325,98,138,.710,37,106,143,127,41,3,104,61,480
3702,Cory Johnson,SR,2010-11,F,Valparaiso,Horizon,34,894,182,374,.487,163,288,19,86,.221,97,137,.708,57,91,148,50,17,17,80,110,480
3703,Antoine Jordan,SR,2005-06,G,Siena,MAAC,28,1019,167,356,.469,133,281,34,75,.453,112,137,.818,51,177,228,83,43,16,63,70,480
3704,Dale Lamberth,SR,2007-08,F,Missouri State,MVC,33,956,176,363,.485,118,218,58,145,.400,70,86,.814,72,102,174,33,18,0,34,58,480
3705,Anthony Livingston,JR,2015-16,F,Arkansas State,Sun Belt,31,961,168,390,.431,146,306,22,84,.262,122,142,.859,80,210,290,15,19,25,54,90,480
3706,Sammy Mejia,SR,2006-07,G,DePaul,Big East,34,1140,188,391,.481,146,272,42,119,.353,62,103,.602,74,128,202,89,35,4,65,72,480
3707,Jaysean Paige,SR,2015-16,G,West Virginia,Big 12,35,786,171,376,.455,128,243,43,133,.323,95,121,.785,55,68,123,43,53,8,54,100,480
3708,Rod Rucker,JR,2012-13,F,Alabama-Birmingham,CUSA,33,1091,204,425,.480,204,418,0,7,.000,72,125,.576,101,169,270,75,37,24,86,92,480
3709,Josh Shipp,SR,2008-09,F,UCLA,Pac-10,33,962,170,337,.504,115,210,55,127,.433,85,106,.802,24,77,101,51,43,12,60,54,480
3710,Shamari Spears,JR,2009-10,F,Charlotte,A-10,30,862,176,379,.464,169,357,7,22,.318,121,158,.766,73,105,178,22,24,9,59,68,480
3711,Jamaal Tatum,JR,2005-06,G,Southern Illinois,MVC,32,1059,163,446,.365,116,285,47,161,.292,107,137,.781,24,58,82,104,42,3,85,67,480
3712,Seth Towns,SO,2017-18,F,Harvard,Ivy,30,838,161,384,.419,98,241,63,143,.441,95,118,.805,32,138,170,54,25,19,64,74,480
3713,Reggie Upshaw,JR,2015-16,F,Middle Tennessee,CUSA,35,1091,185,372,.497,158,301,27,71,.380,83,168,.494,103,195,298,76,51,29,64,81,480
3716,Kwadzo Ahelegbe,SR,2010-11,G,Northern Iowa,MVC,34,1067,151,359,.421,110,231,41,128,.320,136,173,.786,16,92,108,102,19,5,72,70,479
3717,Alec Brown,JR,2012-13,F,Green Bay,Horizon,34,1042,170,379,.449,140,309,30,70,.429,109,146,.747,67,137,204,42,20,59,90,100,479
3718,Derrick Brown,JR,2008-09,F,Xavier,A-10,35,1033,170,337,.504,131,247,39,90,.433,100,135,.741,82,130,212,68,25,30,61,87,479
3719,Da'Sean Butler,SO,2007-08,F,West Virginia,Big East,37,1133,186,376,.495,152,283,34,93,.366,73,114,.640,86,142,228,64,26,7,57,101,479
3720,Khadeen Carrington,SO,2015-16,G,Seton Hall,Big East,34,1049,163,390,.418,107,223,56,167,.335,97,129,.752,15,92,107,84,40,4,68,60,479
3721,Tweety Carter,SR,2009-10,G,Baylor,Big 12,32,1161,161,369,.436,82,164,79,205,.385,78,99,.788,11,77,88,188,42,0,80,59,479
3722,Brett Comer,JR,2013-14,G,Florida Gulf Coast,A-Sun,35,1084,177,389,.455,139,282,38,107,.355,87,137,.635,23,79,102,187,41,7,108,84,479
3723,Trevor Cooney,SR,2015-16,G,Syracuse,ACC,37,1347,150,431,.348,58,171,92,260,.354,87,108,.806,22,73,95,82,61,5,56,49,479
3724,Jordon Crawford,SR,2012-13,G,Bowling Green State,MAC,32,1117,180,459,.392,126,289,54,170,.318,65,86,.756,19,63,82,139,55,0,116,71,479
3725,Stacy Davis,SR,2015-16,F,Pepperdine,WCC,32,1093,159,353,.450,128,260,31,93,.333,130,174,.747,83,209,292,64,18,19,72,80,479
3726,Phil Forte,JR,2014-15,G,Oklahoma State,Big 12,32,1078,139,328,.424,69,144,70,184,.380,131,156,.840,3,64,67,55,60,2,60,44,479
3727,Zam Fredrick,SR,2008-09,G,South Carolina,SEC,31,997,165,417,.396,104,255,61,162,.377,88,130,.677,30,53,83,57,26,2,80,73,479
3728,Kentrell Gransberry,SR,2007-08,C,South Florida,Big East,30,953,183,353,.518,183,353,0,0,,113,220,.514,109,216,325,46,18,43,69,85,479
3729,Malik Hairston,SO,2005-06,G,Oregon,Pac-10,32,1056,175,372,.470,128,248,47,124,.379,82,119,.689,79,72,151,69,15,20,70,73,479
3730,Eugene Harvey,FR,2006-07,G,Seton Hall,Big East,29,1028,166,357,.465,154,318,12,39,.308,135,161,.839,46,48,94,123,50,0,91,73,479
3731,Josh Hawkinson,SR,2016-17,F,Washington State,Pac-12,31,1097,173,326,.531,145,257,28,69,.406,105,126,.833,56,259,315,79,19,25,53,73,479
3732,John Henson,JR,2011-12,F,North Carolina,ACC,35,1019,205,410,.500,205,410,0,0,,69,135,.511,89,259,348,44,20,101,45,55,479
3733,Jeromie Hill,SR,2014-15,F,Texas-San Antonio,CUSA,30,1006,183,433,.423,127,277,56,156,.359,57,93,.613,73,171,244,40,33,20,73,75,479
3734,Brian Laing,JR,2006-07,G,Seton Hall,Big East,29,1052,186,402,.463,165,336,21,66,.318,86,113,.761,66,128,194,60,48,14,59,76,479
3735,Jai Lewis,SR,2005-06,F,George Mason,CAA,35,1065,182,348,.523,166,302,16,46,.348,99,152,.651,101,173,274,64,49,23,71,100,479
3738,Marshall Moses,SR,2010-11,F,Oklahoma State,Big 12,34,1007,182,327,.557,180,323,2,4,.500,113,155,.729,95,153,248,34,19,15,75,107,479
3739,Zane Najdawi,JR,2017-18,F,The Citadel,Southern,31,781,172,335,.513,128,227,44,108,.407,91,128,.711,37,118,155,30,21,42,79,69,479
3740,Maurice Ndour,SR,2014-15,F,Ohio,MAC,30,1047,164,339,.484,137,277,27,62,.435,124,158,.785,68,182,250,50,33,68,89,83,479
3741,Joakim Noah,JR,2006-07,C,Florida,SEC,40,1034,173,285,.607,172,284,1,1,1.000,132,199,.663,102,235,337,90,45,72,100,90,479
3742,Josh Nzeakor,SR,2018-19,F,Lamar,Southland,32,992,186,301,.618,186,301,0,0,,107,183,.585,102,149,251,23,20,15,69,77,479
3743,Braxton Ogbueze,JR,2015-16,G,Charlotte,CUSA,33,1131,160,383,.418,51,128,109,255,.427,50,66,.758,18,58,76,87,16,2,38,51,479
3744,Andre Owens,SR,2005-06,G,Texas-San Antonio,Southland,27,845,182,377,.483,149,276,33,101,.327,82,127,.646,57,105,162,94,45,12,109,82,479
3745,JayVaughn Pinkston,JR,2013-14,F,Villanova,Big East,34,921,160,307,.521,152,276,8,31,.258,151,203,.744,74,134,208,49,31,19,58,83,479
3746,Ed Polite,JR,2017-18,F,Radford,Big South,36,1154,166,350,.474,144,270,22,80,.275,125,172,.727,81,202,283,53,68,34,67,83,479
3747,Joe Reitz,SO,2005-06,C,Western Michigan,MAC,31,923,162,306,.529,162,305,0,1,.000,155,211,.735,91,139,230,20,15,5,63,107,479
3748,Joe Reitz,SR,2007-08,C,Western Michigan,MAC,32,925,146,257,.568,145,256,1,1,1.000,186,260,.715,93,161,254,28,10,3,76,104,479
3749,Brandon Riley,SR,2011-12,G,South Carolina State,MEAC,28,915,176,437,.403,125,280,51,157,.325,76,99,.768,26,79,105,48,28,3,91,60,479
3750,Damian Saunders,JR,2009-10,F,Duquesne,A-10,32,1174,193,390,.495,175,295,18,95,.189,75,155,.484,143,217,360,78,89,94,97,80,479
3751,Ryan Thompson,SO,2007-08,G,Rider,MAAC,32,1086,169,315,.537,134,235,35,80,.438,106,142,.746,69,129,198,110,53,19,81,89,479
3752,Josh White,JR,2009-10,G,North Texas,Sun Belt,33,1182,135,325,.415,78,178,57,147,.388,152,185,.822,18,44,62,116,19,2,103,46,479
3753,Alan Williams,SO,2012-13,C,UC-Santa Barbara,Big West,28,793,174,371,.469,174,371,0,0,,131,181,.724,114,186,300,24,29,64,66,90,479
3754,Ken Williams,JR,2015-16,G,South Alabama,Sun Belt,31,963,153,418,.366,92,223,61,195,.313,112,140,.800,18,86,104,106,26,6,82,36,479
3755,Tracey Worley,SR,2008-09,G,New Orleans,Sun Belt,30,1011,163,376,.434,116,228,47,148,.318,106,138,.768,23,85,108,38,30,2,75,45,479
3756,Courtney Beasley,SR,2008-09,G,Southern Mississippi,CUSA,32,1113,185,407,.455,175,381,10,26,.385,98,129,.760,71,156,227,49,30,5,39,78,478
3757,Evan Boudreaux,FR,2015-16,F,Dartmouth,Ivy,27,868,155,341,.455,127,272,28,69,.406,140,169,.828,64,190,254,31,22,7,70,72,478
3760,Ramel Bradley,SR,2007-08,G,Kentucky,SEC,30,1052,139,330,.421,81,177,58,153,.379,142,171,.830,17,109,126,101,48,6,100,81,478
3761,Taylor Braun,SO,2011-12,G,North Dakota State,Summit,31,939,158,304,.520,122,224,36,80,.450,126,163,.773,28,178,206,78,39,2,77,77,478
3762,Stephon Carter,SR,2012-13,G,Cal State Bakersfield,Ind,30,954,169,352,.480,167,336,2,16,.125,138,194,.711,42,113,155,81,68,8,92,77,478
3763,Jeremy Chappell,JR,2007-08,G,Robert Morris,NEC,32,1033,190,382,.497,128,207,62,175,.354,36,49,.735,48,105,153,76,80,15,60,81,478
3764,Patrick Christopher,JR,2008-09,G,University of California,Pac-10,33,1100,176,399,.441,128,265,48,134,.358,78,94,.830,41,86,127,68,26,5,55,71,478
3765,Ryan Cook,SR,2012-13,G,Maryland-Baltimore County,AEC,31,987,166,363,.457,119,241,47,122,.385,99,118,.839,68,122,190,59,34,10,80,89,478
3766,Tyler Cook,JR,2018-19,F,Iowa,Big Ten,33,1016,174,341,.510,174,335,0,6,.000,130,202,.644,71,181,252,80,24,18,92,77,478
3767,Quenton DeCosey,SO,2013-14,G,Temple,AAC,31,1128,174,420,.414,116,247,58,173,.335,72,109,.661,24,96,120,73,32,7,55,56,478
3768,Aaseem Dixon,SR,2014-15,G,Northern Arizona,Big Sky,37,1293,158,435,.363,70,207,88,228,.386,74,95,.779,28,98,126,85,27,1,55,63,478
3769,Milton Doyle,FR,2013-14,G,Loyola (IL),MVC,32,1050,154,363,.424,114,236,40,127,.315,130,186,.699,29,104,133,115,38,23,108,88,478
3770,Billy Garrett,SR,2016-17,G,DePaul,Big East,32,938,140,361,.388,99,248,41,113,.363,157,178,.882,12,80,92,107,37,5,105,81,478
3771,Chris Gaston,JR,2011-12,F,Fordham,A-10,28,950,188,426,.441,185,418,3,8,.375,99,152,.651,111,165,276,30,35,46,75,68,478
3772,Jeremy Goode,SO,2007-08,G,Mount St. Mary's,NEC,33,1095,140,321,.436,120,254,20,67,.299,178,256,.695,28,79,107,182,65,0,110,51,478
3773,Kenny Hayes,SR,2009-10,G,Miami (OH),MAC,32,1143,167,369,.453,125,251,42,118,.356,102,128,.797,15,79,94,99,27,5,79,67,478
3774,Joe Jackson,SR,2013-14,G,Memphis,AAC,34,1129,154,348,.443,131,264,23,84,.274,147,190,.774,36,86,122,154,52,2,73,68,478
3775,Johnathon Jones,JR,2008-09,G,Oakland,Summit,36,1361,167,401,.416,134,302,33,99,.333,111,144,.771,21,80,101,290,49,8,124,72,478
3776,Justin Kier,JR,2018-19,G,George Mason,A-10,33,1148,171,363,.471,138,274,33,89,.371,103,134,.769,15,200,215,85,52,10,89,65,478
3777,Kyle Kuric,SR,2011-12,G,Louisville,Big East,38,1369,165,391,.422,89,160,76,231,.329,72,91,.791,45,114,159,45,47,19,38,81,478
3778,Damion Lee,SR,2015-16,G,Louisville,ACC,30,1007,152,355,.428,91,176,61,179,.341,113,134,.843,19,98,117,59,46,1,50,62,478
3779,Kurk Lee,FR,2016-17,G,Drexel,CAA,32,1053,171,412,.415,113,267,58,145,.400,78,115,.678,24,100,124,160,51,0,94,86,478
3780,Caris LeVert,SO,2013-14,G,Michigan,Big Ten,37,1258,163,371,.439,103,224,60,147,.408,92,120,.767,19,141,160,109,44,10,62,63,478
3781,Mark McAndrew,SR,2007-08,G,Brown,Ivy,29,966,140,297,.471,74,141,66,156,.423,132,160,.825,22,124,146,63,38,1,78,64,478
3782,Jordan Mickey,SO,2014-15,F,Louisiana State,SEC,31,1081,191,379,.504,190,370,1,9,.111,95,147,.646,99,209,308,40,29,112,101,81,478
3783,Patrick Mills,SO,2008-09,G,Saint Mary's (CA),WCC,26,867,163,405,.402,96,207,67,198,.338,85,99,.859,12,50,62,101,57,6,75,43,478
3784,Shabazz Napier,JR,2012-13,G,Connecticut,Big East,28,1043,146,331,.441,78,160,68,171,.398,118,144,.819,14,109,123,129,56,3,67,58,478
3785,Saah Nimley,SO,2012-13,G,Charleston Southern,Big South,30,997,151,415,.364,74,180,77,235,.328,99,131,.756,31,128,159,151,39,2,84,65,478
3786,Marshawn Powell,FR,2009-10,F,Arkansas,SEC,32,992,190,380,.500,182,343,8,37,.216,90,142,.634,74,141,215,45,32,42,66,87,478
3787,A.J. Price,JR,2007-08,G,Connecticut,Big East,33,1060,160,366,.437,108,225,52,141,.369,106,142,.746,25,92,117,192,43,3,78,53,478
3788,Brian Qvale,SR,2010-11,C,Montana,Big Sky,32,990,189,302,.626,189,302,0,0,,100,155,.645,98,183,281,22,21,95,65,96,478
3789,Quincy Roberts,JR,2011-12,G,Grambling,SWAC,20,746,149,363,.410,110,241,39,122,.320,141,176,.801,24,95,119,32,20,5,75,40,478
3790,Shavon Shields,JR,2014-15,G,Nebraska,Big Ten,31,1095,161,366,.440,144,279,17,87,.195,139,168,.827,45,141,186,67,33,5,84,73,478
3791,Kammron Taylor,SR,2006-07,G,Wisconsin,Big Ten,36,1182,143,340,.421,75,163,68,177,.384,124,157,.790,16,65,81,70,18,2,61,23,478
3792,Tristan Thompson,JR,2009-10,G,North Texas,Sun Belt,33,998,142,330,.430,81,179,61,151,.404,133,162,.821,24,85,109,56,25,2,60,69,478
3793,Romeo Travis,SR,2006-07,F,Akron,MAC,32,904,180,344,.523,177,336,3,8,.375,115,171,.673,78,111,189,53,33,65,61,90,478
3794,Zavier Turner,JR,2016-17,G,Manhattan,MAAC,32,914,133,340,.391,75,196,58,144,.403,154,174,.885,19,54,73,105,32,1,97,92,478
3795,Seth Tuttle,JR,2013-14,F,Northern Iowa,MVC,31,916,156,300,.520,147,262,9,38,.237,157,203,.773,72,177,249,72,30,34,65,76,478
3796,Quinndary Weatherspoon,SO,2016-17,G,Mississippi State,SEC,29,926,173,369,.469,126,243,47,126,.373,85,111,.766,40,108,148,53,50,8,64,68,478
3797,Tai Wesley,JR,2009-10,F,Utah State,WAC,35,963,191,333,.574,191,331,0,2,.000,96,137,.701,100,132,232,117,20,46,63,102,478
3798,Joe Zeglinski,JR,2009-10,G,Hartford,AEC,29,1092,166,445,.373,68,160,98,285,.344,48,65,.738,26,123,149,48,28,6,51,76,478
3799,Karon Abraham,FR,2009-10,G,Robert Morris,NEC,35,938,133,309,.430,48,117,85,192,.443,126,148,.851,22,54,76,53,24,4,63,79,477
3802,Ryan Anderson,SO,2012-13,F,Boston College,ACC,32,1012,182,382,.476,179,368,3,14,.214,110,177,.621,85,170,255,50,21,16,62,53,477
3803,Reid Augst,SR,2008-09,G,North Carolina-Asheville,Big South,31,1075,170,362,.470,139,260,31,102,.304,106,152,.697,56,92,148,79,49,8,78,59,477
3804,Xavier Bishop,JR,2018-19,G,Kansas City,WAC,31,1049,161,377,.427,100,204,61,173,.353,94,118,.797,17,68,85,118,35,0,88,77,477
3805,Brandon Bush,SR,2008-09,G,Texas State,Southland,30,870,171,327,.523,156,271,15,56,.268,120,172,.698,62,152,214,65,25,6,82,89,477
3806,Ty Cockfield,JR,2017-18,G,Arkansas State,Sun Belt,32,955,170,384,.443,116,235,54,149,.362,83,106,.783,25,66,91,65,30,4,69,61,477
3807,Darren Collison,JR,2007-08,G,UCLA,Pac-10,33,1144,161,335,.481,108,234,53,101,.525,102,117,.872,17,69,86,124,61,3,74,44,477
3808,Joe Crawford,JR,2006-07,G,Kentucky,SEC,34,1097,178,401,.444,115,221,63,180,.350,58,91,.637,50,87,137,83,27,10,64,65,477
3809,Darrell Davis,SR,2017-18,G,Dayton,A-10,31,1088,150,345,.435,78,156,72,189,.381,105,120,.875,15,111,126,85,21,3,84,69,477
3810,Steven Davis,SR,2016-17,F,Wright State,Horizon,32,901,169,342,.494,117,206,52,136,.382,87,113,.770,54,85,139,32,16,14,66,94,477
3811,Robert Dozier,SR,2008-09,F,Memphis,CUSA,37,1118,166,320,.519,145,264,21,56,.375,124,172,.721,106,171,277,53,47,61,74,101,477
3812,Eric Fanning,SR,2016-17,G,Boston University,Patriot,32,897,139,335,.415,103,233,36,102,.353,163,208,.784,42,151,193,67,27,13,99,81,477
3813,Quincy Ford,SR,2015-16,F,Northeastern,CAA,29,1008,158,386,.409,93,199,65,187,.348,96,129,.744,45,157,202,75,43,25,63,62,477
3814,Shan Foster,SO,2005-06,G,Vanderbilt,SEC,30,967,162,359,.451,72,142,90,217,.415,63,83,.759,25,64,89,48,14,6,47,38,477
3815,Alex Franklin,JR,2008-09,F,Siena,MAAC,35,1126,171,304,.563,171,304,0,0,,135,218,.619,96,166,262,30,44,24,79,101,477
3816,Melvin Frazier,JR,2017-18,G,Tulane,AAC,30,1032,179,322,.556,144,231,35,91,.385,84,118,.712,35,133,168,86,65,22,77,60,477
3817,Davante Gardner,SR,2013-14,F,Marquette,Big East,32,850,159,301,.528,157,285,2,16,.125,157,201,.781,69,113,182,43,10,15,36,65,477
3818,C.J. Harris,SR,2012-13,G,Wake Forest,ACC,31,1017,140,310,.452,81,173,59,137,.431,138,163,.847,9,63,72,59,24,3,77,64,477
3819,Roy Hibbert,JR,2006-07,C,Georgetown,Big East,37,975,186,277,.671,186,277,0,0,,105,153,.686,100,154,254,39,18,90,46,103,477
3820,Isaiah Johnson,JR,2015-16,C,Akron,MAC,35,889,174,303,.574,173,298,1,5,.200,128,214,.598,93,173,266,57,16,45,54,83,477
3821,Johnathan Jordan,JR,2013-14,G,Texas A&M-Corpus Christi,Southland,33,1119,141,323,.437,133,288,8,35,.229,187,271,.690,33,115,148,177,49,4,88,80,477
3824,Trey Kell,SO,2015-16,G,San Diego State,MWC,38,1084,158,390,.405,87,205,71,185,.384,90,135,.667,29,113,142,54,30,7,67,51,477
3825,Lawrence Kinnard,SR,2008-09,F,Alabama-Birmingham,CUSA,34,1149,185,414,.447,140,267,45,147,.306,62,103,.602,85,227,312,42,37,21,47,78,477
3826,Tanner Leissner,SO,2015-16,F,New Hampshire,AEC,30,984,170,389,.437,148,312,22,77,.286,115,153,.752,75,143,218,46,11,5,65,73,477
3827,Evan Leonard,SO,2017-18,G,UC-Irvine,Big West,35,981,161,360,.447,94,191,67,169,.396,88,111,.793,16,98,114,69,48,4,60,98,477
3828,Kevin Lisch,SO,2006-07,G,Saint Louis,A-10,32,1081,140,327,.428,73,163,67,164,.409,130,158,.823,14,100,114,111,32,12,59,68,477
3829,Corey Lyons,SR,2008-09,G,Norfolk State,MEAC,31,1021,145,382,.380,82,199,63,183,.344,124,167,.743,30,79,109,26,36,17,67,76,477
3830,Z Mason,JR,2012-13,F,Chattanooga,Southern,32,873,173,353,.490,149,277,24,76,.316,107,149,.718,78,165,243,22,29,29,52,56,477
3831,Spencer Parker,SR,2015-16,F,Bowling Green State,MAC,34,986,164,355,.462,131,277,33,78,.423,116,162,.716,51,124,175,58,16,14,80,73,477
3832,Nijal Pearson,FR,2016-17,G,Texas State,Sun Belt,36,1182,167,382,.437,130,275,37,107,.346,106,147,.721,67,139,206,88,49,13,79,84,477
3833,Gyno Pomare,SO,2006-07,C,San Diego,WCC,32,901,182,338,.538,182,338,0,0,,113,154,.734,101,164,265,21,20,42,55,73,477
3834,Tajuan Porter,JR,2008-09,G,Oregon,Pac-10,31,1001,148,377,.393,62,149,86,228,.377,95,109,.872,21,55,76,55,32,2,77,64,477
3835,Landry Shamet,SO,2017-18,G,Wichita State,AAC,32,1015,154,315,.489,70,125,84,190,.442,85,103,.825,14,89,103,166,23,6,67,61,477
3836,Chase Simon,SO,2009-10,G,Detroit Mercy,Horizon,34,1051,170,423,.402,121,277,49,146,.336,88,138,.638,43,130,173,84,41,6,108,77,477
3837,Chase Simon,SR,2011-12,G,Detroit Mercy,Horizon,36,1209,155,419,.370,106,261,49,158,.310,118,154,.766,56,101,157,87,41,6,96,97,477
3838,Ben Simons,JR,2011-12,F,Drake,MVC,29,1041,169,359,.471,92,178,77,181,.425,62,73,.849,18,81,99,40,24,9,47,56,477
3839,Bryan Smithson,SR,2007-08,G,North Carolina-Asheville,Big South,29,1049,157,349,.450,95,198,62,151,.411,101,121,.835,20,95,115,120,54,4,70,50,477
3840,Kirk Van Slyke,SR,2013-14,F,Arkansas State,Sun Belt,32,987,162,313,.518,124,220,38,93,.409,115,141,.816,63,125,188,33,24,38,53,83,477
3841,Dez Wells,JR,2013-14,G,Maryland,ACC,32,980,154,320,.481,137,264,17,56,.304,152,186,.817,33,105,138,69,34,27,79,74,477
3842,James Woodard,SR,2015-16,G,Tulsa,AAC,31,1056,145,349,.415,68,134,77,215,.358,110,140,.786,20,143,163,74,31,12,56,49,477
3843,Josh Young,SO,2007-08,G,Drake,MVC,30,957,147,321,.458,61,123,86,198,.434,97,127,.764,14,61,75,53,42,2,50,52,477
3846,Zach Auguste,JR,2014-15,F,Notre Dame,ACC,37,904,190,307,.619,190,307,0,0,,96,151,.636,82,157,239,29,25,25,61,94,476
3847,Travis Betran,SR,2013-14,G,Austin Peay,OVC,30,998,147,375,.392,72,163,75,212,.354,107,122,.877,4,39,43,68,22,3,75,34,476
3848,Kenny Boynton,FR,2009-10,G,Florida,SEC,34,1117,165,439,.376,93,194,72,245,.294,74,99,.747,37,50,87,92,37,6,68,53,476
3849,Malcolm Brogdon,JR,2014-15,G,Virginia,ACC,34,1105,158,374,.422,114,246,44,128,.344,116,132,.879,16,118,134,81,24,14,58,65,476
3850,Jalen Cannon,JR,2013-14,F,St. Francis (NY),NEC,32,959,164,335,.490,151,287,13,48,.271,135,189,.714,94,169,263,39,20,17,37,57,476
3851,Brayden Carlson,SR,2013-14,G,South Dakota State,Summit,32,1177,144,318,.453,92,174,52,144,.361,136,174,.782,11,100,111,93,48,3,80,71,476
3852,Osiris Eldridge,JR,2008-09,G,Illinois State,MVC,34,1184,165,408,.404,93,204,72,204,.353,74,106,.698,51,159,210,83,52,14,71,66,476
3853,Keenan Evans,JR,2016-17,G,Texas Tech,Big 12,31,943,159,343,.464,108,225,51,118,.432,107,126,.849,23,64,87,94,31,6,52,64,476
3854,Marquis Gilstrap,SR,2009-10,F,Iowa State,Big 12,32,1029,162,372,.435,119,258,43,114,.377,109,163,.669,88,210,298,45,29,30,87,74,476
3855,Jimmy Hall,SO,2014-15,F,Kent State,MAC,30,859,193,363,.532,191,358,2,5,.400,88,129,.682,89,142,231,46,15,29,68,96,476
3856,Jahlil Jenkins,SO,2018-19,G,Fairleigh Dickinson,NEC,35,1291,161,376,.428,118,245,43,131,.328,111,126,.881,7,100,107,157,57,3,75,52,476
3857,Diego Kapelan,SR,2010-11,G,McNeese State,Southland,32,931,149,381,.391,63,142,86,239,.360,92,104,.885,22,56,78,36,22,2,59,51,476
3858,Michael Kidd-Gilchrist,FR,2011-12,F,Kentucky,SEC,40,1245,160,326,.491,147,275,13,51,.255,143,192,.745,103,194,297,75,39,37,87,97,476
3859,Kyle Kuzma,JR,2016-17,F,Utah,Pac-12,29,894,182,361,.504,155,277,27,84,.321,85,127,.669,81,190,271,71,18,14,62,46,476
3860,Travis Leslie,JR,2010-11,G,Georgia,SEC,33,1062,177,360,.492,164,317,13,43,.302,109,136,.801,106,131,237,97,40,20,71,63,476
3861,Jeremy Lin,SR,2009-10,G,Harvard,Ivy,29,933,149,287,.519,119,199,30,88,.341,148,196,.755,24,103,127,131,71,31,90,85,476
3862,Marcus LoVett,FR,2016-17,G,St. John's (NY),Big East,30,948,166,358,.464,116,227,50,131,.382,94,117,.803,18,70,88,113,40,1,79,61,476
3863,Kelvin Martin,SR,2011-12,F,Charleston Southern,Big South,31,1016,187,318,.588,185,310,2,8,.250,100,166,.602,82,199,281,52,65,51,70,80,476
3864,Ronnie Moss,SO,2009-10,G,Texas Christian,MWC,32,1072,165,408,.404,103,243,62,165,.376,84,123,.683,18,84,102,189,24,7,120,74,476
3865,Ahmad Nivins,JR,2007-08,F,Saint Joseph's,A-10,33,1112,165,255,.647,165,255,0,0,,146,197,.741,73,120,193,16,22,39,76,93,476
3868,Prentiss Nixon,SO,2016-17,G,Colorado State,MWC,36,1153,152,400,.380,97,225,55,175,.314,117,144,.813,11,91,102,72,30,4,60,93,476
3869,Javion Ogunyemi,SR,2016-17,F,Siena,MAAC,34,1091,176,329,.535,171,309,5,20,.250,119,189,.630,91,103,194,42,21,65,66,109,476
3870,Eli Pemberton,SO,2017-18,G,Hofstra,CAA,30,1046,145,321,.452,91,189,54,132,.409,132,175,.754,48,96,144,67,20,5,61,75,476
3871,Xavier Rathan-Mayes,FR,2014-15,G,Florida State,ACC,32,1110,165,397,.416,117,226,48,171,.281,98,142,.690,16,96,112,137,35,0,108,74,476
3872,Christian Vital,SO,2017-18,G,Connecticut,AAC,32,1013,138,360,.383,70,146,68,214,.318,132,156,.846,25,148,173,53,50,1,56,73,476
3873,Jamel Artis,JR,2015-16,F,Pittsburgh,ACC,33,991,165,351,.470,116,216,49,135,.363,96,123,.780,41,119,160,98,19,8,80,59,475
3874,Godwin Boahen,JR,2018-19,G,Illinois-Chicago,Horizon,32,1096,160,367,.436,70,126,90,241,.373,65,77,.844,21,90,111,101,39,13,77,82,475
3875,Jason Calliste,JR,2012-13,G,Detroit Mercy,Horizon,33,1161,133,342,.389,60,142,73,200,.365,136,163,.834,20,83,103,109,44,5,72,64,475
3876,Kyle Collinsworth,SO,2013-14,G,Brigham Young,WCC,34,1136,175,352,.497,167,330,8,22,.364,117,203,.576,85,190,275,156,57,14,89,82,475
3877,Pat Connaughton,SR,2014-15,G,Notre Dame,ACC,38,1351,166,356,.466,73,136,93,220,.423,50,64,.781,41,241,282,57,27,36,44,75,475
3878,Christen Cunningham,SO,2015-16,G,Samford,Southern,33,1114,161,357,.451,142,287,19,70,.271,134,162,.827,17,76,93,128,34,2,87,54,475
3879,Kim English,SO,2009-10,G,Missouri,Big 12,34,818,156,397,.393,88,213,68,184,.370,95,130,.731,29,86,115,39,45,3,71,58,475
3880,Dwayne Evans,SR,2013-14,F,Saint Louis,A-10,34,1005,168,340,.494,163,322,5,18,.278,134,179,.749,66,156,222,42,41,20,82,96,475
3881,Zam Fredrick,JR,2007-08,G,South Carolina,SEC,32,1128,176,438,.402,108,245,68,193,.352,55,82,.671,19,72,91,101,30,6,75,69,475
3882,Jordan Geist,SR,2018-19,G,Missouri,SEC,32,1080,155,352,.440,90,168,65,184,.353,100,132,.758,26,122,148,97,34,0,69,56,475
3883,Shawn Glover,JR,2012-13,F,Oral Roberts,Southland,33,1082,199,399,.499,191,363,8,36,.222,69,97,.711,57,110,167,64,40,44,70,60,475
3884,Johnny Gray,SR,2005-06,G,Pacific,Big West,32,1088,170,351,.484,104,194,66,157,.420,69,79,.873,13,73,86,100,30,2,78,59,475
3885,Tucker Haymond,SR,2016-17,G,Western Michigan,MAC,32,1003,155,340,.456,114,232,41,108,.380,124,167,.743,47,115,162,80,23,3,79,69,475
3886,Malcolm Hill,SO,2014-15,G,Illinois,Big Ten,33,1010,156,352,.443,114,244,42,108,.389,121,155,.781,61,98,159,44,28,7,49,68,475
3887,Nathan Hoover,JR,2018-19,G,Wofford,Southern,35,1002,153,335,.457,61,139,92,196,.469,77,85,.906,9,78,87,35,21,1,25,49,475
3888,Matt Howard,SO,2008-09,F,Butler,Horizon,32,888,148,269,.550,146,260,2,9,.222,177,229,.773,82,134,216,36,25,48,52,101,475
3889,A.J. Jackson,JR,2005-06,F,Robert Morris,NEC,28,949,168,368,.457,135,288,33,80,.413,106,147,.721,78,181,259,35,22,24,71,80,475
3890,Przemek Karnowski,SR,2016-17,C,Gonzaga,WCC,39,902,198,338,.586,198,337,0,1,.000,79,133,.594,56,172,228,75,17,37,70,83,475
3891,Dwight Lewis,JR,2008-09,G,Southern California,Pac-10,33,1191,164,407,.403,109,262,55,145,.379,92,123,.748,25,84,109,69,37,5,81,67,475
3892,Liam O'Reilly,SR,2017-18,G,Gardner-Webb,Big South,32,1091,166,403,.412,81,182,85,221,.385,58,69,.841,11,139,150,120,33,2,95,58,475
3893,Sean Ogirri,SR,2008-09,G,Wyoming,MWC,33,1191,152,343,.443,43,85,109,258,.422,62,72,.861,12,64,76,73,31,4,66,76,475
3894,Marcus Ottey,JR,2018-19,G,Illinois-Chicago,Horizon,32,1010,179,364,.492,155,285,24,79,.304,93,127,.732,19,93,112,77,36,6,80,85,475
3895,Shabooty Phillips,JR,2018-19,G,Longwood,Big South,34,1064,148,366,.404,74,151,74,215,.344,105,118,.890,10,149,159,129,33,1,83,81,475
3896,Keith Rendleman,JR,2011-12,F,North Carolina-Wilmington,CAA,31,1024,186,351,.530,186,350,0,1,.000,103,164,.628,117,194,311,37,41,33,66,101,475
3897,Julian Sensley,SR,2005-06,F,Hawaii,WAC,27,1000,174,390,.446,124,243,50,147,.340,77,117,.658,45,111,156,87,34,14,65,45,475
3898,Josh Shipp,JR,2007-08,F,UCLA,Pac-10,39,1269,169,389,.434,99,173,70,216,.324,67,87,.770,16,107,123,83,52,16,67,75,475
3899,Mike Smith,SO,2017-18,G,Columbia,Ivy,27,918,157,403,.390,108,244,49,159,.308,112,133,.842,12,58,70,124,31,1,59,49,475
3900,Tavares Speaks,SR,2012-13,G,Liberty,Big South,36,1122,165,378,.437,152,344,13,34,.382,132,163,.810,14,109,123,43,42,3,75,91,475
3901,Ethan Telfair,SR,2016-17,G,Idaho State,Big Sky,28,1013,146,429,.340,104,296,42,133,.316,141,183,.770,21,100,121,134,56,6,96,60,475
3902,Obi Toppin,FR,2018-19,F,Dayton,A-10,33,873,201,302,.666,190,281,11,21,.524,62,87,.713,50,136,186,61,21,28,63,70,475
3903,Phil Valenti,SR,2016-17,F,Canisius,MAAC,34,1026,181,361,.501,150,270,31,91,.341,82,103,.796,62,139,201,82,36,4,64,93,475
3904,Fred VanVleet,JR,2014-15,G,Wichita State,MVC,35,1104,151,351,.430,111,239,40,112,.357,133,167,.796,41,115,156,183,66,4,59,50,475
3905,Kori Babineaux,JR,2014-15,G,Jacksonville,A-Sun,32,1080,193,396,.487,191,375,2,21,.095,86,145,.593,18,108,126,127,51,4,106,81,474
3906,Tyrone Bazy,SR,2006-07,G,Northern Arizona,Big Sky,30,796,159,314,.506,149,275,10,39,.256,146,178,.820,27,60,87,75,33,2,86,86,474
3907,Leron Black,JR,2017-18,F,Illinois,Big Ten,31,789,188,344,.547,166,301,22,43,.512,76,95,.800,55,106,161,26,10,8,56,104,474
3910,Aaron Brown,SR,2014-15,G,Boston College,ACC,32,1086,158,384,.411,98,194,60,190,.316,98,143,.685,15,84,99,64,19,1,70,65,474
3911,Michael Carter-Williams,SO,2012-13,G,Syracuse,Big East,40,1409,155,394,.393,120,275,35,119,.294,129,186,.694,51,148,199,291,109,20,138,92,474
3912,Louis Dabney,SR,2015-16,G,Tulane,AAC,33,1088,153,413,.370,99,240,54,173,.312,114,144,.792,26,74,100,73,35,4,68,86,474
3913,Michael Dixon,JR,2011-12,G,Missouri,Big 12,35,934,154,316,.487,104,180,50,136,.368,116,132,.879,10,53,63,116,41,3,56,64,474
3914,Shep Garner,SO,2015-16,G,Penn State,Big Ten,32,1127,149,390,.382,74,185,75,205,.366,101,129,.783,9,94,103,109,42,7,65,59,474
3915,Steven Gray,SR,2010-11,G,Gonzaga,WCC,34,1075,159,388,.410,88,197,71,191,.372,85,112,.759,21,111,132,136,57,3,73,82,474
3916,Jamar Gulley,SR,2013-14,F,Missouri State,MVC,33,883,170,369,.461,144,283,26,86,.302,108,147,.735,67,144,211,52,52,11,56,103,474
3917,Adam Haluska,JR,2005-06,G,Iowa,Big Ten,34,1173,149,357,.417,85,172,64,185,.346,112,132,.848,21,138,159,78,36,6,68,61,474
3918,Trevon Harmon,JR,2010-11,G,Cleveland State,Horizon,36,1195,161,367,.439,100,186,61,181,.337,91,115,.791,45,99,144,46,55,0,47,72,474
3919,Delroy James,JR,2009-10,F,Rhode Island,A-10,36,974,165,393,.420,119,250,46,143,.322,98,133,.737,79,112,191,57,52,45,73,87,474
3920,Tre Kelley,JR,2005-06,G,South Carolina,SEC,38,1330,166,398,.417,99,206,67,192,.349,75,98,.765,22,88,110,174,50,5,103,74,474
3921,Tyler Larson,SR,2014-15,G,South Dakota,Summit,33,1141,156,362,.431,124,276,32,86,.372,130,173,.751,74,185,259,95,26,8,70,85,474
3922,Devareaux Manley,SR,2014-15,G,Kent State,MAC,35,1139,144,361,.399,30,74,114,287,.397,72,93,.774,15,84,99,29,20,6,37,64,474
3923,Jermaine Marshall,JR,2012-13,G,Penn State,Big Ten,31,1073,154,394,.391,95,220,59,174,.339,107,141,.759,14,128,142,80,45,19,82,96,474
3924,Nick Masterson,SR,2017-18,G,Kennesaw State,A-Sun,30,1102,167,301,.555,94,166,73,135,.541,67,76,.882,22,62,84,96,25,4,44,59,474
3925,Dominick Mejia,JR,2005-06,G,Drexel,CAA,31,981,152,410,.371,60,162,92,248,.371,78,93,.839,21,85,106,70,35,5,81,49,474
3926,Eugene Myatt,SR,2008-09,F,Howard,MEAC,30,996,166,422,.393,140,329,26,93,.280,116,148,.784,21,90,111,43,24,5,86,78,474
3927,Le'Bryan Nash,JR,2013-14,G,Oklahoma State,Big 12,34,1017,169,325,.520,169,319,0,6,.000,136,184,.739,51,137,188,54,18,27,64,114,474
3928,Reeves Nelson,SO,2010-11,F,UCLA,Pac-10,34,1066,177,312,.567,173,291,4,21,.190,116,187,.620,80,228,308,54,14,14,83,77,474
3929,LeRoy Nobles,JR,2009-10,G,IUPUI,Summit,36,1181,145,325,.446,75,159,70,166,.422,114,144,.792,36,118,154,55,29,6,71,70,474
3932,Tanner Plomb,JR,2014-15,F,Army,Patriot,30,846,166,391,.425,100,216,66,175,.377,76,94,.809,29,139,168,40,24,12,57,61,474
3933,DeWayne Reed,JR,2008-09,G,Auburn,SEC,36,1144,156,403,.387,91,204,65,199,.327,97,157,.618,19,73,92,134,67,15,92,80,474
3934,Cameron Rundles,SR,2010-11,G,Wofford,Southern,34,1124,155,356,.435,80,168,75,188,.399,89,134,.664,12,117,129,85,39,3,51,75,474
3935,Tevon Saddler,SR,2017-18,G,Nicholls State,Southland,30,878,162,343,.472,143,272,19,71,.268,131,171,.766,45,154,199,85,48,7,95,89,474
3936,Micah Seaborn,FR,2015-16,G,Monmouth,MAAC,36,996,160,377,.424,92,201,68,176,.386,86,102,.843,16,96,112,71,36,7,66,78,474
3937,Umar Shannon,SO,2010-11,G,Saint Francis (PA),NEC,30,959,146,356,.410,78,177,68,179,.380,114,142,.803,26,64,90,59,14,0,66,57,474
3938,Marcus Shaver,SO,2018-19,G,Portland,WCC,32,1005,151,374,.404,99,229,52,145,.359,120,153,.784,17,90,107,69,40,13,69,88,474
3939,Jaylen Shaw,SR,2017-18,G,Coastal Carolina,Sun Belt,32,989,157,374,.420,123,266,34,108,.315,126,163,.773,10,92,102,172,51,1,112,71,474
3940,Nick Stallings,SR,2008-09,G,Centenary (LA),Summit,31,1133,173,405,.427,117,262,56,143,.392,72,116,.621,,,189,66,49,15,94,,474
3941,Brock Stull,SO,2016-17,G,Milwaukee,Horizon,35,1167,173,390,.444,116,245,57,145,.393,71,88,.807,37,195,232,100,27,1,76,65,474
3942,James Thompson IV,SO,2016-17,,Eastern Michigan,MAC,32,988,178,310,.574,177,309,1,1,1.000,117,164,.713,152,206,358,32,24,29,64,101,474
3943,Shawne Williams,FR,2005-06,F,Memphis,CUSA,36,1002,156,375,.416,108,221,48,154,.312,114,145,.786,62,160,222,67,50,49,81,105,474
3944,Chris Wright,SR,2010-11,F,Dayton,A-10,36,1038,179,390,.459,174,368,5,22,.227,111,185,.600,83,218,301,66,28,51,102,101,474
3945,Miles Bridges,FR,2016-17,F,Michigan State,Big Ten,28,895,177,364,.486,121,220,56,144,.389,63,92,.685,41,191,232,58,19,43,66,52,473
3946,Jacob Burtschi,SR,2006-07,F,Air Force,MWC,35,1122,168,337,.499,106,178,62,159,.390,75,97,.773,49,161,210,80,55,3,35,84,473
3947,Jake Cohen,JR,2011-12,F,Davidson,Southern,33,818,151,310,.487,121,228,30,82,.366,141,161,.876,69,133,202,45,24,55,68,100,473
3948,Devon Collier,SO,2011-12,F,Oregon State,Pac-12,36,964,176,286,.615,176,286,0,0,,121,192,.630,89,98,187,63,36,46,49,74,473
3949,Spencer Collins,SR,2015-16,G,Wofford,Southern,32,1006,152,386,.394,77,202,75,184,.408,94,116,.810,29,78,107,69,27,4,60,75,473
3950,Brian Conklin,SR,2011-12,F,Saint Louis,A-10,34,1001,158,303,.521,157,301,1,2,.500,156,195,.800,67,89,156,42,24,11,71,90,473
3951,Kevin Dillard,SR,2012-13,G,Dayton,A-10,31,1023,139,343,.405,84,204,55,139,.396,140,157,.892,12,48,60,141,34,4,98,65,473
3954,Deon Edwin,SR,2016-17,G,Kent State,MAC,36,1031,163,353,.462,126,246,37,107,.346,110,153,.719,62,137,199,85,48,17,75,96,473
3955,Dominique Elliott,SR,2015-16,F,Maryland-Eastern Shore,MEAC,32,987,180,331,.544,175,314,5,17,.294,108,169,.639,76,179,255,49,18,16,94,101,473
3956,Sterling Gibbs,JR,2014-15,G,Seton Hall,Big East,29,976,151,350,.431,76,178,75,172,.436,96,137,.701,15,45,60,110,35,0,58,45,473
3957,Cedric Jackson,JR,2007-08,G,Cleveland State,Horizon,34,1058,148,353,.419,102,235,46,118,.390,131,191,.686,25,141,166,168,88,10,131,97,473
3958,Dominic James,FR,2005-06,G,Marquette,Big East,31,1006,174,404,.431,133,268,41,136,.301,84,131,.641,24,116,140,167,50,12,87,74,473
3959,Michael Jenkins,SR,2007-08,G,Winthrop,Big South,34,1083,166,399,.416,92,198,74,201,.368,67,94,.713,31,110,141,85,38,14,63,79,473
3960,Xavier Johnson,SR,2016-17,G,Colorado,Pac-12,32,895,164,335,.490,125,233,39,102,.382,106,157,.675,55,135,190,33,17,11,47,82,473
3961,Teyvion Kirk,FR,2017-18,G,Ohio,MAC,31,993,160,365,.438,144,325,16,40,.400,137,190,.721,34,154,188,95,42,5,105,78,473
3962,Martin Krampelj,JR,2018-19,F,Creighton,Big East,35,888,177,299,.592,151,229,26,70,.371,93,147,.633,60,181,241,28,38,29,55,99,473
3963,Oliver Lafayette,SR,2006-07,G,Houston,CUSA,33,1181,149,421,.354,74,191,75,230,.326,100,132,.758,47,149,196,102,78,8,66,101,473
3964,Julian Mavunga,JR,2010-11,F,Miami (OH),MAC,32,1163,142,315,.451,113,228,29,87,.333,160,227,.705,64,197,261,96,20,17,121,77,473
3965,Khris Middleton,SO,2010-11,F,Texas A&M,Big 12,33,978,159,353,.450,120,245,39,108,.361,116,148,.784,64,108,172,93,39,2,89,70,473
3966,Deven Mitchell,SR,2007-08,F,Missouri State,MVC,33,923,156,289,.540,154,282,2,7,.286,159,178,.893,69,133,202,25,47,18,76,94,473
3967,Mark Nwakamma,JR,2013-14,F,Hartford,AEC,31,910,171,324,.528,158,283,13,41,.317,118,173,.682,55,126,181,60,23,23,95,109,473
3968,Rodney Pierce,JR,2008-09,G,Buffalo,MAC,33,1017,167,431,.387,111,274,56,157,.357,83,110,.755,23,97,120,71,28,2,68,73,473
3969,Jesse Reed,JR,2014-15,G,American,Patriot,33,1269,158,336,.470,112,207,46,129,.357,111,144,.771,23,141,164,44,33,19,62,75,473
3970,Nate Rohnert,JR,2008-09,G,Denver,Sun Belt,31,1147,166,337,.493,131,230,35,107,.327,106,148,.716,24,142,166,146,40,10,105,88,473
3971,Amu Saaka,JR,2009-10,F,Furman,Southern,30,975,163,364,.448,123,254,40,110,.364,107,154,.695,70,147,217,50,20,14,66,95,473
3972,Mike Schachtner,JR,2007-08,F,Green Bay,Horizon,30,883,166,341,.487,129,260,37,81,.457,104,115,.904,47,80,127,19,10,2,43,67,473
3973,Jordan Sugars,SO,2009-10,G,Navy,Patriot,30,1066,169,372,.454,91,187,78,185,.422,57,86,.663,84,155,239,39,38,4,64,74,473
3976,Devin Sweetney,SR,2009-10,G,Saint Francis (PA),NEC,28,899,142,340,.418,108,236,34,104,.327,155,187,.829,60,146,206,60,34,15,91,70,473
3977,Tyler Tiedeman,SR,2007-08,G,Boise State,WAC,34,1074,153,289,.529,69,117,84,172,.488,83,111,.748,22,92,114,105,17,10,85,92,473
3978,Reed Timmer,JR,2016-17,G,Drake,MVC,31,918,146,351,.416,91,197,55,154,.357,126,152,.829,17,80,97,56,32,2,56,53,473
3979,Matt Van Scyoc,SO,2013-14,F,The Citadel,Southern,33,1062,145,333,.435,79,152,66,181,.365,117,136,.860,32,144,176,34,12,23,54,98,473
3980,Steve Vasturia,SR,2016-17,G,Notre Dame,ACC,36,1244,162,374,.433,104,212,58,162,.358,91,100,.910,25,116,141,119,42,4,58,75,473
3981,Jaytornah Wisseh,SO,2007-08,G,Long Island University,NEC,30,1076,158,363,.435,131,275,27,88,.307,130,163,.798,23,122,145,153,49,6,97,77,473
3982,Ron Baker,SO,2013-14,G,Wichita State,MVC,36,1075,146,320,.456,78,141,68,179,.380,112,133,.842,27,110,137,112,51,23,61,66,472
3983,Ryan Boatright,JR,2013-14,G,Connecticut,AAC,39,1264,145,371,.391,101,254,44,117,.376,138,173,.798,21,115,136,131,61,6,76,61,472
3984,Evan Boudreaux,SO,2016-17,F,Dartmouth,Ivy,27,903,166,378,.439,129,273,37,105,.352,103,148,.696,56,201,257,26,21,14,80,59,472
3985,Brandon Bowdry,SO,2008-09,F,Eastern Michigan,MAC,32,945,169,379,.446,152,319,17,60,.283,117,170,.688,75,155,230,58,27,8,124,96,472
3986,Sam Dekker,SO,2013-14,F,Wisconsin,Big Ten,38,1134,168,358,.469,126,229,42,129,.326,94,137,.686,65,166,231,52,29,22,41,52,472
3987,Alihan Demir,JR,2018-19,F,Drexel,CAA,32,969,186,363,.512,166,290,20,73,.274,80,115,.696,50,156,206,93,16,18,84,72,472
3988,Cole Dickerson,JR,2012-13,F,San Francisco,WCC,31,1024,175,369,.474,127,252,48,117,.410,74,127,.583,81,223,304,42,29,10,78,82,472
3989,Marvin Dominique,SR,2014-15,F,Saint Peter's,MAAC,34,1096,167,362,.461,130,260,37,102,.363,101,135,.748,84,162,246,17,30,22,51,89,472
3990,Malcolm Drumwright,SR,2017-18,G,Jacksonville State,OVC,36,1231,162,405,.400,89,203,73,202,.361,75,89,.843,16,74,90,130,25,2,47,72,472
3991,Perry Ellis,SO,2013-14,F,Kansas,Big 12,35,973,174,317,.549,166,300,8,17,.471,116,152,.763,72,162,234,36,29,20,40,76,472
3992,Matthew Fisher-Davis,JR,2016-17,G,Vanderbilt,SEC,34,947,145,359,.404,61,133,84,226,.372,98,121,.810,11,98,109,35,21,8,52,70,472
3993,Kyle Fogg,SR,2011-12,G,Arizona,Pac-12,35,1124,140,333,.420,68,171,72,162,.444,120,152,.789,17,114,131,76,37,13,63,78,472
3994,Joe Harden,SO,2008-09,G,UC-Davis,Big West,32,1050,143,345,.414,119,258,24,87,.276,162,203,.798,53,176,229,58,30,9,84,98,472
3995,Jordan Heading,SR,2018-19,G,California Baptist,WAC,31,1003,175,380,.461,115,214,60,166,.361,62,75,.827,14,106,120,81,19,1,86,72,472
3996,Kevin Huerter,SO,2017-18,G,Maryland,Big Ten,32,1101,162,322,.503,89,147,73,175,.417,75,99,.758,31,130,161,108,20,21,80,76,472
3997,Matt Hunter,JR,2012-13,G,Central Connecticut State,NEC,30,1116,168,425,.395,130,306,38,119,.319,98,133,.737,46,186,232,78,78,28,102,78,472
3998,A.J. Jackson,SR,2006-07,F,Robert Morris,NEC,28,991,173,371,.466,132,254,41,117,.350,85,100,.850,56,161,217,33,20,28,55,72,472
3999,Lamont Mack,SR,2008-09,F,Charlotte,A-10,31,808,160,423,.378,96,222,64,201,.318,88,124,.710,49,129,178,28,25,10,78,106,472
4000,Patrick Mills,FR,2007-08,G,Saint Mary's (CA),WCC,32,1027,161,375,.429,100,186,61,189,.323,89,117,.761,14,53,67,111,57,3,91,50,472
4001,Wesley Myers,JR,2016-17,G,Maine,AEC,28,844,164,375,.437,130,276,34,99,.343,110,142,.775,35,91,126,44,30,16,62,57,472
4002,Jacob Parker,SR,2014-15,F,Stephen F. Austin,Southland,34,922,157,307,.511,102,182,55,125,.440,103,123,.837,58,129,187,55,37,14,55,95,472
4003,Curtis Phillips,SR,2017-18,F,Tennessee Tech,OVC,33,1011,152,387,.393,91,208,61,179,.341,107,149,.718,34,137,171,72,59,20,99,69,472
4004,Jordan Poole,SO,2018-19,G,Michigan,Big Ten,37,1224,161,369,.436,86,166,75,203,.369,75,90,.833,8,102,110,80,40,8,57,74,472
4005,Stanley Pringle,SR,2008-09,G,Penn State,Big Ten,37,1140,167,369,.453,95,210,72,159,.453,66,91,.725,21,96,117,102,49,8,63,81,472
4006,Jacob Pullen,SO,2008-09,G,Kansas State,Big 12,34,1027,153,403,.380,78,179,75,224,.335,91,125,.728,25,66,91,109,54,2,98,74,472
4007,Vova Severovas,SR,2006-07,F,Oakland,Mid-Cont,33,1099,135,278,.486,135,277,0,1,.000,202,246,.821,79,109,188,71,29,0,74,86,472
4008,Joe Sherburne,SR,2018-19,G,Maryland-Baltimore County,AEC,34,1241,181,378,.479,121,223,60,155,.387,50,57,.877,56,134,190,101,29,4,61,73,472
4009,Chris Silva,JR,2017-18,F,South Carolina,SEC,33,851,127,272,.467,122,260,5,12,.417,213,283,.753,108,156,264,40,21,45,87,115,472
4010,Danny Stewart,SR,2013-14,F,Rider,MAAC,31,922,130,293,.444,105,230,25,63,.397,187,219,.854,60,134,194,30,31,13,71,96,472
4011,Trey Sumler,SO,2011-12,G,Western Carolina,Southern,35,1269,150,357,.420,101,230,49,127,.386,123,148,.831,37,133,170,145,48,2,114,76,472
4012,Marc Trasolini,JR,2010-11,F,Santa Clara,WCC,37,977,170,325,.523,143,238,27,87,.310,105,141,.745,83,143,226,29,17,35,55,107,472
4013,Noah Allen,SR,2016-17,G,Hawaii,Big West,30,907,169,358,.472,127,229,42,129,.326,91,117,.778,26,148,174,60,35,7,80,58,471
4014,Diante Baldwin,SR,2016-17,G,North Carolina-Greensboro,Southern,35,1073,171,400,.428,128,285,43,115,.374,86,118,.729,29,95,124,149,63,6,93,69,471
4015,Ryan Betley,SO,2017-18,G,Pennsylvania,Ivy,33,1106,150,355,.423,66,140,84,215,.391,87,113,.770,21,144,165,40,27,14,48,67,471
4018,Jaylen Bland,JR,2014-15,G,UC-Riverside,Big West,31,1103,151,395,.382,56,150,95,245,.388,74,92,.804,24,124,148,49,43,11,55,59,471
4019,Desmond Cambridge,SO,2018-19,G,Brown,Ivy,30,860,162,436,.372,86,197,76,239,.318,71,92,.772,15,100,115,28,30,52,52,71,471
4020,Rotnei Clarke,JR,2010-11,G,Arkansas,SEC,31,985,144,328,.439,53,120,91,208,.438,92,107,.860,10,84,94,49,24,1,38,30,471
4021,Xavier Cooks,SO,2015-16,G,Winthrop,Big South,32,883,172,332,.518,133,233,39,99,.394,88,115,.765,47,179,226,57,26,54,83,84,471
4022,JoJo Cooper,SR,2017-18,G,Wagner,NEC,33,1202,158,376,.420,119,273,39,103,.379,116,157,.739,38,135,173,201,48,1,109,72,471
4023,CJ Elleby,FR,2018-19,F,Washington State,Pac-12,32,992,168,385,.436,115,257,53,128,.414,82,124,.661,51,176,227,96,33,18,96,82,471
4024,Jordan Evans,JR,2017-18,G,Mississippi Valley State,SWAC,32,960,159,432,.368,103,270,56,162,.346,97,130,.746,28,69,97,64,33,1,63,93,471
4025,Trey Freeman,SO,2012-13,G,Campbell,Big South,33,1226,171,387,.442,148,341,23,46,.500,106,128,.828,13,94,107,190,45,2,89,72,471
4026,Justin Hare,JR,2006-07,G,Belmont,A-Sun,33,1025,156,349,.447,95,187,61,162,.377,98,125,.784,14,79,93,82,29,3,65,57,471
4027,Joseph Harris,SR,2008-09,F,Coastal Carolina,Big South,31,1022,190,330,.576,190,329,0,1,.000,91,144,.632,127,225,352,63,45,36,97,91,471
4028,Jeremy Hence,SR,2010-11,F,Army,Patriot,30,969,173,338,.512,133,224,40,114,.351,85,124,.685,62,96,158,56,24,11,73,58,471
4029,Jay Hook,JR,2013-14,G,Tulane,CUSA,34,1081,135,304,.444,52,128,83,176,.472,118,142,.831,38,134,172,25,25,0,61,81,471
4030,Jordair Jett,SR,2013-14,G,Saint Louis,A-10,34,1073,169,345,.490,162,308,7,37,.189,126,210,.600,32,105,137,164,51,18,97,63,471
4031,Isaiah Joe,FR,2018-19,G,Arkansas,SEC,34,1024,148,358,.413,35,85,113,273,.414,62,82,.756,21,73,94,58,51,5,42,64,471
4032,Louie Krogman,SR,2011-12,G,South Dakota,Summit,28,1008,166,374,.444,86,165,80,209,.383,59,85,.694,12,76,88,107,41,4,56,47,471
4033,Gani Lawal,JR,2009-10,F,Georgia Tech,ACC,36,930,172,325,.529,172,324,0,1,.000,127,222,.572,105,200,305,15,16,49,78,76,471
4034,Keddric Mays,SR,2006-07,G,Chattanooga,Southern,33,1092,149,353,.422,31,67,118,286,.413,55,74,.743,23,52,75,51,35,4,44,65,471
4035,Jalen Moore,JR,2015-16,F,Utah State,MWC,31,1091,170,387,.439,120,237,50,150,.333,81,113,.717,44,142,186,82,25,18,48,54,471
4036,Nick Muszynski,FR,2018-19,C,Belmont,OVC,32,797,198,328,.604,190,306,8,22,.364,67,86,.779,40,145,185,87,19,70,50,65,471
4037,Zach Norvell,FR,2017-18,G,Gonzaga,WCC,37,999,161,353,.456,84,145,77,208,.370,72,90,.800,39,104,143,85,42,3,58,79,471
4040,Sollie Norwood,JR,2007-08,G,Texas Southern,SWAC,32,1103,152,406,.374,72,171,80,235,.340,87,109,.798,30,94,124,34,38,1,71,52,471
4041,Corey Petros,SR,2014-15,C,Oakland,Horizon,33,1190,201,334,.602,201,333,0,1,.000,69,149,.463,108,164,272,66,17,10,50,87,471
4042,Willie Powers,JR,2009-10,G,Georgia Southern,Southern,32,1037,157,365,.430,127,263,30,102,.294,127,159,.799,27,79,106,175,41,3,118,79,471
4043,J-Mychal Reese,JR,2015-16,G,North Texas,CUSA,32,1073,164,390,.421,126,266,38,124,.306,105,138,.761,17,76,93,118,34,0,101,76,471
4044,Magnum Rolle,SR,2009-10,F,Louisiana Tech,WAC,34,1025,189,368,.514,189,368,0,0,,93,141,.660,120,166,286,28,26,71,67,95,471
4045,Myles Taylor,SO,2012-13,F,Tennessee-Martin,OVC,29,806,158,336,.470,148,305,10,31,.323,145,194,.747,78,131,209,21,25,14,60,110,471
4046,Kevin Thompson,SO,2009-10,F,Morgan State,MEAC,37,1147,186,357,.521,186,356,0,1,.000,99,165,.600,179,259,438,67,20,53,77,115,471
4047,Tristan Thompson,FR,2010-11,F,Texas,Big 12,36,1104,172,315,.546,172,315,0,0,,127,261,.487,138,144,282,45,34,86,64,100,471
4048,Jamarco Warren,JR,2009-10,G,Charleston Southern,Big South,30,989,161,409,.394,79,178,82,231,.355,67,92,.728,16,75,91,84,52,2,86,66,471
4049,Desmond Williams,JR,2016-17,F,Florida A&M,MEAC,29,936,182,377,.483,182,372,0,5,.000,107,172,.622,45,132,177,44,29,35,63,58,471
4050,James Williams,SR,2006-07,G,Long Island University,NEC,29,1012,150,399,.376,74,181,76,218,.349,95,113,.841,16,62,78,54,18,1,81,66,471
4051,Noruwa Agho,JR,2010-11,G,Columbia,Ivy,28,966,166,386,.430,125,279,41,107,.383,97,149,.651,30,108,138,119,27,16,89,63,470
4052,Ian Baker,JR,2015-16,G,New Mexico State,WAC,34,1114,156,367,.425,87,187,69,180,.383,89,109,.817,21,136,157,124,37,4,75,49,470
4053,Jimmy Baron,JR,2007-08,G,Rhode Island,A-10,33,933,149,347,.429,50,103,99,244,.406,73,80,.913,24,44,68,64,18,1,38,49,470
4054,Jacobi Boykins,JR,2016-17,G,Louisiana Tech,CUSA,32,967,153,333,.459,64,115,89,218,.408,75,93,.806,25,124,149,70,65,18,35,72,470
4055,Malcolm Brogdon,SO,2013-14,G,Virginia,ACC,37,1163,150,363,.413,106,244,44,119,.370,126,144,.875,33,168,201,101,44,5,53,71,470
4056,Dee Brown,SR,2005-06,G,Illinois,Big Ten,33,1183,157,437,.359,79,194,78,243,.321,78,103,.757,15,87,102,191,53,1,94,61,470
4057,Lorenzo Brown,SO,2011-12,G,North Carolina State,ACC,37,1268,165,367,.450,138,290,27,77,.351,113,155,.729,28,140,168,234,67,20,118,58,470
4058,Sterling Brown,SR,2016-17,G,Southern Methodist,AAC,35,1143,161,351,.459,100,215,61,136,.449,87,110,.791,55,172,227,105,50,19,69,91,470
4059,Kyvon Davenport,SR,2018-19,F,Memphis,AAC,36,940,171,341,.501,134,237,37,104,.356,91,152,.599,85,163,248,36,24,28,55,122,470
4062,Tyreek Duren,SR,2013-14,G,La Salle,A-10,31,1121,147,353,.416,89,211,58,142,.408,118,147,.803,18,87,105,108,51,9,58,61,470
4063,Erik Etherly,SR,2012-13,F,Loyola (MD),MAAC,30,1018,162,371,.437,160,361,2,10,.200,144,213,.676,63,132,195,48,45,29,70,63,470
4064,Aaron Gordon,FR,2013-14,F,Arizona,Pac-12,38,1187,189,382,.495,173,337,16,45,.356,76,180,.422,102,201,303,75,34,39,55,90,470
4065,TJ Haws,FR,2016-17,G,Brigham Young,WCC,34,1040,147,347,.424,71,159,76,188,.404,100,127,.787,9,88,97,110,34,4,86,77,470
4066,Kyle Hittle,SR,2015-16,G,Incarnate Word,Southland,29,970,158,328,.482,86,157,72,171,.421,82,112,.732,33,138,171,67,34,3,44,73,470
4067,Austin Hollins,SR,2013-14,G,Minnesota,Big Ten,38,1258,161,362,.445,97,177,64,185,.346,84,109,.771,61,128,189,91,75,19,59,69,470
4068,Demetrius Jackson,SO,2014-15,G,Notre Dame,ACC,38,1318,167,329,.508,113,203,54,126,.429,82,110,.745,44,93,137,116,59,12,57,71,470
4069,Kris Jenkins,SR,2016-17,F,Villanova,Big East,36,1118,142,370,.384,56,131,86,239,.360,100,116,.862,13,136,149,73,40,10,52,69,470
4070,Jarrod Jones,JR,2010-11,F,Ball State,MAC,32,945,181,357,.507,181,350,0,7,.000,108,161,.671,71,199,270,37,26,22,57,74,470
4071,Rob Jones,JR,2010-11,F,Saint Mary's (CA),WCC,34,1068,176,379,.464,122,216,54,163,.331,64,89,.719,60,203,263,58,36,18,70,103,470
4072,Marcus Jordan,SO,2010-11,G,Central Florida,CUSA,31,980,136,336,.405,95,208,41,128,.320,157,203,.773,13,73,86,103,27,2,89,52,470
4073,Corey Lowe,SO,2007-08,G,Boston University,AEC,26,880,164,404,.406,72,156,92,248,.371,50,82,.610,19,78,97,86,25,5,83,67,470
4074,Skylar Mays,JR,2018-19,G,Louisiana State,SEC,35,1159,143,340,.421,88,164,55,176,.313,129,150,.860,14,100,114,72,66,8,43,60,470
4075,Jalen Moore,SO,2014-15,F,Utah State,MWC,31,1066,157,319,.492,112,204,45,115,.391,111,149,.745,36,173,209,53,19,27,37,44,470
4076,Miguel Paul,JR,2011-12,G,East Carolina,CUSA,31,976,132,342,.386,64,154,68,188,.362,138,180,.767,9,53,62,183,39,3,88,76,470
4077,Adam Pegg,SR,2012-13,C,Stetson,A-Sun,30,851,193,360,.536,171,301,22,59,.373,62,92,.674,50,140,190,30,13,11,65,71,470
4078,Quinton Pippen,SR,2013-14,G,Chicago State,WAC,31,964,153,388,.394,63,145,90,243,.370,74,91,.813,22,97,119,79,57,7,70,98,470
4079,Bryce Pressley,SR,2015-16,G,Portland,WCC,32,1005,170,364,.467,107,200,63,164,.384,67,89,.753,41,105,146,78,41,17,36,64,470
4080,Omar Prewitt,SR,2016-17,G,William & Mary,CAA,30,948,175,378,.463,130,244,45,134,.336,75,116,.647,31,155,186,96,25,19,62,64,470
4081,Ryan Rossiter,JR,2009-10,F,Siena,MAAC,34,1120,172,301,.571,171,295,1,6,.167,125,163,.767,130,249,379,34,47,35,46,87,470
4084,Clint Sargent,SR,2010-11,G,South Dakota State,Summit,31,998,158,385,.410,75,172,83,213,.390,71,89,.798,14,84,98,40,17,2,31,50,470
4085,Sylvester Seay,SR,2009-10,F,Fresno State,WAC,33,971,168,372,.452,132,246,36,126,.286,98,136,.721,64,136,200,48,34,36,69,89,470
4086,Nych Smith,SR,2018-19,G,Winthrop,Big South,28,769,167,373,.448,118,226,49,147,.333,87,115,.757,12,62,74,103,15,0,67,56,470
4087,Ryan Taylor,JR,2015-16,F,Marshall,CUSA,33,882,168,303,.554,146,236,22,67,.328,112,173,.647,66,152,218,99,35,25,80,124,470
4088,Reid Travis,JR,2016-17,F,Stanford,Pac-12,27,813,176,304,.579,176,303,0,1,.000,118,181,.652,93,146,239,14,14,5,56,64,470
4089,Lagerald Vick,JR,2017-18,G,Kansas,Big 12,39,1289,187,383,.488,128,225,59,158,.373,37,55,.673,37,150,187,83,34,13,64,74,470
4090,Christian Vital,JR,2018-19,G,Connecticut,AAC,33,996,150,331,.453,71,138,79,193,.409,91,112,.813,34,151,185,79,52,1,77,82,470
4091,Corey Walden,JR,2013-14,G,Eastern Kentucky,OVC,34,1072,151,304,.497,112,184,39,120,.325,129,155,.832,25,115,140,100,76,1,69,121,470
4092,Darius Washington,SO,2005-06,G,Memphis,CUSA,35,928,153,362,.423,108,236,45,126,.357,119,152,.783,33,64,97,110,45,3,111,62,470
4093,B.J. Young,SO,2012-13,G,Arkansas,SEC,31,866,180,401,.449,155,291,25,110,.227,85,127,.669,32,78,110,105,21,8,64,52,470
4094,J.R. Blount,JR,2007-08,G,Loyola (IL),Horizon,31,1073,163,421,.387,136,307,27,114,.237,116,162,.716,41,84,125,82,38,1,82,93,469
4095,Evan Bradds,SO,2014-15,F,Belmont,OVC,33,928,185,269,.688,180,256,5,13,.385,94,145,.648,65,171,236,44,21,7,83,74,469
4096,David Caraher,FR,2017-18,G,Houston Baptist,Southland,29,908,162,356,.455,106,202,56,154,.364,89,121,.736,70,138,208,56,24,4,69,83,469
4097,Keith Clanton,SO,2010-11,F,Central Florida,CUSA,33,1006,164,310,.529,143,254,21,56,.375,120,176,.682,81,173,254,53,33,60,76,85,469
4098,Rotnei Clarke,SO,2009-10,G,Arkansas,SEC,31,1058,151,332,.455,51,98,100,234,.427,67,81,.827,5,69,74,37,36,3,36,32,469
4099,Nolan Cressler,SO,2013-14,G,Cornell,Ivy,28,912,169,411,.411,101,224,68,187,.364,63,81,.778,20,98,118,45,14,2,59,78,469
4100,Kendrick Davis,JR,2005-06,G,North Texas,Sun Belt,28,856,159,390,.408,99,218,60,172,.349,91,116,.784,16,59,75,68,42,1,68,68,469
4101,Shawntrez Davis,JR,2017-18,F,Bethune-Cookman,MEAC,32,863,181,327,.554,158,266,23,61,.377,84,142,.592,86,191,277,40,15,39,78,109,469
4102,Stacy Davis,SO,2013-14,F,Pepperdine,WCC,31,910,155,329,.471,132,280,23,49,.469,136,179,.760,66,170,236,48,14,20,68,73,469
4103,Justin Drummond,JR,2013-14,G,Toledo,MAC,33,909,146,288,.507,121,210,25,78,.321,152,208,.731,49,121,170,87,34,13,58,88,469
4104,Perry Ellis,JR,2014-15,F,Kansas,Big 12,34,978,166,363,.457,148,317,18,46,.391,119,163,.730,74,160,234,42,28,23,58,81,469
4105,Dion Harris,SR,2006-07,G,Michigan,Big Ten,35,1147,147,392,.375,75,191,72,201,.358,103,120,.858,12,72,84,127,38,3,97,66,469
4106,Jalen Henry,JR,2017-18,F,Southern Illinois-Edwardsville,OVC,29,815,157,374,.420,120,272,37,102,.363,118,165,.715,45,166,211,34,23,24,73,84,469
4107,DeQuan Hicks,SR,2013-14,F,Northwestern State,Southland,31,758,166,352,.472,164,338,2,14,.143,135,198,.682,80,146,226,82,44,19,101,78,469
4108,Keonta Howell,SR,2006-07,F,Toledo,MAC,32,1023,170,373,.456,106,192,64,181,.354,65,84,.774,38,109,147,40,37,8,53,93,469
4109,ShawnDre' Jones,JR,2015-16,G,Richmond,A-10,31,1073,157,363,.433,97,210,60,153,.392,95,115,.826,17,53,70,114,23,2,50,82,469
4110,Terrence Jones,SO,2011-12,F,Kentucky,SEC,38,1115,177,354,.500,161,305,16,49,.327,99,158,.627,96,176,272,51,49,68,62,91,469
4111,Harper Kamp,JR,2010-11,F,University of California,Pac-10,33,1085,169,320,.528,167,310,2,10,.200,129,158,.816,69,115,184,55,19,9,75,92,469
4112,Doron Lamb,FR,2010-11,G,Kentucky,SEC,38,1078,161,324,.497,93,184,68,140,.486,79,100,.790,19,56,75,62,22,6,50,85,469
4113,Jack Leasure,JR,2006-07,G,Coastal Carolina,Big South,30,1039,163,397,.411,73,155,90,242,.372,53,63,.841,13,73,86,108,46,0,59,44,469
4114,Jack Leasure,SR,2007-08,G,Coastal Carolina,Big South,28,1044,155,368,.421,44,99,111,269,.413,48,55,.873,23,98,121,64,24,3,57,43,469
4115,Jaren Lewis,SR,2018-19,F,Abilene Christian,Southland,34,1056,178,382,.466,164,340,14,42,.333,99,135,.733,77,131,208,93,54,22,60,66,469
4116,Mickey McConnell,JR,2009-10,G,Saint Mary's (CA),WCC,34,1229,159,313,.508,82,162,77,151,.510,74,88,.841,15,66,81,174,50,8,74,71,469
4117,Brandon Paul,JR,2011-12,G,Illinois,Big Ten,32,1070,145,370,.392,91,208,54,162,.333,125,172,.727,30,121,151,94,46,27,109,84,469
4118,Vasa Pusica,SR,2018-19,G,Northeastern,CAA,27,941,151,313,.482,92,165,59,148,.399,108,129,.837,11,91,102,111,40,6,85,56,469
4119,Ivan Radenovic,SR,2006-07,F,Arizona,Pac-10,31,1063,150,296,.507,131,245,19,51,.373,150,172,.872,86,150,236,64,27,18,65,73,469
4120,Brandon Reed,FR,2009-10,G,Arkansas State,Sun Belt,31,1032,168,428,.393,110,255,58,173,.335,75,106,.708,30,75,105,76,22,5,76,49,469
4121,Laquincy Rideau,SO,2016-17,G,Gardner-Webb,Big South,33,950,157,334,.470,127,257,30,77,.390,125,216,.579,45,144,189,171,100,10,112,99,469
4122,Jalen Riley,JR,2013-14,G,East Tennessee State,A-Sun,35,735,125,343,.364,75,188,50,155,.323,169,202,.837,21,67,88,64,31,6,53,76,469
4123,Jonathan Rodriguez,JR,2008-09,F,Campbell,A-Sun,30,911,163,344,.474,144,291,19,53,.358,124,157,.790,91,157,248,57,38,9,80,62,469
4126,Deville Smith,SR,2014-15,G,Tennessee-Martin,OVC,34,1220,170,410,.415,109,220,61,190,.321,68,103,.660,18,135,153,153,59,19,102,69,469
4127,Eric Smith,JR,2005-06,G,Campbell,A-Sun,28,843,149,353,.422,42,85,107,268,.399,64,93,.688,31,72,103,67,36,8,70,64,469
4128,Justin Stommes,JR,2009-10,G,Eastern Kentucky,OVC,33,1069,159,305,.521,98,158,61,147,.415,90,116,.776,10,114,124,117,32,9,76,49,469
4129,Daniel Utomi,JR,2018-19,G,Akron,MAC,33,1107,162,402,.403,69,153,93,249,.373,52,77,.675,37,143,180,42,19,13,58,83,469
4130,David Walker,JR,2014-15,G,Northeastern,CAA,35,1298,142,325,.437,73,149,69,176,.392,116,134,.866,10,111,121,126,41,10,78,28,469
4131,Demetrius Ward,JR,2010-11,G,Western Michigan,MAC,34,1087,143,352,.406,78,188,65,164,.396,118,153,.771,42,103,145,84,37,3,73,85,469
4132,Lucas Woodhouse,SR,2016-17,G,Stony Brook,AEC,31,992,146,318,.459,80,174,66,144,.458,111,127,.874,13,91,104,158,34,0,61,52,469
4133,Brandon Anderson,SO,2017-18,G,Brown,Ivy,27,915,133,352,.378,100,238,33,114,.289,169,196,.862,18,54,72,105,40,3,81,61,468
4134,Eddie Ard,SR,2007-08,G,Lipscomb,A-Sun,31,966,157,391,.402,101,230,56,161,.348,98,133,.737,25,117,142,64,39,20,73,69,468
4135,Logan Aronhalt,SO,2010-11,G,Albany (NY),AEC,32,1107,163,422,.386,90,227,73,195,.374,69,91,.758,51,100,151,43,22,9,61,40,468
4136,John Baumann,SR,2007-08,F,Columbia,Ivy,29,911,160,311,.514,135,228,25,83,.301,123,164,.750,65,129,194,31,18,9,58,75,468
4137,Dee Bost,SO,2009-10,G,Mississippi State,SEC,36,1255,147,367,.401,77,168,70,199,.352,104,144,.722,19,139,158,188,47,7,118,71,468
4138,T.J. Bray,SR,2013-14,G,Princeton,Ivy,26,920,152,283,.537,100,157,52,126,.413,112,140,.800,13,111,124,133,34,5,46,51,468
4139,Elijah Bryant,FR,2014-15,G,Elon,CAA,33,840,147,385,.382,103,259,44,126,.349,130,173,.751,45,93,138,89,42,13,115,87,468
4140,Johnnie Bryant,SR,2007-08,G,Utah,MWC,33,891,160,325,.492,71,124,89,201,.443,59,64,.922,8,65,73,39,26,0,40,63,468
4141,Desmond Cambridge,FR,2017-18,G,Brown,Ivy,27,809,160,399,.401,92,196,68,203,.335,80,104,.769,25,97,122,33,29,27,39,77,468
4142,Josh Cameron,JR,2013-14,G,Coastal Carolina,Big South,34,946,147,379,.388,81,205,66,174,.379,108,143,.755,11,75,86,86,33,8,93,72,468
4143,Josh Carter,SR,2008-09,F,Texas A&M,Big 12,34,1041,143,330,.433,66,137,77,193,.399,105,124,.847,36,111,147,59,28,8,38,48,468
4144,Elgin Cook,JR,2014-15,F,Oregon,Pac-12,36,1059,169,325,.520,164,305,5,20,.250,125,171,.731,52,136,188,59,38,6,80,117,468
4145,Isaiah Cousins,SR,2015-16,G,Oklahoma,Big 12,37,1232,169,416,.406,104,258,65,158,.411,65,97,.670,23,142,165,168,51,10,88,63,468
4148,Jon Diebler,SR,2010-11,G,Ohio State,Big Ten,37,1320,145,286,.507,31,59,114,227,.502,64,79,.810,14,84,98,88,36,5,35,37,468
4149,Jacob Evans,JR,2017-18,G,Cincinnati,AAC,36,1107,161,377,.427,101,215,60,162,.370,86,114,.754,50,120,170,113,47,35,63,72,468
4150,Demetrious Floyd,SR,2015-16,G,Stephen F. Austin,Southland,34,832,173,375,.461,73,139,100,236,.424,22,31,.710,9,43,52,50,40,3,32,45,468
4151,Roberto Gallinat,JR,2017-18,G,Pacific,WCC,32,1023,153,349,.438,102,190,51,159,.321,111,144,.771,26,64,90,37,20,7,47,79,468
4152,Greg Gantt,FR,2009-10,G,Florida Atlantic,Sun Belt,30,929,166,390,.426,81,172,85,218,.390,51,72,.708,31,42,73,31,20,3,24,39,468
4153,Adam Grant,JR,2018-19,G,Bryant,NEC,30,1065,162,393,.412,82,186,80,207,.386,64,81,.790,25,63,88,46,34,3,56,67,468
4154,Mike Groselle,SR,2012-13,C,The Citadel,Southern,30,952,189,329,.574,189,329,0,0,,90,121,.744,93,135,228,47,39,18,66,73,468
4155,Richard Hendrix,SO,2006-07,F,Alabama,SEC,32,883,186,309,.602,185,304,1,5,.200,95,151,.629,106,173,279,60,17,41,69,96,468
4156,Solomon Hill,SR,2012-13,F,Arizona,Pac-12,35,1154,158,345,.458,101,199,57,146,.390,95,124,.766,61,126,187,95,40,20,77,76,468
4157,Kerron Johnson,JR,2011-12,G,Belmont,A-Sun,34,972,145,280,.518,121,202,24,78,.308,154,201,.766,22,83,105,177,48,1,81,80,468
4158,Mike Jones,SR,2006-07,G,Maryland,ACC,34,884,167,356,.469,86,172,81,184,.440,53,67,.791,29,81,110,47,28,8,49,65,468
4159,Devoe Joseph,SR,2011-12,G,Oregon,Pac-12,28,989,166,351,.473,100,193,66,158,.418,70,88,.795,18,87,105,91,38,4,52,43,468
4160,Daniel Kickert,SR,2005-06,F,Saint Mary's (CA),WCC,28,937,157,346,.454,98,217,59,129,.457,95,108,.880,32,124,156,29,17,19,70,66,468
4161,Egor Koulechov,SR,2017-18,G,Florida,SEC,34,1040,161,390,.413,91,213,70,177,.395,76,88,.864,57,161,218,40,21,4,44,74,468
4162,David Lighty,JR,2009-10,G,Ohio State,Big Ten,37,1344,164,333,.492,120,218,44,115,.383,96,152,.632,53,115,168,110,58,20,85,90,468
4163,James McGee,JR,2016-17,G,Southern Utah,Big Sky,33,1116,138,345,.400,37,105,101,240,.421,91,126,.722,16,72,88,84,27,4,59,83,468
4164,Tymell Murphy,JR,2012-13,F,Florida International,Sun Belt,32,974,196,342,.573,184,304,12,38,.316,64,95,.674,75,143,218,62,55,36,81,90,468
4165,Divine Myles,SO,2015-16,G,Stetson,A-Sun,34,1103,174,341,.510,148,273,26,68,.382,94,142,.662,22,132,154,143,46,4,57,76,468
4166,Laquincy Rideau,JR,2018-19,G,South Florida,AAC,35,1124,162,396,.409,108,236,54,160,.338,90,164,.549,33,98,131,189,101,5,126,125,468
4167,Yettra Specks,SR,2016-17,G,Jackson State,SWAC,32,1175,143,377,.379,73,163,70,214,.327,112,131,.855,23,80,103,85,37,4,59,78,468
4170,Kevin Tiggs,JR,2007-08,F,East Tennessee State,A-Sun,32,949,170,310,.548,160,279,10,31,.323,118,150,.787,92,85,177,50,48,6,102,77,468
4171,Lucas Troutman,JR,2012-13,F,Elon,Southern,31,819,194,355,.546,194,353,0,2,.000,80,119,.672,62,101,163,20,37,64,64,73,468
4172,B.J. Tyson,SO,2015-16,G,East Carolina,AAC,32,1071,173,412,.420,129,262,44,150,.293,78,106,.736,25,116,141,82,31,4,73,55,468
4173,Dimencio Vaughn,FR,2017-18,G,Rider,MAAC,29,804,164,323,.508,137,246,27,77,.351,113,148,.764,74,119,193,31,53,21,69,83,468
4174,Harold Washington,SR,2012-13,G,Canisius,MAAC,34,1089,152,345,.441,93,201,59,144,.410,105,137,.766,22,65,87,77,31,2,98,69,468
4175,Kaleb Wesson,SO,2018-19,F,Ohio State,Big Ten,32,829,156,312,.500,130,237,26,75,.347,130,177,.734,77,144,221,59,33,21,73,103,468
4176,Nigel Williams-Goss,SO,2014-15,G,Washington,Pac-12,30,1104,186,421,.442,164,335,22,86,.256,74,97,.763,20,121,141,177,33,5,85,56,468
4177,Ray Willis,JR,2011-12,G,North Carolina Central,MEAC,32,1036,137,317,.432,113,241,24,76,.316,170,214,.794,37,142,179,87,43,23,110,74,468
4178,Rosco Allen,SR,2015-16,F,Stanford,Pac-12,30,1018,142,335,.424,86,169,56,166,.337,127,172,.738,48,146,194,50,35,5,60,84,467
4179,Udoka Azubuike,SO,2017-18,C,Kansas,Big 12,36,848,211,274,.770,211,274,0,0,,45,109,.413,87,165,252,24,20,60,63,108,467
4180,Jimmy Baron,SO,2006-07,G,Rhode Island,A-10,32,905,149,306,.487,52,103,97,203,.478,72,81,.889,14,55,69,63,16,0,42,40,467
4181,Jamari Blackmon,FR,2018-19,G,North Alabama,A-Sun,32,1130,137,421,.325,69,187,68,234,.291,125,163,.767,26,85,111,87,56,6,60,82,467
4182,De'Mon Brooks,JR,2012-13,F,Davidson,Southern,34,919,170,340,.500,161,299,9,41,.220,118,158,.747,76,135,211,26,30,21,66,98,467
4183,Remond Brown,SR,2016-17,G,Grambling,SWAC,33,1087,183,396,.462,148,291,35,105,.333,66,100,.660,38,109,147,59,61,14,84,73,467
4184,Tyler Brown,JR,2011-12,G,Illinois State,MVC,34,1053,153,337,.454,74,163,79,174,.454,82,104,.788,27,101,128,79,34,4,86,62,467
4185,Wayne Chism,JR,2008-09,F,Tennessee,SEC,34,873,165,354,.466,124,226,41,128,.320,96,134,.716,94,179,273,42,26,34,69,98,467
4186,Wayne Chism,SR,2009-10,F,Tennessee,SEC,37,998,169,363,.466,134,255,35,108,.324,94,124,.758,74,192,266,40,41,48,60,102,467
4187,Marquese Chriss,FR,2015-16,F,Washington,Pac-12,34,848,179,338,.530,158,278,21,60,.350,88,129,.682,85,98,183,26,32,55,69,138,467
4188,Aaron Cosby,SR,2015-16,G,Western Kentucky,CUSA,34,1073,137,390,.351,56,169,81,221,.367,112,131,.855,16,108,124,67,15,5,67,47,467
4189,Jason Flagler,SR,2009-10,G,South Carolina State,MEAC,31,1066,201,366,.549,200,363,1,3,.333,64,74,.865,42,128,170,33,20,11,46,65,467
4192,Stone Gettings,JR,2017-18,F,Cornell,Ivy,28,749,165,339,.487,122,222,43,117,.368,94,114,.825,39,147,186,80,20,13,63,79,467
4193,Javonte Green,SO,2012-13,F,Radford,Big South,32,885,178,353,.504,173,327,5,26,.192,106,179,.592,94,164,258,43,66,23,66,88,467
4194,Michael Hale,JR,2012-13,G,Texas-San Antonio,WAC,30,1087,148,371,.399,89,204,59,167,.353,112,148,.757,15,77,92,115,44,0,82,72,467
4195,Jaylen Hands,SO,2018-19,G,UCLA,Pac-12,33,1029,158,383,.413,92,206,66,177,.373,85,109,.780,12,109,121,201,44,5,105,40,467
4196,Braxton Huggins,JR,2016-17,G,New Mexico State,WAC,34,940,140,319,.439,51,107,89,212,.420,98,121,.810,15,75,90,45,11,8,52,63,467
4197,Desmar Jackson,SR,2012-13,G,Southern Illinois,MVC,31,923,168,383,.439,130,264,38,119,.319,93,135,.689,49,118,167,61,58,15,84,90,467
4198,Ben Jacobson,SR,2005-06,G,Northern Iowa,MVC,33,1196,158,406,.389,100,229,58,177,.328,93,120,.775,18,111,129,124,51,5,86,53,467
4199,Shawn Jones,SR,2013-14,F,Middle Tennessee,CUSA,33,930,183,317,.577,183,316,0,1,.000,101,147,.687,99,180,279,20,30,63,48,91,467
4200,Jared Jordan,JR,2005-06,G,Marist,MAAC,29,1130,167,343,.487,106,180,61,163,.374,72,97,.742,32,106,138,247,50,1,92,46,467
4201,Colter Lasher,SR,2016-17,F,Houston Baptist,Southland,31,904,167,385,.434,109,224,58,161,.360,75,97,.773,27,101,128,86,29,16,65,61,467
4202,Gani Lawal,SO,2008-09,F,Georgia Tech,ACC,31,919,184,331,.556,184,330,0,1,.000,99,177,.559,111,183,294,19,31,46,79,80,467
4203,Adam Leonard,JR,2009-10,G,Missouri State,MVC,36,1178,149,375,.397,46,111,103,264,.390,66,84,.786,6,79,85,78,20,1,55,41,467
4204,Tyrone Lewis,SO,2007-08,G,Niagara,MAAC,29,1011,149,381,.391,86,182,63,199,.317,106,150,.707,45,76,121,57,58,17,65,85,467
4205,Derrick Low,JR,2006-07,G,Washington State,Pac-10,34,1170,166,372,.446,91,184,75,188,.399,60,76,.789,8,65,73,73,45,5,46,62,467
4206,Harris Mansell,JR,2007-08,G,Rider,MAAC,34,1044,148,325,.455,68,146,80,179,.447,91,117,.778,24,86,110,64,32,4,55,69,467
4207,Koby McEwen,SO,2017-18,G,Utah State,MWC,30,970,150,375,.400,83,172,67,203,.330,100,138,.725,13,150,163,97,23,1,89,78,467
4208,Tyrell Nelson,JR,2015-16,F,Gardner-Webb,Big South,33,898,181,324,.559,176,307,5,17,.294,100,163,.613,102,150,252,53,21,26,86,87,467
4209,David Nichols,JR,2017-18,G,Albany (NY),AEC,32,1082,166,421,.394,109,265,57,156,.365,78,101,.772,16,120,136,111,37,7,80,84,467
4210,Chris Perez,JR,2012-13,G,Stetson,A-Sun,31,949,172,354,.486,149,280,23,74,.311,100,149,.671,58,69,127,58,35,0,81,86,467
4211,Lance Perique,SR,2006-07,F,Georgia State,CAA,30,949,157,321,.489,143,274,14,47,.298,139,205,.678,57,94,151,30,19,7,82,78,467
4212,Steffphon Pettigrew,SR,2010-11,F,Western Kentucky,Sun Belt,32,1085,182,372,.489,152,270,30,102,.294,73,127,.575,83,111,194,42,24,20,64,88,467
4213,Will Rayman,FR,2016-17,F,Colgate,Patriot,32,941,154,347,.444,89,183,65,164,.396,94,136,.691,45,102,147,31,22,13,69,91,467
4214,Cameron Reynolds,SR,2017-18,G,Tulane,AAC,31,1117,171,419,.408,110,246,61,173,.353,64,91,.703,36,160,196,68,24,18,47,77,467
4215,Erik Rush,SR,2010-11,G,Montana State,Big Sky,31,987,150,349,.430,112,223,38,126,.302,129,183,.705,35,93,128,88,43,9,72,75,467
4216,Jarvis Threatt,JR,2013-14,G,Delaware,CAA,26,964,138,334,.413,128,288,10,46,.217,181,262,.691,35,116,151,141,64,4,66,55,467
4217,Jerome Tillman,SO,2006-07,F,Ohio,MAC,32,1037,162,289,.561,139,238,23,51,.451,120,176,.682,97,164,261,42,31,15,57,93,467
4218,Jordon Varnado,JR,2017-18,F,Troy,Sun Belt,26,810,174,364,.478,148,274,26,90,.289,93,126,.738,49,134,183,44,18,36,56,71,467
4219,Dion Waiters,SO,2011-12,G,Syracuse,Big East,37,891,170,357,.476,129,244,41,113,.363,86,118,.729,18,67,85,92,67,12,48,69,467
4220,Gary Wilkinson,JR,2007-08,F,Utah State,WAC,35,976,174,298,.584,165,266,9,32,.281,110,135,.815,73,173,246,41,16,22,63,70,467
4221,Terry Winn,SR,2018-19,F,Texas-Rio Grande Valley,WAC,37,1097,166,373,.445,165,360,1,13,.077,134,188,.713,30,143,173,60,35,6,83,64,467
4222,Wade Baldwin,SO,2015-16,G,Vanderbilt,SEC,33,1002,135,316,.427,94,215,41,101,.406,155,194,.799,13,119,132,172,40,11,91,85,466
4223,Levi Bradley,JR,2017-18,F,Northern Illinois,MAC,32,947,162,379,.427,136,286,26,93,.280,116,140,.829,41,135,176,24,28,8,42,88,466
4224,Darien Brothers,JR,2011-12,G,Richmond,A-10,32,971,146,345,.423,78,164,68,181,.376,106,119,.891,19,75,94,53,28,2,44,74,466
4225,Omar Carter,FR,2007-08,G,Charleston Southern,Big South,30,835,165,375,.440,110,222,55,153,.359,81,110,.736,56,139,195,50,36,6,72,75,466
4226,Warren Carter,SR,2006-07,F,Illinois,Big Ten,34,1047,167,344,.485,136,270,31,74,.419,101,142,.711,61,148,209,68,24,32,90,87,466
4227,Tahj Eaddy,SO,2018-19,G,Santa Clara,WCC,31,1099,152,379,.401,75,176,77,203,.379,85,106,.802,9,74,83,98,28,0,62,63,466
4228,Roderick Flemings,SR,2009-10,F,Hawaii,WAC,28,988,173,398,.435,155,323,18,75,.240,102,156,.654,59,115,174,63,21,10,58,64,466
4229,Jarell Flora,SR,2014-15,G,Seattle,WAC,34,1097,166,383,.433,86,185,80,198,.404,54,66,.818,19,125,144,51,29,9,73,50,466
4230,Dairese Gary,SR,2010-11,G,New Mexico,MWC,33,1117,134,279,.480,99,175,35,104,.337,163,209,.780,21,84,105,182,43,1,92,76,466
4231,Archie Goodwin,FR,2012-13,G,Kentucky,SEC,33,1048,157,357,.440,140,293,17,64,.266,135,212,.637,48,104,152,88,36,15,101,97,466
4234,Bobby Hain,JR,2014-15,F,Youngstown State,Horizon,32,1018,181,352,.514,174,321,7,31,.226,97,137,.708,75,163,238,65,18,20,56,82,466
4235,Damon Heuir,SR,2012-13,G,Southern Utah,Big Sky,30,932,147,397,.370,90,223,57,174,.328,115,150,.767,36,84,120,96,24,6,100,74,466
4236,Leonard Houston,SR,2007-08,G,Drake,MVC,33,1042,156,370,.422,101,210,55,160,.344,99,129,.767,46,101,147,60,47,8,64,57,466
4237,Elijah Hughes,JR,2018-19,F,Syracuse,ACC,34,1111,155,369,.420,68,133,87,236,.369,69,93,.742,23,124,147,50,42,27,63,72,466
4238,Sylven Landesberg,SO,2009-10,G,Virginia,ACC,27,868,166,375,.443,143,315,23,60,.383,111,137,.810,37,95,132,77,21,8,61,57,466
4239,Kevin Larsen,SR,2015-16,F,George Washington,A-10,38,1287,165,331,.498,148,295,17,36,.472,119,165,.721,108,204,312,100,36,27,70,83,466
4240,Nathaniel Lester,SR,2011-12,F,Hofstra,CAA,32,1036,153,385,.397,134,312,19,73,.260,141,183,.770,92,117,209,32,43,15,56,81,466
4241,JaVale McGee,SO,2007-08,F,Nevada,WAC,33,902,189,357,.529,175,315,14,42,.333,74,141,.525,83,159,242,20,26,92,80,82,466
4242,Jordan McLaughlin,JR,2016-17,G,Southern California,Pac-12,36,1228,162,353,.459,115,236,47,117,.402,95,119,.798,29,99,128,197,53,4,80,35,466
4243,Kojo Mensah,SO,2005-06,G,Siena,MAAC,28,984,146,336,.435,137,298,9,38,.237,165,232,.711,87,88,175,114,71,5,102,62,466
4244,Nic Moore,SR,2015-16,G,Southern Methodist,AAC,29,996,153,364,.420,77,180,76,184,.413,84,105,.800,9,61,70,152,39,3,66,64,466
4245,Demetris Nichols,JR,2005-06,F,Syracuse,Big East,35,1164,165,386,.427,92,185,73,201,.363,63,93,.677,61,143,204,50,45,33,63,96,466
4246,Alex Petrie,FR,2017-18,G,Lafayette,Patriot,31,772,156,358,.436,88,190,68,168,.405,86,95,.905,9,66,75,23,14,0,58,22,466
4247,Jordan Reed,FR,2012-13,G,Binghamton,AEC,28,987,165,422,.391,158,371,7,51,.137,129,194,.665,81,185,266,40,27,17,96,64,466
4248,Richard Roby,JR,2006-07,G,Colorado,Big 12,27,867,158,412,.383,121,274,37,138,.268,113,154,.734,49,89,138,59,33,12,91,55,466
4249,Joey Rodriguez,JR,2009-10,G,Virginia Commonwealth,CAA,36,1184,157,361,.435,100,198,57,163,.350,95,118,.805,28,69,97,208,67,0,98,60,466
4250,Brenton Scott,SO,2015-16,G,Indiana State,MVC,32,978,158,392,.403,82,194,76,198,.384,74,96,.771,20,111,131,42,39,7,57,55,466
4251,Ryan Taylor,SO,2016-17,G,Evansville,MVC,33,1032,167,382,.437,113,238,54,144,.375,78,92,.848,24,71,95,50,19,16,42,80,466
4252,Demond Watt,SR,2010-11,F,Texas A&M-Corpus Christi,Southland,31,1035,164,283,.580,164,282,0,1,.000,138,212,.651,115,160,275,44,33,40,87,58,466
4253,James Williams,JR,2005-06,G,Long Island University,NEC,28,961,144,344,.419,55,131,89,213,.418,89,108,.824,11,59,70,92,24,2,92,72,466
4256,Holland Woods,SO,2018-19,G,Portland State,Big Sky,31,1104,149,374,.398,111,241,38,133,.286,130,167,.778,12,82,94,165,49,2,110,69,466
4257,Greer Wright,JR,2009-10,F,Binghamton,AEC,31,1034,152,350,.434,111,216,41,134,.306,121,161,.752,48,139,187,98,37,18,116,105,466
4258,O.D. Anosike,JR,2011-12,F,Siena,MAAC,31,1142,184,351,.524,184,351,0,0,,97,172,.564,135,253,388,33,35,31,75,79,465
4259,Brandon Ashley,JR,2014-15,F,Arizona,Pac-12,38,1055,166,323,.514,154,287,12,36,.333,121,172,.703,69,128,197,25,23,25,55,107,465
4260,Brian Barbour,JR,2011-12,G,Columbia,Ivy,30,1068,141,358,.394,104,247,37,111,.333,146,162,.901,16,67,83,133,30,3,69,46,465
4261,Connor Cashaw,JR,2017-18,G,Rice,CUSA,30,1008,158,397,.398,107,237,51,160,.319,98,135,.726,42,172,214,96,40,2,65,60,465
4262,Hayden Dalton,JR,2016-17,F,Wyoming,MWC,38,1018,141,327,.431,89,177,52,150,.347,131,157,.834,53,263,316,99,17,34,100,98,465
4263,Byron Davis,SR,2007-08,G,Youngstown State,Horizon,30,1063,175,388,.451,131,252,44,136,.324,71,103,.689,28,62,90,71,33,6,86,69,465
4264,Justin Doellman,SR,2006-07,F,Xavier,A-10,34,919,164,331,.495,122,215,42,116,.362,95,120,.792,48,140,188,57,30,39,56,106,465
4265,Arturo Dubois,SO,2005-06,F,Manhattan,MAAC,31,1002,197,352,.560,197,352,0,0,,71,135,.526,99,166,265,31,39,74,65,119,465
4266,Junior Etou,SR,2017-18,F,Tulsa,AAC,31,942,145,311,.466,103,191,42,120,.350,133,186,.715,77,167,244,47,16,8,72,66,465
4267,Montell Goodwin,SR,2017-18,G,Eastern Illinois,OVC,31,1100,164,411,.399,91,208,73,203,.360,64,83,.771,15,89,104,103,34,12,61,46,465
4268,E.J. Gordon,SR,2005-06,G,Stetson,A-Sun,30,913,161,363,.444,158,350,3,13,.231,140,187,.749,61,133,194,92,61,13,99,78,465
4269,Jerian Grant,JR,2012-13,G,Notre Dame,Big East,35,1270,156,384,.406,104,233,52,151,.344,101,137,.737,12,89,101,194,44,8,100,62,465
4270,Jamie Harris,JR,2009-10,G,Drexel,CAA,32,1128,164,413,.397,129,302,35,111,.315,102,128,.797,18,53,71,110,32,1,79,88,465
4271,Marcus Jackson,SO,2014-15,G,Rice,CUSA,32,1013,153,370,.414,68,156,85,214,.397,74,89,.831,25,86,111,87,27,4,74,66,465
4272,Abdulai Jalloh,JR,2007-08,G,James Madison,CAA,30,874,139,342,.406,84,200,55,142,.387,132,166,.795,39,126,165,87,50,11,125,102,465
4273,Curtis Jerrells,SO,2006-07,G,Baylor,Big 12,31,1019,157,356,.441,100,200,57,156,.365,94,139,.676,35,112,147,118,33,11,85,52,465
4274,James Johnson,SO,2008-09,F,Wake Forest,ACC,31,946,187,345,.542,165,276,22,69,.319,69,99,.697,79,185,264,62,44,48,74,91,465
4275,Kenny Kadji,SR,2012-13,F,Miami (FL),ACC,36,1047,168,357,.471,121,223,47,134,.351,82,124,.661,56,188,244,30,14,46,63,87,465
4278,Codi Miller-McIntyre,JR,2014-15,G,Wake Forest,ACC,32,1007,167,371,.450,148,304,19,67,.284,112,174,.644,27,126,153,137,32,11,80,57,465
4279,Tasmin Mitchell,SO,2006-07,F,Louisiana State,SEC,32,1092,173,371,.466,132,262,41,109,.376,78,104,.750,60,129,189,59,34,25,55,76,465
4280,Amorrow Morgan,SR,2009-10,G,Idaho State,Big Sky,28,972,159,344,.462,130,265,29,79,.367,118,170,.694,22,81,103,45,24,3,89,53,465
4281,DeMarcus Nelson,JR,2006-07,G,Duke,ACC,33,1052,174,364,.478,130,243,44,121,.364,73,123,.593,45,132,177,66,44,17,82,76,465
4282,Brockeith Pane,SR,2011-12,G,Utah State,WAC,37,1194,164,405,.405,135,309,29,96,.302,108,139,.777,14,97,111,159,27,7,107,88,465
4283,Charles Rhodes,JR,2006-07,F,Mississippi State,SEC,34,896,180,325,.554,174,306,6,19,.316,99,141,.702,76,136,212,27,17,64,82,91,465
4284,Kassius Robertson,SO,2015-16,G,Canisius,MAAC,33,1121,153,350,.437,67,137,86,213,.404,73,100,.730,34,59,93,59,36,2,77,73,465
4285,Parker Smith,JR,2011-12,G,North Florida,A-Sun,32,877,143,329,.435,47,95,96,234,.410,83,99,.838,9,69,78,33,21,3,59,50,465
4286,Frankie Sullivan,SR,2012-13,G,Auburn,SEC,32,998,148,403,.367,92,201,56,202,.277,113,143,.790,15,109,124,90,33,9,98,83,465
4287,Tony Taylor,JR,2010-11,G,George Washington,A-10,31,1034,149,353,.422,109,235,40,118,.339,127,183,.694,17,85,102,144,40,1,81,71,465
4288,Torey Thomas,SR,2006-07,G,Holy Cross,Patriot,34,1279,131,349,.375,83,230,48,119,.403,155,201,.771,22,139,161,160,95,0,135,92,465
4289,Killian Tillie,SO,2017-18,F,Gonzaga,WCC,36,944,181,312,.580,136,218,45,94,.479,58,75,.773,61,151,212,60,30,37,57,88,465
4290,Mark Tyndale,JR,2006-07,G,Temple,A-10,24,821,164,304,.539,140,248,24,56,.429,113,159,.711,50,110,160,68,37,11,65,58,465
4291,Gabe Vincent,SO,2015-16,G,UC-Santa Barbara,Big West,33,1055,163,401,.406,83,193,80,208,.385,59,73,.808,20,86,106,74,41,6,57,93,465
4292,Mark Walters,SR,2005-06,G,New Mexico,MWC,30,974,154,353,.436,97,202,57,151,.377,100,142,.704,31,104,135,92,62,10,78,86,465
4293,Maurice Watson,SO,2013-14,G,Boston University,Patriot,35,1090,189,382,.495,161,299,28,83,.337,59,94,.628,20,106,126,248,74,0,101,87,465
4294,Rodney Williams,JR,2011-12,F,Minnesota,Big Ten,38,1213,185,328,.564,168,273,17,55,.309,78,132,.591,62,150,212,66,50,54,59,103,465
4295,Raeford Worsham,SR,2015-16,G,Jackson State,SWAC,35,1109,173,336,.515,170,316,3,20,.150,116,196,.592,104,165,269,75,61,28,77,98,465
4296,Daniel Amigo,JR,2016-17,C,Denver,Summit,30,748,182,340,.535,173,324,9,16,.563,91,139,.655,50,163,213,41,8,18,80,107,464
4297,Andrew Andrews,JR,2014-15,G,Washington,Pac-12,31,1047,140,347,.403,75,174,65,173,.376,119,146,.815,32,100,132,67,44,1,61,81,464
4300,Eddie Ard,JR,2006-07,G,Lipscomb,A-Sun,31,985,152,372,.409,114,252,38,120,.317,122,146,.836,48,132,180,52,43,14,79,66,464
4301,Jamel Artis,SO,2014-15,F,Pittsburgh,ACC,34,1082,160,341,.469,121,242,39,99,.394,105,132,.795,67,138,205,77,25,15,60,63,464
4302,Damen Bell-Holter,SO,2010-11,F,Oral Roberts,Summit,35,1065,160,313,.511,147,279,13,34,.382,131,180,.728,96,178,274,51,19,50,65,90,464
4303,Anatoly Bose,SO,2008-09,G,Nicholls State,Southland,31,981,144,307,.469,72,135,72,172,.419,104,138,.754,51,117,168,62,25,2,68,73,464
4304,Terrell Brown,SO,2018-19,G,Seattle,WAC,33,1101,180,396,.455,166,352,14,44,.318,90,132,.682,47,179,226,150,36,9,79,89,464
4305,Mario Chalmers,SO,2006-07,G,Kansas,Big 12,38,1108,159,324,.491,100,178,59,146,.404,87,113,.770,11,104,115,124,97,16,91,95,464
4306,Gary Clark,SR,2017-18,F,Cincinnati,AAC,36,1025,160,304,.526,133,242,27,62,.435,117,158,.741,107,206,313,76,51,44,36,75,464
4307,D.J. Covington,JR,2012-13,F,Virginia Military Institute,Big South,31,905,190,339,.560,189,332,1,7,.143,83,128,.648,93,131,224,26,39,93,64,93,464
4308,Chris De La Rosa,JR,2010-11,G,Maryland-Baltimore County,AEC,30,1074,167,422,.396,129,303,38,119,.319,92,130,.708,20,98,118,181,30,0,85,60,464
4309,Angel Delgado,SR,2017-18,C,Seton Hall,Big East,34,1049,187,370,.505,187,368,0,2,.000,90,147,.612,137,265,402,94,26,23,85,77,464
4310,Chris Devine,SR,2008-09,F,UC-Santa Barbara,Big West,30,908,163,316,.516,157,284,6,32,.188,132,171,.772,68,128,196,43,32,11,91,69,464
4311,Justin Greene,SO,2009-10,F,Kent State,MAC,34,957,158,290,.545,158,290,0,0,,148,185,.800,86,147,233,45,27,30,70,73,464
4312,Max Hazzard,JR,2018-19,G,UC-Irvine,Big West,37,976,159,386,.412,66,146,93,240,.388,53,68,.779,17,57,74,76,25,1,47,48,464
4313,Lawrence Hill,SR,2008-09,F,Stanford,Pac-10,34,1059,182,362,.503,161,297,21,65,.323,79,114,.693,68,131,199,76,31,17,57,71,464
4314,Jabarie Hinds,SR,2015-16,G,Massachusetts,A-10,32,947,176,383,.460,128,253,48,130,.369,64,87,.736,14,61,75,96,47,7,54,67,464
4315,Justin Ingram,SR,2006-07,G,Toledo,MAC,32,1125,155,417,.372,86,185,69,232,.297,85,111,.766,18,123,141,91,67,9,72,71,464
4316,Justin Johnson,JR,2016-17,F,Western Kentucky,CUSA,32,1005,173,331,.523,147,264,26,67,.388,92,166,.554,83,219,302,66,11,18,42,45,464
4317,Sylven Landesberg,FR,2008-09,G,Virginia,ACC,28,957,150,344,.436,134,293,16,51,.314,148,186,.796,47,122,169,78,28,3,77,49,464
4318,Amadi McKenzie,SR,2007-08,F,Tennessee Tech,OVC,32,963,178,301,.591,170,276,8,25,.320,100,173,.578,103,165,268,55,30,9,79,89,464
4319,Daxter Miles,SR,2017-18,G,West Virginia,Big 12,36,1047,160,358,.447,99,182,61,176,.347,83,112,.741,44,57,101,110,47,0,51,110,464
4320,Dwayne Mitchell,SR,2005-06,G,Louisiana,Sun Belt,28,1028,176,336,.524,162,280,14,56,.250,98,166,.590,65,165,230,120,59,9,128,70,464
4321,John Mooney,JR,2018-19,F,Notre Dame,ACC,33,977,170,374,.455,136,283,34,91,.374,90,117,.769,97,273,370,44,29,27,44,65,464
4322,Ashton Moore,JR,2013-14,G,The Citadel,Southern,33,1070,150,386,.389,80,216,70,170,.412,94,120,.783,16,95,111,120,33,3,82,64,464
4323,Grant Mullins,SR,2015-16,G,Columbia,Ivy,35,1090,141,301,.468,72,144,69,157,.439,113,136,.831,17,115,132,116,28,5,46,80,464
4324,Derek Needham,SO,2010-11,G,Fairfield,MAAC,33,1161,150,420,.357,77,184,73,236,.309,91,130,.700,14,85,99,150,47,1,128,89,464
4325,Nathan Peavy,SR,2006-07,F,Miami (OH),MAC,33,1122,165,312,.529,140,243,25,69,.362,109,149,.732,46,163,209,31,24,39,61,97,464
4326,Jesse Pellot-Rosa,SR,2006-07,G,Virginia Commonwealth,CAA,35,925,152,339,.448,86,184,66,155,.426,94,117,.803,71,87,158,48,39,15,55,78,464
4327,T.J. Price,JR,2013-14,G,Western Kentucky,Sun Belt,30,887,153,371,.412,81,170,72,201,.358,86,111,.775,28,104,132,58,28,3,63,83,464
4328,Brandon Provost,SR,2012-13,G,Texas-Rio Grande Valley,GWC,31,1055,135,307,.440,54,124,81,183,.443,113,141,.801,17,114,131,67,32,9,62,43,464
4329,Chasson Randle,SO,2012-13,G,Stanford,Pac-12,34,1054,156,391,.399,95,221,61,170,.359,91,116,.784,23,77,100,89,38,2,78,99,464
4330,Alex Robinson,SR,2018-19,G,Texas Christian,Big 12,37,1290,169,394,.429,131,272,38,122,.311,88,135,.652,14,129,143,254,52,12,129,84,464
4331,Nate Rohnert,SR,2009-10,G,Denver,Sun Belt,32,1045,141,285,.495,116,208,25,77,.325,157,211,.744,25,157,182,123,39,5,78,79,464
4332,Josh Shipp,SO,2006-07,F,UCLA,Pac-10,35,1055,168,358,.469,126,225,42,133,.316,86,110,.782,41,94,135,92,47,9,63,59,464
4333,Chris Smith,SR,2015-16,G,Utah State,MWC,31,960,161,326,.494,98,186,63,140,.450,79,106,.745,43,120,163,64,25,12,50,66,464
4334,Delano Spencer,SR,2017-18,G,Tennessee State,OVC,30,984,152,348,.437,67,147,85,201,.423,75,90,.833,17,76,93,38,34,2,55,56,464
4335,Jarvis Varnado,JR,2008-09,F,Mississippi State,SEC,36,1012,180,328,.549,180,327,0,1,.000,104,159,.654,103,214,317,28,22,170,60,83,464
4336,Drew Viney,JR,2010-11,F,Loyola Marymount,WCC,27,910,167,349,.479,129,248,38,101,.376,92,120,.767,37,140,177,48,23,26,78,71,464
4337,Kyle Washington,JR,2016-17,F,Cincinnati,AAC,36,889,184,361,.510,169,319,15,42,.357,81,114,.711,78,165,243,31,13,42,54,91,464
4338,Mike Washington,JR,2008-09,F,Arkansas,SEC,30,901,178,323,.551,173,293,5,30,.167,103,171,.602,105,189,294,27,29,39,62,92,464
4339,Devin Williams,JR,2015-16,F,West Virginia,Big 12,35,889,154,330,.467,154,330,0,0,,156,225,.693,124,208,332,49,25,6,80,89,464
4342,Troy Williams,JR,2015-16,F,Indiana,Big Ten,35,916,163,318,.513,137,243,26,75,.347,112,162,.691,50,154,204,70,39,28,93,76,464
4343,Chris Wright,SO,2008-09,F,Dayton,A-10,35,915,166,347,.478,155,303,11,44,.250,121,179,.676,94,138,232,33,30,44,84,103,464
4344,Matt Bouldin,JR,2008-09,G,Gonzaga,WCC,34,1079,156,318,.491,101,188,55,130,.423,96,129,.744,25,114,139,115,52,5,58,53,463
4345,Cane Broome,FR,2014-15,G,Sacred Heart,NEC,32,1011,165,371,.445,120,238,45,133,.338,88,117,.752,15,107,122,77,36,6,75,63,463
4346,Michael Carrera,SR,2015-16,F,South Carolina,SEC,32,888,145,323,.449,94,197,51,126,.405,122,162,.753,70,177,247,40,32,33,61,86,463
4347,Drew Eubanks,SO,2016-17,F,Oregon State,Pac-12,32,1027,182,310,.587,182,310,0,0,,99,139,.712,81,185,266,39,20,69,96,92,463
4348,Chris Eversley,JR,2012-13,F,Cal Poly,Big West,30,986,173,383,.452,152,315,21,68,.309,96,133,.722,75,135,210,61,21,4,55,59,463
4349,A.J. Graves,SR,2007-08,G,Butler,Horizon,34,1196,148,395,.375,53,114,95,281,.338,72,81,.889,10,89,99,74,54,3,55,42,463
4350,Josh Hagins,SR,2015-16,G,Little Rock,Sun Belt,35,1073,162,358,.453,105,209,57,149,.383,82,98,.837,28,119,147,165,52,6,59,75,463
4351,Stefhon Hannah,JR,2006-07,G,Missouri,Big 12,30,911,161,356,.452,102,205,59,151,.391,82,104,.788,23,83,106,137,72,0,98,90,463
4352,Chris Harris,JR,2008-09,G,Navy,Patriot,30,1046,136,375,.363,51,144,85,231,.368,106,125,.848,15,61,76,57,42,1,52,76,463
4353,Jace Hogan,JR,2017-18,F,Jacksonville,A-Sun,27,828,194,376,.516,191,367,3,9,.333,72,105,.686,62,117,179,32,22,14,51,61,463
4354,Justinian Jessup,JR,2018-19,G,Boise State,MWC,33,1171,169,380,.445,82,168,87,212,.410,38,52,.731,16,133,149,88,35,17,44,76,463
4355,Johnathon Jones,SO,2007-08,G,Oakland,Summit,31,1119,154,351,.439,118,260,36,91,.396,119,138,.862,18,71,89,186,48,3,103,79,463
4356,Mason Jones,SO,2018-19,G,Arkansas,SEC,34,996,136,337,.404,60,129,76,208,.365,115,143,.804,18,114,132,96,31,5,61,77,463
4357,Verdell Jones,SO,2009-10,G,Indiana,Big Ten,31,974,149,373,.399,128,296,21,77,.273,144,190,.758,28,93,121,105,28,13,87,53,463
4358,Luke Kornet,SR,2016-17,F,Vanderbilt,SEC,35,1101,145,357,.406,92,195,53,162,.327,120,140,.857,53,164,217,42,19,71,45,81,463
4359,David Laury,JR,2013-14,F,Iona,MAAC,33,957,162,295,.549,162,295,0,0,,139,237,.586,75,199,274,77,22,38,60,101,463
4360,Damion Lee,SO,2012-13,G,Drexel,CAA,27,892,152,358,.425,90,186,62,172,.360,97,117,.829,34,104,138,49,22,3,50,79,463
4361,Tony Lee,SR,2007-08,G,Robert Morris,NEC,34,989,176,347,.507,151,267,25,80,.313,86,124,.694,84,141,225,217,95,5,147,78,463
4364,Matt Lewis,FR,2017-18,G,James Madison,CAA,32,1017,136,362,.376,82,201,54,161,.335,137,171,.801,24,95,119,72,31,5,40,62,463
4365,Khyle Marshall,SR,2013-14,F,Butler,Big East,31,897,196,368,.533,195,358,1,10,.100,70,153,.458,78,72,150,16,22,14,34,73,463
4366,Lawrence McKenzie,SR,2006-07,G,Minnesota,Big Ten,31,1071,157,377,.416,79,170,78,207,.377,71,92,.772,12,92,104,86,16,5,97,58,463
4367,Morgan Means,JR,2018-19,G,Seattle,WAC,33,1166,143,364,.393,81,196,62,168,.369,115,135,.852,22,121,143,98,41,1,80,114,463
4368,Juevol Myles,SR,2012-13,G,South Dakota,Summit,30,970,136,354,.384,86,201,50,153,.327,141,159,.887,10,94,104,89,37,0,57,68,463
4369,Marshawn Powell,JR,2012-13,F,Arkansas,SEC,32,819,175,359,.487,148,281,27,78,.346,86,134,.642,61,113,174,43,38,37,58,95,463
4370,Naz Reid,FR,2018-19,F,Louisiana State,SEC,34,926,171,365,.468,143,281,28,84,.333,93,128,.727,86,159,245,29,25,23,85,108,463
4371,Adam Sollazzo,SR,2011-12,G,East Tennessee State,A-Sun,31,1083,154,359,.429,141,315,13,44,.295,142,215,.660,50,119,169,137,51,4,97,72,463
4372,Daman Starring,SR,2012-13,G,UC-Irvine,Big West,36,1093,153,373,.410,81,196,72,177,.407,85,109,.780,23,118,141,72,32,5,69,78,463
4373,Demontez Stitt,SR,2010-11,G,Clemson,ACC,32,1093,152,351,.433,108,224,44,127,.346,115,157,.732,37,102,139,107,44,14,68,79,463
4374,Malik Story,SO,2010-11,G,Nevada,WAC,32,1030,158,400,.395,82,203,76,197,.386,71,97,.732,17,78,95,63,19,3,77,53,463
4375,Jordan Swing,JR,2012-13,F,Alabama-Birmingham,CUSA,33,1008,162,347,.467,101,177,61,170,.359,78,99,.788,40,151,191,90,43,13,61,81,463
4376,Ricky Tarrant,FR,2011-12,G,Tulane,CUSA,31,1026,140,329,.426,88,178,52,151,.344,131,167,.784,14,97,111,102,52,1,68,80,463
4377,Marlain Veal,SO,2016-17,G,Southeastern Louisiana,Southland,32,937,155,325,.477,109,210,46,115,.400,107,142,.754,27,94,121,144,58,2,119,74,463
4378,Zane Waterman,JR,2016-17,F,Manhattan,MAAC,32,888,151,313,.482,111,203,40,110,.364,121,155,.781,62,161,223,20,24,14,66,96,463
4379,Christian Watford,SO,2010-11,F,Indiana,Big Ten,29,845,143,339,.422,106,242,37,97,.381,140,166,.843,41,115,156,32,22,12,55,67,463
4380,Shayne Whittington,JR,2012-13,C,Western Michigan,MAC,35,1041,168,334,.503,166,319,2,15,.133,125,157,.796,92,216,308,40,25,58,65,85,463
4381,Terrence Williams,SR,2008-09,F,Louisville,Big East,37,1266,169,392,.431,112,244,57,148,.385,68,117,.581,51,266,317,185,86,29,86,62,463
4382,Jordan Aaron,JR,2012-13,G,Milwaukee,Horizon,32,1140,150,404,.371,83,210,67,194,.345,95,110,.864,16,99,115,128,40,0,123,85,462
4383,Jo Acuil,SR,2017-18,F,Baylor,Big 12,33,1023,187,364,.514,181,343,6,21,.286,82,116,.707,93,192,285,26,18,64,68,93,462
4386,Sean Baptiste,SO,2007-08,G,Fairleigh Dickinson,NEC,25,919,151,317,.476,120,230,31,87,.356,129,169,.763,63,94,157,35,24,6,42,68,462
4387,Korvotney Barber,SR,2008-09,F,Auburn,SEC,36,1071,188,345,.545,188,345,0,0,,86,182,.473,133,214,347,34,24,44,82,104,462
4388,Ryan Boatright,SO,2012-13,G,Connecticut,Big East,30,1089,151,352,.429,108,223,43,129,.333,117,149,.785,13,75,88,131,44,2,89,44,462
4389,Ian Clark,FR,2009-10,G,Belmont,A-Sun,31,918,163,360,.453,89,176,74,184,.402,62,80,.775,22,80,102,67,33,10,93,74,462
4390,Jason Clark,SR,2011-12,G,Georgetown,Big East,33,1077,159,334,.476,111,185,48,149,.322,96,128,.750,30,104,134,58,54,9,75,66,462
4391,Markeith Cummings,JR,2011-12,F,Kennesaw State,A-Sun,30,1045,162,358,.453,141,292,21,66,.318,117,182,.643,63,96,159,62,32,18,88,84,462
4392,Jackson Emery,SR,2010-11,G,Brigham Young,MWC,37,1202,151,354,.427,59,99,92,255,.361,68,82,.829,15,116,131,97,101,8,35,98,462
4393,Darren Fells,SR,2007-08,C,UC-Irvine,Big West,32,1009,168,295,.569,160,282,8,13,.615,118,159,.742,89,141,230,66,51,15,56,89,462
4394,Eric Ferguson,SO,2011-12,F,Georgia Southern,Southern,30,846,187,329,.568,179,295,8,34,.235,80,132,.606,65,151,216,24,46,34,61,100,462
4395,Bruno Fernando,SO,2018-19,F,Maryland,Big Ten,34,1021,173,285,.607,170,275,3,10,.300,113,145,.779,100,262,362,68,22,64,95,92,462
4396,Isaac Fotu,SO,2013-14,F,Hawaii,Big West,31,954,181,310,.584,180,302,1,8,.125,99,135,.733,72,118,190,21,13,24,51,76,462
4397,Eric Garcia,SR,2016-17,G,Wofford,Southern,33,1111,129,288,.448,53,120,76,168,.452,128,139,.921,9,82,91,226,24,1,60,66,462
4398,Trae Golden,SO,2011-12,G,Tennessee,SEC,34,1089,141,321,.439,91,192,50,129,.388,130,157,.828,18,84,102,154,27,3,98,68,462
4399,David Gomez,SR,2007-08,F,Tulane,CUSA,32,911,162,301,.538,153,279,9,22,.409,129,179,.721,55,142,197,29,27,51,65,88,462
4400,Jeremy Granger,SR,2011-12,G,Eastern Illinois,OVC,29,973,168,362,.464,139,284,29,78,.372,97,113,.858,20,78,98,88,29,3,66,60,462
4401,Steven Gray,JR,2009-10,G,Gonzaga,WCC,34,1083,160,347,.461,109,192,51,155,.329,91,117,.778,26,111,137,98,39,13,76,79,462
4402,Antoine Hood,SR,2005-06,G,Air Force,MWC,31,1127,171,315,.543,134,219,37,96,.385,83,113,.735,30,85,115,86,47,7,65,62,462
4403,Cameron Jones,SR,2015-16,G,Radford,Big South,31,894,171,387,.442,96,192,75,195,.385,45,59,.763,46,93,139,42,19,8,55,57,462
4404,DJ Laster,SR,2018-19,F,Gardner-Webb,Big South,34,896,192,348,.552,169,292,23,56,.411,55,84,.655,68,116,184,15,14,21,52,80,462
4405,Romain Martin,JR,2008-09,G,Eastern Illinois,OVC,30,906,168,386,.435,90,190,78,196,.398,48,61,.787,15,97,112,31,22,2,53,50,462
4408,Du'Vaughn Maxwell,SR,2013-14,F,Hampton,MEAC,31,965,176,346,.509,171,325,5,21,.238,105,205,.512,74,153,227,44,36,92,57,94,462
4409,Koby McEwen,FR,2016-17,G,Utah State,MWC,31,969,137,297,.461,79,159,58,138,.420,130,179,.726,15,144,159,96,24,11,84,90,462
4410,Brian Parker,FR,2015-16,G,Marist,MAAC,29,913,163,317,.514,153,291,10,26,.385,126,174,.724,46,104,150,84,20,1,90,63,462
4411,Brian Parker,SR,2018-19,G,Marist,MAAC,31,883,172,352,.489,159,312,13,40,.325,105,174,.603,18,101,119,108,18,2,99,59,462
4412,Robby Ptacek,JR,2010-11,G,Central Connecticut State,NEC,31,1043,156,382,.408,122,274,34,108,.315,116,131,.885,21,97,118,51,33,2,81,69,462
4413,Justin Robinson,JR,2017-18,G,Virginia Tech,ACC,33,1021,150,323,.464,99,195,51,128,.398,111,142,.782,24,68,92,185,41,2,83,76,462
4414,Dewayne Russell,FR,2012-13,G,Northern Arizona,Big Sky,32,1067,149,374,.398,108,253,41,121,.339,123,168,.732,15,63,78,102,49,4,98,65,462
4415,Dantrell Thomas,SR,2013-14,G,Nicholls State,Southland,29,838,150,286,.524,136,249,14,37,.378,148,194,.763,49,109,158,78,44,11,55,92,462
4416,Marcus Walker,SR,2008-09,G,Colorado State,MWC,27,868,163,397,.411,111,245,52,152,.342,84,107,.785,17,53,70,58,29,1,61,64,462
4417,Karrington Ward,JR,2013-14,F,Eastern Michigan,MAC,37,1083,151,343,.440,94,192,57,151,.377,103,159,.648,47,188,235,28,52,25,44,48,462
4418,Jalen Adams,SO,2016-17,G,Connecticut,AAC,32,1137,174,404,.431,138,301,36,103,.350,77,93,.828,23,113,136,195,35,7,99,68,461
4419,Cameron Ayers,SR,2013-14,G,Bucknell,Patriot,30,1022,154,374,.412,92,222,62,152,.408,91,106,.858,25,109,134,41,27,2,39,40,461
4420,Will Blalock,JR,2005-06,G,Iowa State,Big 12,30,1072,177,396,.447,130,278,47,118,.398,60,91,.659,24,75,99,184,65,2,89,55,461
4421,Andrew Brown,JR,2007-08,G,Lafayette,Patriot,29,837,147,352,.418,48,105,99,247,.401,68,82,.829,14,53,67,85,28,1,79,68,461
4422,Robert Brown,SR,2015-16,G,Alabama-Birmingham,CUSA,33,999,160,372,.430,93,202,67,170,.394,74,96,.771,11,79,90,102,30,9,58,57,461
4423,Brenton Butler,SR,2009-10,G,Fordham,A-10,28,961,143,427,.335,85,233,58,194,.299,117,144,.813,14,74,88,68,25,0,62,57,461
4424,Bryce Canda,SR,2017-18,G,Portland State,Big Sky,33,1134,171,425,.402,96,193,75,232,.323,44,67,.657,46,151,197,82,55,6,51,34,461
4425,Jeremy Combs,SO,2015-16,F,North Texas,CUSA,31,981,175,291,.601,175,291,0,0,,111,190,.584,107,218,325,24,42,23,61,93,461
4426,Tyrone Conley,SR,2010-11,G,New Hampshire,AEC,30,1049,158,415,.381,80,178,78,237,.329,67,97,.691,35,66,101,63,38,23,62,80,461
4427,Rasheem Dunn,SO,2017-18,G,St. Francis (NY),NEC,30,928,157,403,.390,115,253,42,150,.280,105,136,.772,21,151,172,70,42,1,62,60,461
4428,Chris Fouch,SO,2010-11,G,Drexel,CAA,31,884,155,409,.379,93,223,62,186,.333,89,126,.706,25,79,104,38,15,5,41,57,461
4429,Grandy Glaze,SR,2015-16,F,Grand Canyon,WAC,33,872,198,332,.596,198,321,0,11,.000,65,106,.613,76,214,290,26,18,0,52,51,461
4430,Martez Harrison,JR,2015-16,G,Kansas City,WAC,30,999,134,346,.387,95,220,39,126,.310,154,201,.766,25,86,111,126,38,3,110,76,461
4431,Jalin Hart,JR,2016-17,G,Incarnate Word,Southland,29,958,163,315,.517,126,221,37,94,.394,98,153,.641,16,86,102,135,40,8,77,78,461
4432,Spencer Hawes,FR,2006-07,C,Washington,Pac-10,31,896,193,363,.532,192,360,1,3,.333,74,98,.755,61,136,197,60,16,54,78,70,461
4433,Isaiah Hicks,SR,2016-17,F,North Carolina,ACC,39,907,174,302,.576,174,302,0,0,,113,145,.779,72,141,213,55,16,29,64,119,461
4434,Ken Horton,SO,2008-09,F,Central Connecticut State,NEC,28,954,168,334,.503,136,244,32,90,.356,93,116,.802,61,100,161,41,16,44,56,45,461
4435,Twymond Howard,JR,2014-15,F,Tennessee-Martin,OVC,34,1182,167,351,.476,146,290,21,61,.344,106,148,.716,62,161,223,58,29,20,61,85,461
4436,Alshwan Hymes,JR,2011-12,G,Canisius,MAAC,30,1061,168,431,.390,84,174,84,257,.327,41,56,.732,27,70,97,51,36,2,80,64,461
4437,Kerron Johnson,SR,2012-13,G,Belmont,OVC,33,991,137,299,.458,121,243,16,56,.286,171,220,.777,11,93,104,158,57,1,104,85,461
4438,Ravern Johnson,JR,2009-10,G,Mississippi State,SEC,35,1010,173,362,.478,86,148,87,214,.407,28,43,.651,26,94,120,23,14,16,44,46,461
4439,Tyus Jones,FR,2014-15,G,Duke,ACC,39,1322,135,324,.417,88,200,47,124,.379,144,162,.889,19,118,137,217,59,3,76,46,461
4440,Jackson Kent,SR,2016-17,G,James Madison,CAA,33,1189,153,343,.446,99,190,54,153,.353,101,119,.849,16,130,146,75,37,4,59,46,461
4441,George King,SO,2015-16,G,Colorado,Pac-12,34,862,152,341,.446,84,192,68,149,.456,89,119,.748,55,104,159,23,13,8,63,60,461
4442,Chris Knight,SO,2018-19,F,Dartmouth,Ivy,30,845,192,385,.499,184,357,8,28,.286,69,112,.616,64,139,203,71,18,37,90,90,461
4443,Matthew Knight,SR,2006-07,F,Loyola Marymount,WCC,28,912,173,358,.483,172,353,1,5,.200,114,166,.687,72,143,215,30,31,11,40,56,461
4444,Keon Lewis,SR,2014-15,G,Texas-San Antonio,CUSA,29,974,133,336,.396,97,231,36,105,.343,159,193,.824,19,59,78,89,47,0,62,57,461
4445,Tyrone Lewis,SR,2009-10,G,Niagara,MAAC,27,923,144,373,.386,57,136,87,237,.367,86,114,.754,39,87,126,46,51,19,38,72,461
4446,Anthony Livingston,SO,2014-15,F,Arkansas State,Sun Belt,29,1039,166,358,.464,139,274,27,84,.321,102,148,.689,77,214,291,22,14,29,78,67,461
4447,Marin Maric,SR,2016-17,C,Northern Illinois,MAC,32,911,172,303,.568,167,281,5,22,.227,112,168,.667,101,167,268,25,23,17,73,89,461
4450,Anthony Mathis,SR,2018-19,G,New Mexico,MWC,32,986,134,326,.411,28,71,106,255,.416,87,98,.888,14,57,71,66,34,5,61,80,461
4451,Trhae Mitchell,JR,2018-19,F,South Alabama,Sun Belt,34,1164,175,366,.478,141,285,34,81,.420,77,119,.647,46,211,257,122,39,71,82,94,461
4452,Shaquille Morris,SR,2017-18,F,Wichita State,AAC,33,783,176,318,.553,158,272,18,46,.391,91,125,.728,55,130,185,44,18,51,48,79,461
4453,Le'Bryan Nash,SO,2012-13,G,Oklahoma State,Big 12,33,1052,160,346,.462,148,296,12,50,.240,129,174,.741,28,107,135,59,20,5,86,88,461
4454,Donte Poole,SR,2011-12,F,Murray State,OVC,33,1024,139,315,.441,71,134,68,181,.376,115,134,.858,21,98,119,48,63,5,61,73,461
4455,R.J. Price,JR,2013-14,G,Radford,Big South,35,1033,151,382,.395,74,171,77,211,.365,82,101,.812,14,73,87,100,49,4,48,49,461
4456,Rodney Purvis,JR,2015-16,G,Connecticut,AAC,36,1038,163,376,.434,93,194,70,182,.385,65,99,.657,16,91,107,74,32,4,55,71,461
4457,Ronald Roberts ,SR,2013-14,F,Saint Joseph's,A-10,32,1065,174,290,.600,174,290,0,0,,113,190,.595,92,146,238,41,11,43,63,78,461
4458,T.J. Robinson,JR,2010-11,F,Cal State Long Beach,Big West,34,1114,182,364,.500,173,340,9,24,.375,88,150,.587,100,244,344,33,19,3,78,79,461
4459,Jaelan Sanford,SO,2016-17,G,Toledo,MAC,34,1219,157,345,.455,92,179,65,166,.392,82,113,.726,14,59,73,107,23,17,63,61,461
4460,Matt Scott,SO,2015-16,G,Niagara,MAAC,30,992,146,358,.408,112,240,34,118,.288,135,176,.767,61,152,213,76,39,10,96,85,461
4461,Mike Scott,SR,2007-08,F,Kent State,MAC,35,1153,148,305,.485,108,204,40,101,.396,125,147,.850,64,158,222,39,39,27,51,66,461
4462,Tyler Seibring,SO,2016-17,F,Elon,CAA,32,1044,169,359,.471,109,207,60,152,.395,63,85,.741,54,167,221,61,16,27,46,60,461
4463,E.J. Singler,JR,2011-12,F,Oregon,Pac-12,34,1046,151,323,.467,102,190,49,133,.368,110,121,.909,43,146,189,76,20,14,64,89,461
4464,Tyler Smith,FR,2006-07,F,Iowa,Big Ten,31,1045,174,394,.442,157,327,17,67,.254,96,132,.727,67,86,153,111,45,8,92,79,461
4465,Moses Sonko,SR,2006-07,G,Coastal Carolina,Big South,30,845,188,336,.560,182,319,6,17,.353,79,106,.745,82,126,208,32,43,4,63,86,461
4466,Bo Spencer,SR,2011-12,G,Nebraska,Big Ten,30,976,153,373,.410,90,188,63,185,.341,92,105,.876,9,68,77,98,39,4,89,62,461
4467,Bo Taylor,SR,2006-07,F,Hartford,AEC,31,971,171,355,.482,159,304,12,51,.235,107,159,.673,34,130,164,55,51,8,76,117,461
4468,Ryan Taylor,SR,2016-17,F,Marshall,CUSA,32,921,160,315,.508,141,247,19,68,.279,122,190,.642,66,202,268,73,26,53,77,111,461
4469,Jalin Thomas,SR,2010-11,G,Central Michigan,MAC,29,975,139,365,.381,80,198,59,167,.353,124,154,.805,58,95,153,15,17,0,51,64,461
4472,Kahlil Thomas,SR,2016-17,F,Rider,MAAC,33,1012,179,339,.528,173,319,6,20,.300,97,150,.647,84,207,291,40,34,29,76,96,461
4473,Ralston Turner,SR,2014-15,G,North Carolina State,ACC,36,1136,150,381,.394,56,125,94,256,.367,67,80,.838,22,95,117,35,22,6,37,86,461
4474,Gavin Ware,SR,2015-16,F,Mississippi State,SEC,30,842,183,298,.614,183,297,0,1,.000,95,126,.754,87,147,234,27,28,32,55,83,461
4475,Tyler Wilkerson,SR,2009-10,F,Marshall,CUSA,33,867,169,326,.518,154,280,15,46,.326,108,140,.771,77,161,238,34,21,34,52,87,461
4476,Leon Williams,JR,2006-07,F,Ohio,MAC,32,927,162,278,.583,162,278,0,0,,137,201,.682,114,169,283,29,33,24,61,121,461
4477,Josh Young,SR,2009-10,G,Drake,MVC,32,1100,146,332,.440,93,184,53,148,.358,116,159,.730,26,100,126,86,33,1,57,79,461
4478,Shaddean Aaron,JR,2006-07,G,Mercer,A-Sun,29,981,173,356,.486,150,277,23,79,.291,91,118,.771,,,177,56,38,36,,,460
4479,Stefan Blaszczynski,SR,2006-07,G,Nicholls State,Southland,24,859,149,327,.456,108,210,41,117,.350,121,155,.781,60,108,168,77,31,6,74,75,460
4480,Ryan Bright,JR,2006-07,F,Sam Houston State,Southland,31,909,171,333,.514,135,239,36,94,.383,82,153,.536,81,169,250,87,54,45,85,87,460
4481,Alec Brown,SR,2013-14,F,Green Bay,Horizon,30,909,165,347,.476,123,247,42,100,.420,88,121,.727,63,108,171,30,15,94,65,67,460
4482,John Brown,FR,2012-13,F,High Point,Big South,28,724,180,347,.519,180,347,0,0,,100,151,.662,84,87,171,19,48,34,37,72,460
4483,Stanley Burrell,SO,2005-06,G,Xavier,A-10,32,1093,165,400,.413,96,228,69,172,.401,61,78,.782,21,73,94,105,23,3,73,56,460
4484,Olin Carter,SR,2018-19,G,San Diego,WCC,31,1050,170,387,.439,89,171,81,216,.375,39,49,.796,6,85,91,49,26,5,46,84,460
4485,Quinton Chievous,SR,2015-16,G,Hampton,MEAC,27,922,185,325,.569,167,266,18,59,.305,72,149,.483,86,204,290,54,16,4,72,63,460
4486,Aaron Cook,SR,2005-06,G,Hartford,AEC,28,978,153,365,.419,71,155,82,210,.390,72,94,.766,35,82,117,69,45,3,60,59,460
4487,Javaris Crittenton,FR,2006-07,G,Georgia Tech,ACC,32,1003,158,351,.450,122,250,36,101,.356,108,138,.783,28,91,119,184,65,2,124,67,460
4488,Chris Davis,SR,2008-09,G,Southern,SWAC,31,1018,152,372,.409,100,239,52,133,.391,104,136,.765,28,105,133,97,35,8,76,55,460
4489,Marcus Derrickson,JR,2017-18,F,Georgetown,Big East,29,927,150,297,.505,103,196,47,101,.465,113,131,.863,67,167,234,46,20,19,63,70,460
4490,Zabian Dowdell,JR,2005-06,G,Virginia Tech,ACC,30,1079,164,393,.417,110,242,54,151,.358,78,112,.696,13,81,94,103,70,5,70,65,460
4491,Colin Falls,SR,2006-07,G,Notre Dame,Big East,30,1027,138,314,.439,39,64,99,250,.396,85,102,.833,10,75,85,72,32,5,42,67,460
4494,Dylan Garrity,SR,2014-15,G,Sacramento State,Big Sky,33,1085,148,319,.464,67,121,81,198,.409,83,100,.830,8,59,67,84,32,1,55,54,460
4495,Dairese Gary,JR,2009-10,G,New Mexico,MWC,35,1002,125,278,.450,110,234,15,44,.341,195,260,.750,16,81,97,137,36,1,63,70,460
4496,Evan Gordon,SO,2010-11,G,Liberty,Big South,32,1053,155,400,.388,85,192,70,208,.337,80,105,.762,24,69,93,70,52,4,87,66,460
4497,Cedric Hankerson,SO,2014-15,G,Boston University,Patriot,29,982,121,305,.397,49,124,72,181,.398,146,217,.673,21,110,131,76,52,3,78,85,460
4498,Bobby Howard,SR,2010-11,F,Montana State,Big Sky,31,993,159,403,.395,112,248,47,155,.303,95,154,.617,67,156,223,54,27,9,60,83,460
4499,Loren Jackson,SO,2018-19,G,Akron,MAC,33,1042,137,397,.345,71,177,66,220,.300,120,149,.805,26,67,93,102,30,5,60,65,460
4500,Emmanuel Jones,SR,2008-09,F,Texas-Rio Grande Valley,Ind,26,791,185,332,.557,184,328,1,4,.250,89,135,.659,65,142,207,28,20,23,66,49,460
4501,Chavaughn Lewis,FR,2011-12,G,Marist,MAAC,32,943,150,347,.432,124,268,26,79,.329,134,208,.644,36,113,149,57,53,25,95,74,460
4502,Mike Lewis,SO,2017-18,G,Duquesne,A-10,32,994,138,359,.384,49,117,89,242,.368,95,115,.826,16,58,74,23,34,1,41,66,460
4503,Trenton Marshall,JR,2009-10,F,Jacksonville State,OVC,26,817,154,370,.416,97,215,57,155,.368,95,120,.792,32,105,137,62,44,14,52,60,460
4504,Mark McAndrew,JR,2006-07,G,Brown,Ivy,29,1056,127,274,.464,55,111,72,163,.442,134,158,.848,28,127,155,64,28,1,80,74,460
4505,Dexter McClanahan,SO,2016-17,G,Savannah State,MEAC,28,780,152,349,.436,79,142,73,207,.353,83,120,.692,20,134,154,62,30,4,63,46,460
4506,Sheldon McClellan,SO,2012-13,G,Texas,Big 12,34,929,136,356,.382,103,235,33,121,.273,155,186,.833,36,96,132,29,28,3,57,28,460
4507,Chris McEachin,SR,2011-12,G,Norfolk State,MEAC,36,1077,154,395,.390,78,174,76,221,.344,76,102,.745,26,79,105,42,45,20,72,90,460
4508,Tyrus McGee,SR,2012-13,G,Iowa State,Big 12,35,841,157,322,.488,61,115,96,207,.464,50,61,.820,31,92,123,46,40,11,30,63,460
4509,Jordan McLaughlin,SR,2017-18,G,Southern California,Pac-12,36,1270,159,354,.449,105,218,54,136,.397,88,118,.746,26,106,132,281,72,8,92,39,460
4510,Akil Mitchell,JR,2012-13,F,Virginia,ACC,35,1069,177,325,.545,177,323,0,2,.000,106,153,.693,94,218,312,52,45,14,63,74,460
4511,Jonathan Mitchell,SR,2010-11,F,Rutgers,Big East,32,969,164,365,.449,113,235,51,130,.392,81,103,.786,57,121,178,29,26,19,49,51,460
4512,Devin Morgan,SO,2016-17,G,Delaware State,MEAC,32,1148,149,404,.369,63,165,86,239,.360,76,85,.894,16,82,98,103,35,0,57,42,460
4513,Robert Nyakundi,SR,2011-12,F,Southern Methodist,CUSA,31,1034,156,337,.463,72,134,84,203,.414,64,82,.780,34,116,150,30,35,9,58,90,460
4516,Femi Olujobi,SR,2018-19,F,DePaul,Big East,36,954,163,271,.601,149,238,14,33,.424,120,172,.698,71,125,196,35,20,11,66,87,460
4517,Isaiah Philmore,SO,2010-11,F,Towson,CAA,30,1071,169,344,.491,151,293,18,51,.353,104,131,.794,75,135,210,30,27,17,60,79,460
4518,John Roberson,SO,2008-09,G,Texas Tech,Big 12,33,1160,146,385,.379,75,184,71,201,.353,97,117,.829,12,104,116,212,35,2,116,83,460
4519,Adrian Rodgers,SO,2014-15,G,Southern,SWAC,35,1010,164,420,.390,110,254,54,166,.325,78,98,.796,24,122,146,40,26,5,64,67,460
4520,Mike Rose,JR,2007-08,G,Eastern Kentucky,OVC,30,1086,167,399,.419,107,224,60,175,.343,66,81,.815,48,84,132,65,54,6,70,37,460
4521,Joe Rosga,SO,2016-17,G,Denver,Summit,30,1034,152,334,.455,78,167,74,167,.443,82,96,.854,14,108,122,97,34,1,65,62,460
4522,Dylan Smith,FR,2015-16,G,North Carolina-Asheville,Big South,34,929,134,363,.369,53,131,81,232,.349,111,135,.822,13,77,90,63,34,11,88,81,460
4523,Marcus Stout,JR,2006-07,G,Fordham,A-10,30,988,157,368,.427,83,172,74,196,.378,72,109,.661,19,76,95,78,49,4,61,66,460
4524,Thomas Walkup,SO,2013-14,G,Stephen F. Austin,Southland,35,994,175,308,.568,161,269,14,39,.359,96,131,.733,81,105,186,75,38,9,55,111,460
4525,Rich Williams,JR,2015-16,G,Manhattan,MAAC,31,879,166,367,.452,128,262,38,105,.362,90,113,.796,45,140,185,41,33,15,74,82,460
4526,Ryan Allen,FR,2017-18,G,Delaware,CAA,30,1072,163,401,.406,77,180,86,221,.389,47,65,.723,8,67,75,45,15,6,49,86,459
4527,Corey Allmond,JR,2008-09,G,Sam Houston State,Southland,30,922,155,354,.438,56,127,99,227,.436,50,61,.820,15,62,77,79,39,0,56,57,459
4528,Daniel Amigo,SR,2017-18,C,Denver,Summit,30,774,189,363,.521,171,319,18,44,.409,63,106,.594,67,133,200,47,9,22,89,96,459
4529,Jaylen Barford,JR,2016-17,G,Arkansas,SEC,36,913,174,397,.438,145,288,29,109,.266,82,109,.752,39,97,136,72,44,6,70,81,459
4530,Chris Boucher,JR,2015-16,F,Oregon,Pac-12,38,981,159,295,.539,120,180,39,115,.339,102,149,.685,103,177,280,15,30,110,43,102,459
4531,Ron Curry,JR,2014-15,G,James Madison,CAA,33,1175,141,349,.404,79,202,62,147,.422,115,156,.737,19,108,127,143,36,7,75,60,459
4532,Josh Duncan,SR,2007-08,F,Xavier,A-10,37,829,141,284,.496,86,152,55,132,.417,122,143,.853,43,130,173,49,16,23,61,90,459
4533,Chris Eversley,SR,2013-14,F,Cal Poly,Big West,34,1057,167,417,.400,125,273,42,144,.292,83,117,.709,74,167,241,55,44,13,46,72,459
4534,Iverson Fleming,SR,2016-17,G,Long Island University,NEC,32,1009,154,406,.379,104,265,50,141,.355,101,131,.771,26,81,107,61,45,13,92,86,459
4535,Jacob Grandison,SO,2018-19,G,Holy Cross,Patriot,33,1141,169,394,.429,100,205,69,189,.365,52,65,.800,26,138,164,97,36,11,62,72,459
4536,Rokas Gustys,SO,2015-16,F,Hofstra,CAA,34,1033,192,291,.660,192,291,0,0,,75,172,.436,141,301,442,31,32,40,60,114,459
4537,Ahmed Hill,SR,2018-19,G,Virginia Tech,ACC,35,1236,164,370,.443,89,178,75,192,.391,56,69,.812,23,112,135,46,28,2,47,69,459
4538,Rick Jackson,SR,2010-11,F,Syracuse,Big East,35,1245,193,328,.588,193,328,0,0,,73,137,.533,120,240,360,77,47,86,72,71,459
4539,Matt Janning,JR,2008-09,G,Northeastern,CAA,32,1151,158,389,.406,107,231,51,158,.323,92,124,.742,32,118,150,85,48,6,78,64,459
4540,Joseph Jones,SO,2005-06,C,Texas A&M,Big 12,30,869,155,305,.508,153,286,2,19,.105,147,200,.735,67,128,195,45,46,16,56,90,459
4541,Tim Kempton,SO,2014-15,C,Lehigh,Patriot,30,866,172,345,.499,171,344,1,1,1.000,114,160,.713,56,204,260,31,15,11,76,79,459
4542,Bronson Koenig,JR,2015-16,G,Wisconsin,Big Ten,35,1222,151,385,.392,68,172,83,213,.390,74,97,.763,13,84,97,84,14,6,52,76,459
4543,Marvett McDonald,SR,2005-06,G,Alabama-Birmingham,CUSA,31,893,156,402,.388,60,136,96,266,.361,51,64,.797,19,60,79,70,44,1,50,61,459
4544,Carlos Medlock,JR,2007-08,G,Eastern Michigan,MAC,31,1005,126,322,.391,63,136,63,186,.339,144,176,.818,21,81,102,127,34,1,108,79,459
4545,Donavan Monroe,SR,2010-11,G,College of Charleston,Southern,37,1225,160,354,.452,118,227,42,127,.331,97,132,.735,26,75,101,97,33,5,77,73,459
4546,Marcus Morris,SO,2009-10,F,Kansas,Big 12,36,889,174,305,.570,162,273,12,32,.375,99,150,.660,96,124,220,37,34,12,48,94,459
4547,Jordan Price,SR,2016-17,G,La Salle,A-10,30,985,155,358,.433,86,163,69,195,.354,80,105,.762,17,112,129,77,19,8,71,59,459
4548,Taurean Prince,JR,2014-15,F,Baylor,Big 12,33,868,167,354,.472,107,202,60,152,.395,65,101,.644,60,124,184,42,49,29,67,70,459
4549,Jason Richards,JR,2006-07,G,Davidson,Southern,34,1167,145,349,.415,92,208,53,141,.376,116,143,.811,25,105,130,249,52,2,106,59,459
4550,Grant Riller,FR,2016-17,G,College of Charleston,CAA,35,944,159,327,.486,121,213,38,114,.333,103,129,.798,13,59,72,43,33,7,47,60,459
4551,Sam Rowley,SR,2014-15,F,Albany (NY),AEC,33,1094,168,332,.506,168,328,0,4,.000,123,150,.820,81,170,251,59,40,26,88,90,459
4552,Darius Roy,JR,2018-19,G,Milwaukee,Horizon,29,1015,164,365,.449,119,254,45,111,.405,86,102,.843,13,105,118,118,36,7,93,75,459
4553,Dana Smith,JR,2008-09,F,Longwood,Ind,31,931,173,334,.518,159,281,14,53,.264,99,152,.651,71,128,199,65,54,26,69,107,459
4554,Jonathan Tavernari,SO,2007-08,F,Brigham Young,MWC,35,966,166,420,.395,78,186,88,234,.376,39,45,.867,34,150,184,53,48,16,59,70,459
4555,Edwin Ubiles,SR,2009-10,F,Siena,MAAC,30,926,188,398,.472,159,325,29,73,.397,54,82,.659,31,80,111,67,33,7,58,38,459
4558,Deron Washington,SR,2007-08,F,Virginia Tech,ACC,35,1159,147,353,.416,129,286,18,67,.269,147,219,.671,69,158,227,80,34,22,74,103,459
4559,Arnaud William Adala Moto,JR,2015-16,F,Towson,CAA,33,935,145,329,.441,128,271,17,58,.293,151,208,.726,75,199,274,53,25,4,94,87,458
4560,Ryan Anderson,JR,2013-14,F,Boston College,ACC,32,1004,149,305,.489,145,290,4,15,.267,156,211,.739,76,156,232,45,25,20,62,65,458
4561,Kelsey Barlow,SR,2013-14,G,Illinois-Chicago,Horizon,31,973,150,388,.387,102,238,48,150,.320,110,144,.764,30,124,154,121,31,8,81,83,458
4562,George Blagojevic,SR,2018-19,F,Hartford,AEC,32,1071,185,329,.562,179,300,6,29,.207,82,142,.577,84,157,241,61,39,28,84,87,458
4563,Kellen Brand,JR,2008-09,G,Appalachian State,Southern,31,944,154,315,.489,106,193,48,122,.393,102,129,.791,28,54,82,45,24,0,63,67,458
4564,Michael Bryson,JR,2014-15,G,UC-Santa Barbara,Big West,33,1060,160,360,.444,92,171,68,189,.360,70,82,.854,33,125,158,56,27,22,51,82,458
4565,Ricky Cadell,SO,2008-09,G,St. Francis (NY),NEC,30,924,152,326,.466,96,186,56,140,.400,98,140,.700,26,75,101,76,31,0,103,81,458
4566,Eli Cain,SR,2018-19,G,DePaul,Big East,35,1189,158,373,.424,97,205,61,168,.363,81,118,.686,12,97,109,119,42,10,82,97,458
4567,Olin Carter,SO,2016-17,G,San Diego,WCC,30,1063,151,366,.413,59,124,92,242,.380,64,82,.780,5,70,75,61,19,1,43,75,458
4568,Keith Clanton,SR,2012-13,F,Central Florida,CUSA,31,1096,167,312,.535,156,256,11,56,.196,113,177,.638,90,173,263,77,35,63,96,83,458
4569,Jack Cooley,SR,2012-13,F,Notre Dame,Big East,35,1026,173,299,.579,172,297,1,2,.500,111,158,.703,141,213,354,29,23,41,50,93,458
4570,Darryl Crawford,SR,2009-10,G,Manhattan,MAAC,31,1033,157,380,.413,136,304,21,76,.276,123,165,.745,56,140,196,69,36,14,67,69,458
4571,Corey Davis,JR,2017-18,G,Houston,AAC,35,1057,148,334,.443,45,94,103,240,.429,59,73,.808,23,84,107,84,31,1,50,69,458
4572,Torin Dorn,JR,2017-18,G,North Carolina State,ACC,33,948,178,335,.531,155,261,23,74,.311,79,108,.731,80,128,208,46,33,13,66,78,458
4573,Aaron Gray,JR,2005-06,C,Pittsburgh,Big East,33,920,170,323,.526,170,323,0,0,,118,186,.634,121,224,345,60,21,49,88,86,458
4574,J.J. Hickson,FR,2007-08,F,North Carolina State,ACC,31,890,163,276,.591,163,275,0,1,.000,132,195,.677,80,182,262,31,22,47,83,60,458
4575,Kadeem Jack,JR,2013-14,F,Rutgers,AAC,32,938,175,349,.501,173,346,2,3,.667,106,154,.688,87,132,219,23,23,41,60,92,458
4576,Quan Jackson,SO,2018-19,G,Georgia Southern,Sun Belt,31,992,158,358,.441,111,216,47,142,.331,95,129,.736,14,126,140,45,62,16,57,60,458
4577,Vander Joaquim,JR,2011-12,C,Hawaii,WAC,32,978,172,307,.560,172,307,0,0,,114,180,.633,100,204,304,33,21,58,65,98,458
4580,Damian Jones,JR,2015-16,C,Vanderbilt,SEC,33,866,184,312,.590,184,309,0,3,.000,90,168,.536,74,153,227,38,8,54,65,108,458
4581,Coby Karl,SR,2006-07,G,Boise State,WAC,31,1009,131,321,.408,51,105,80,216,.370,116,139,.835,16,111,127,125,25,18,97,76,458
4582,Markus Kennedy,SO,2013-14,F,Southern Methodist,AAC,37,924,182,341,.534,181,336,1,5,.200,93,158,.589,73,188,261,58,57,44,67,87,458
4583,Travis Leslie,SO,2009-10,G,Georgia,SEC,31,912,169,347,.487,163,336,6,11,.545,114,155,.735,96,116,212,78,40,30,82,65,458
4584,Kira Lewis,FR,2018-19,G,Alabama,SEC,34,1075,157,363,.433,103,212,54,151,.358,90,115,.783,13,74,87,98,28,10,74,61,458
4585,Mike Liabo,SO,2011-12,G,Tennessee-Martin,OVC,30,946,156,448,.348,88,225,68,223,.305,78,97,.804,20,100,120,79,17,4,85,48,458
4586,Alex Loughton,SR,2005-06,C,Old Dominion,CAA,34,970,162,334,.485,149,294,13,40,.325,121,162,.747,85,177,262,46,34,23,57,90,458
4587,Charles Mann,SO,2013-14,G,Georgia,SEC,33,979,121,295,.410,100,227,21,68,.309,195,277,.704,23,115,138,97,35,2,113,82,458
4588,Jordan Mathews,JR,2015-16,G,University of California,Pac-12,34,1011,143,339,.422,54,125,89,214,.416,83,104,.798,25,89,114,42,16,0,45,73,458
4589,Gerald McLemore,SR,2011-12,G,Maine,AEC,27,956,162,378,.429,89,194,73,184,.397,61,66,.924,17,47,64,36,21,5,47,39,458
4590,Paul Miller,SR,2005-06,C,Wichita State,MVC,35,979,174,340,.512,174,338,0,2,.000,110,149,.738,74,158,232,41,15,15,63,85,458
4591,Robert Mitchell,FR,2006-07,F,Duquesne,A-10,28,750,172,381,.451,128,271,44,110,.400,70,96,.729,64,87,151,40,22,18,51,68,458
4592,Siler Schneider,JR,2017-18,G,UC-Davis,Big West,33,995,176,397,.443,140,285,36,112,.321,70,98,.714,16,86,102,71,37,8,82,85,458
4593,Kendall Smith,SR,2017-18,G,Oklahoma State,Big 12,35,943,166,414,.401,116,292,50,122,.410,76,114,.667,20,88,108,100,35,1,75,61,458
4594,Jae'Sean Tate,JR,2016-17,F,Ohio State,Big Ten,32,1021,182,333,.547,174,297,8,36,.222,86,150,.573,62,143,205,64,34,15,72,101,458
4595,Moritz Wagner,SO,2016-17,F,Michigan,Big Ten,38,908,168,300,.560,123,186,45,114,.395,77,106,.726,51,107,158,20,39,14,54,102,458
4596,C.J. Watson,SR,2005-06,G,Tennessee,SEC,30,956,136,291,.467,87,175,49,116,.422,137,156,.878,16,77,93,117,59,4,63,77,458
4597,Devonta White,JR,2012-13,G,Georgia State,CAA,31,1121,155,361,.429,115,233,40,128,.313,108,146,.740,20,66,86,121,52,1,93,54,458
4598,Sam Willard,SR,2010-11,F,Pacific,Big West,31,1030,165,344,.480,142,278,23,66,.348,105,134,.784,93,233,326,49,20,22,67,85,458
4599,Eric Williams,FR,2017-18,G,Duquesne,A-10,32,1079,147,375,.392,80,191,67,184,.364,97,131,.740,68,212,280,51,43,10,67,75,458
4602,E.J. Anosike,SO,2018-19,F,Sacred Heart,NEC,32,928,156,301,.518,137,248,19,53,.358,126,166,.759,105,153,258,29,19,15,48,79,457
4603,Chip Armelin,JR,2014-15,G,Southern Mississippi,CUSA,29,1022,170,364,.467,109,195,61,169,.361,56,88,.636,37,83,120,56,33,6,57,42,457
4604,Art Bernardi,SR,2012-13,F,Houston Baptist,GWC,31,921,178,384,.464,164,346,14,38,.368,87,132,.659,67,150,217,40,37,27,82,85,457
4605,Mike Black,JR,2011-12,G,Albany (NY),AEC,34,1121,156,350,.446,105,207,51,143,.357,94,125,.752,22,74,96,145,38,0,89,79,457
4606,Ramel Bradley,JR,2006-07,G,Kentucky,SEC,34,1107,141,336,.420,72,148,69,188,.367,106,130,.815,31,96,127,129,44,9,91,71,457
4607,Chris Braswell,JR,2011-12,F,Charlotte,A-10,29,863,162,317,.511,147,268,15,49,.306,118,152,.776,73,147,220,34,35,36,90,93,457
4608,Brandon Childress,JR,2018-19,G,Wake Forest,ACC,31,1128,131,342,.383,57,141,74,201,.368,121,152,.796,13,104,117,125,48,1,84,73,457
4609,Geary Claxton,SO,2005-06,F,Penn State,Big Ten,30,1025,168,383,.439,146,315,22,68,.324,99,157,.631,96,129,225,45,42,21,63,82,457
4610,Charles Cooke,SR,2016-17,G,Dayton,A-10,29,915,151,332,.455,102,209,49,123,.398,106,151,.702,29,120,149,82,32,28,61,56,457
4611,Bryce Cotton,SO,2011-12,G,Providence,Big East,32,1234,145,351,.413,68,148,77,203,.379,90,101,.891,14,67,81,72,32,5,52,51,457
4612,Dave Dudzinski,JR,2012-13,F,Holy Cross,Patriot,30,869,166,344,.483,148,292,18,52,.346,107,131,.817,69,130,199,25,18,26,45,81,457
4613,Khallid Hart,FR,2013-14,G,Marist,MAAC,31,1068,149,326,.457,104,208,45,118,.381,114,144,.792,19,74,93,78,43,0,75,73,457
4614,LaDontae Henton,FR,2011-12,F,Providence,Big East,32,1191,168,370,.454,124,258,44,112,.393,77,109,.706,88,186,274,36,32,34,55,76,457
4615,Jaleel Hogan,JR,2016-17,F,Detroit Mercy,Horizon,30,792,175,296,.591,175,296,0,0,,107,199,.538,84,91,175,31,16,31,68,113,457
4616,Richaun Holmes,SR,2014-15,F,Bowling Green State,MAC,31,892,165,293,.563,147,250,18,43,.419,109,153,.712,88,160,248,26,22,83,60,77,457
4617,Damon Huffman,SR,2007-08,G,Brown,Ivy,29,1002,154,319,.483,72,137,82,182,.451,67,84,.798,13,77,90,48,35,2,45,50,457
4618,Isaiah Hunter,SR,2005-06,G,Old Dominion,CAA,32,903,148,379,.391,91,207,57,172,.331,104,138,.754,21,85,106,85,23,4,78,35,457
4619,Andre Ingram,SR,2006-07,G,American,Patriot,30,1035,150,357,.420,72,173,78,184,.424,79,95,.832,22,121,143,53,37,2,39,52,457
4620,Paul Jackson,SR,2018-19,G,Eastern Michigan,MAC,32,1118,165,440,.375,144,349,21,91,.231,106,149,.711,16,48,64,148,42,1,88,89,457
4621,Jeremy Lamb,FR,2010-11,G,Connecticut,Big East,41,1140,182,374,.487,136,249,46,125,.368,47,59,.797,50,133,183,66,35,25,52,64,457
4624,Shawn Lewis,SR,2010-11,G,Cal Poly,Big West,30,938,145,393,.369,103,241,42,152,.276,125,175,.714,33,133,166,67,44,10,94,78,457
4625,Eric Lockett,JR,2017-18,G,Florida International,CUSA,32,1185,181,388,.466,167,340,14,48,.292,81,113,.717,41,168,209,98,39,12,66,76,457
4626,Greg Mangano,JR,2010-11,F,Yale,Ivy,28,897,171,353,.484,141,271,30,82,.366,85,120,.708,56,225,281,15,12,85,57,87,457
4627,Frantz Massenat,JR,2012-13,G,Drexel,CAA,31,1099,141,386,.365,94,241,47,145,.324,128,158,.810,13,61,74,131,24,13,72,82,457
4628,E.C. Matthews,FR,2013-14,G,Rhode Island,A-10,32,1041,150,356,.421,103,221,47,135,.348,110,149,.738,28,110,138,75,30,22,76,77,457
4629,Rickey McGill,JR,2017-18,G,Iona,MAAC,34,1145,163,363,.449,112,230,51,133,.383,80,114,.702,25,113,138,189,52,4,95,71,457
4630,Lamont Middleton,JR,2012-13,G,North Carolina A&T,MEAC,37,1144,134,355,.377,104,245,30,110,.273,159,227,.700,51,102,153,83,35,9,103,80,457
4631,Walter Offutt,JR,2011-12,G,Ohio,MAC,37,1088,148,329,.450,95,190,53,139,.381,108,152,.711,48,86,134,65,57,4,62,94,457
4632,Dylan Osetkowski,JR,2017-18,F,Texas,Big 12,34,1196,161,402,.400,119,256,42,146,.288,93,129,.721,78,166,244,42,35,7,76,63,457
4633,Dyshawn Pierre,JR,2014-15,F,Dayton,A-10,36,1202,164,354,.463,127,250,37,104,.356,92,136,.676,76,215,291,103,22,15,72,65,457
4634,Jared Quayle,JR,2008-09,G,Utah State,WAC,35,1057,152,327,.465,93,175,59,152,.388,94,123,.764,63,146,209,131,50,5,64,60,457
4635,Will Rayman,JR,2018-19,F,Colgate,Patriot,35,1159,157,369,.425,91,215,66,154,.429,77,113,.681,70,157,227,52,32,27,58,101,457
4636,Jason Richards,SR,2007-08,G,Davidson,Southern,36,1264,153,371,.412,95,189,58,182,.319,93,125,.744,17,93,110,293,50,4,104,57,457
4637,Vinnie Shahid,JR,2018-19,G,North Dakota State,Summit,35,1031,143,325,.440,79,150,64,175,.366,107,126,.849,10,95,105,91,26,0,49,60,457
4638,E.J. Singler,SO,2010-11,F,Oregon,Pac-10,39,1188,149,323,.461,94,185,55,138,.399,104,122,.852,64,156,220,66,41,29,58,101,457
4639,Sindarius Thornwell,JR,2015-16,G,South Carolina,SEC,34,1125,144,377,.382,98,239,46,138,.333,123,161,.764,39,125,164,130,50,16,78,66,457
4640,Chad Timberlake,SR,2005-06,G,Fairleigh Dickinson,NEC,30,1090,175,356,.492,136,255,39,101,.386,68,103,.660,59,106,165,126,41,17,63,48,457
4641,Joe Trapani,SO,2008-09,F,Boston College,ACC,34,990,157,363,.433,105,220,52,143,.364,91,115,.791,69,155,224,50,20,35,67,72,457
4642,Alan Voskuil,SR,2008-09,G,Texas Tech,Big 12,33,1176,140,320,.438,49,111,91,209,.435,86,96,.896,26,110,136,69,40,0,46,69,457
4643,Andre Walker,SR,2017-18,G,Loyola (MD),Patriot,29,929,168,438,.384,102,241,66,197,.335,55,93,.591,28,85,113,80,47,0,84,83,457
4644,Martez Walker,SR,2017-18,G,Oakland,Horizon,26,965,138,299,.462,84,137,54,162,.333,127,163,.779,28,78,106,42,23,15,45,50,457
4645,Jaytornah Wisseh,JR,2008-09,G,Long Island University,NEC,30,1045,135,369,.366,98,269,37,100,.370,150,187,.802,20,90,110,133,47,2,96,54,457
4646,Jordan Aaron,SR,2013-14,G,Milwaukee,Horizon,31,1021,138,369,.374,70,171,68,198,.343,112,137,.818,12,84,96,77,34,4,65,78,456
4647,DeMario Anderson,JR,2006-07,G,Quinnipiac,NEC,29,847,186,366,.508,162,290,24,76,.316,60,91,.659,33,93,126,45,50,10,66,83,456
4648,Isaiah Austin,FR,2012-13,C,Baylor,Big 12,35,1046,181,394,.459,151,304,30,90,.333,64,101,.634,88,204,292,39,12,58,65,81,456
4649,Brandon Bos,SR,2014-15,G,South Dakota,Summit,33,1019,147,398,.369,99,260,48,138,.348,114,138,.826,29,90,119,74,13,2,71,54,456
4650,Ky Bowman,FR,2016-17,G,Boston College,ACC,32,920,160,325,.492,98,187,62,138,.449,74,104,.712,25,130,155,92,37,4,93,78,456
4651,Etienne Brower,SR,2007-08,F,Massachusetts,A-10,36,1085,148,324,.457,66,133,82,191,.429,78,113,.690,74,173,247,58,26,48,49,116,456
4652,Paul Carter,SR,2010-11,F,Illinois-Chicago,Horizon,31,1010,156,382,.408,127,285,29,97,.299,115,150,.767,78,171,249,60,20,22,96,88,456
4653,Semaj Christon,FR,2012-13,G,Xavier,A-10,30,1027,162,365,.444,155,337,7,28,.250,125,186,.672,5,81,86,139,45,3,109,80,456
4654,Paris Collins,SO,2015-16,G,Jackson State,SWAC,35,1067,168,455,.369,113,261,55,194,.284,65,105,.619,50,165,215,62,66,23,67,85,456
4655,Kyle Collinsworth,JR,2014-15,G,Brigham Young,WCC,33,1019,158,335,.472,152,314,6,21,.286,134,182,.736,81,205,286,197,59,11,96,73,456
4656,Quenton DeCosey,JR,2014-15,G,Temple,AAC,37,1109,143,379,.377,92,237,51,142,.359,119,177,.672,37,132,169,81,31,12,66,70,456
4657,Matthew Dellavedova,SO,2010-11,G,Saint Mary's (CA),WCC,34,1199,142,340,.418,74,159,68,181,.376,104,118,.881,37,86,123,180,42,1,80,70,456
4658,Malcolm Duvivier,SR,2017-18,G,Akron,MAC,32,1041,159,408,.390,72,175,87,233,.373,51,79,.646,10,71,81,99,27,6,95,94,456
4659,Keyshawn Evans,JR,2017-18,G,Illinois State,MVC,30,935,140,341,.411,49,124,91,217,.419,85,112,.759,10,70,80,107,19,0,63,58,456
4660,Frankie Ferrari,SR,2018-19,G,San Francisco,WCC,31,1050,152,357,.426,79,175,73,182,.401,79,92,.859,8,92,100,172,49,0,62,59,456
4661,Jordan Fouse,SR,2015-16,G,Green Bay,Horizon,36,1137,157,381,.412,116,248,41,133,.308,101,138,.732,73,227,300,118,77,49,78,109,456
4662,Ivan Gandia-Rosa,SO,2017-18,G,North Florida,A-Sun,33,1080,149,357,.417,73,151,76,206,.369,82,92,.891,12,77,89,205,18,0,103,36,456
4663,Tyree Griffin,SR,2018-19,G,Southern Mississippi,CUSA,33,1140,165,379,.435,111,234,54,145,.372,72,100,.720,15,97,112,233,65,3,87,55,456
4666,Andre Hollins,JR,2014-15,G,Minnesota,Big Ten,33,1007,153,366,.418,71,167,82,199,.412,68,90,.756,27,105,132,89,35,6,61,72,456
4667,Franko House,SR,2016-17,F,Ball State,MAC,34,891,165,314,.525,144,256,21,58,.362,105,138,.761,74,145,219,79,14,20,75,112,456
4668,Jordan Howard,FR,2014-15,G,Central Arkansas,Southland,29,978,146,360,.406,69,162,77,198,.389,87,111,.784,6,66,72,56,14,0,77,38,456
4669,Zak Irvin,SO,2014-15,G,Michigan,Big Ten,32,1160,163,405,.402,86,188,77,217,.355,53,76,.697,31,122,153,49,33,3,47,42,456
4670,Wesley Iwundu,SR,2016-17,F,Kansas State,Big 12,35,1098,151,314,.481,119,229,32,85,.376,122,159,.767,36,185,221,121,35,12,81,63,456
4671,Roosevelt Jones,SR,2015-16,F,Butler,Big East,33,1109,166,355,.468,165,354,1,1,1.000,123,182,.676,67,151,218,154,50,13,77,82,456
4672,Robo Kreps,JR,2009-10,G,Illinois-Chicago,Horizon,30,1070,142,400,.355,86,211,56,189,.296,116,137,.847,22,94,116,64,42,1,65,38,456
4673,Chris Long,SR,2010-11,G,Elon,Southern,31,1044,126,297,.424,72,137,54,160,.338,150,185,.811,19,59,78,188,53,2,69,73,456
4674,Deandre Mathieu,JR,2013-14,G,Minnesota,Big Ten,38,1145,165,323,.511,143,278,22,45,.489,104,138,.754,18,85,103,160,60,3,102,83,456
4675,Javon McCrea,SO,2011-12,F,Buffalo,MAC,31,784,190,332,.572,190,331,0,1,.000,76,136,.559,88,127,215,58,32,38,69,97,456
4676,Jordan McLaughlin,SO,2015-16,G,Southern California,Pac-12,34,1100,162,344,.471,106,212,56,132,.424,76,103,.738,17,111,128,161,55,5,81,34,456
4677,Anthony Morrow,SR,2007-08,G,Georgia Tech,ACC,32,951,154,336,.458,73,155,81,181,.448,67,78,.859,37,93,130,34,36,10,33,60,456
4678,Andrew Nicholas,JR,2013-14,G,Monmouth,MAAC,32,969,165,421,.392,103,244,62,177,.350,64,90,.711,29,77,106,35,29,14,61,88,456
4679,Chuma Okeke,SO,2018-19,F,Auburn,SEC,38,1105,168,339,.496,113,197,55,142,.387,65,90,.722,106,154,260,73,69,46,66,71,456
4680,Prince Okoroh,JR,2013-14,G,Howard,MEAC,33,1095,158,417,.379,144,366,14,51,.275,126,183,.689,55,121,176,37,51,15,88,82,456
4681,Josh Perkins,JR,2017-18,G,Gonzaga,WCC,37,1216,156,355,.439,73,144,83,211,.393,61,81,.753,19,97,116,196,44,3,77,94,456
4682,Justin Pierce,SO,2017-18,F,William & Mary,CAA,31,980,163,325,.502,116,212,47,113,.416,83,105,.790,63,204,267,75,28,19,56,66,456
4683,Rodney Purvis,SR,2016-17,G,Connecticut,AAC,33,1217,151,406,.372,74,180,77,226,.341,77,95,.811,13,126,139,84,34,8,59,71,456
4684,Nick Sherod,SO,2017-18,G,Richmond,A-10,32,1008,165,343,.481,104,187,61,156,.391,65,81,.802,31,128,159,45,31,4,36,58,456
4685,Jason Siggers,SR,2006-07,G,Albany (NY),AEC,33,1029,169,383,.441,123,238,46,145,.317,72,88,.818,52,78,130,75,23,11,70,83,456
4688,Tyler Stone,SO,2011-12,F,Southeast Missouri State,OVC,31,918,193,364,.530,185,341,8,23,.348,62,100,.620,53,174,227,26,21,34,48,71,456
4689,Romeo Travis,JR,2005-06,F,Akron,MAC,33,1009,175,334,.524,170,318,5,16,.313,101,156,.647,66,160,226,62,34,30,57,83,456
4690,Omar Wattad,JR,2010-11,G,Chattanooga,Southern,32,936,143,379,.377,55,135,88,244,.361,82,110,.745,39,78,117,65,27,2,65,79,456
4691,Royce White,SO,2011-12,F,Iowa State,Big 12,34,1072,175,328,.534,171,316,4,12,.333,102,205,.498,85,231,316,170,40,32,130,89,456
4692,Jordan Williams,SR,2014-15,G,North Texas,CUSA,31,1062,153,392,.390,112,243,41,149,.275,109,149,.732,42,110,152,64,47,15,83,69,456
4693,McKinley Wright IV,SO,2018-19,G,Colorado,Pac-12,35,1133,161,326,.494,123,222,38,104,.365,96,119,.807,28,145,173,167,39,7,108,58,456
4694,Isaiah Wright,JR,2017-18,G,San Diego,WCC,34,1173,147,326,.451,94,191,53,135,.393,109,149,.732,11,157,168,181,44,4,105,93,456
4695,Julian Wright,SO,2006-07,F,Kansas,Big 12,38,1048,190,346,.549,187,333,3,13,.231,73,119,.613,96,202,298,82,55,49,91,94,456
4696,Kris Acox,SR,2016-17,F,Furman,Southern,35,1003,199,317,.628,199,317,0,0,,57,102,.559,78,191,269,48,49,25,67,91,455
4697,Quincy Acy,SR,2011-12,F,Baylor,Big 12,38,1130,158,274,.577,155,269,3,5,.600,136,174,.782,99,183,282,38,35,70,71,117,455
4698,Noruwa Agho,SO,2009-10,G,Columbia,Ivy,28,966,151,355,.425,93,225,58,130,.446,95,130,.731,28,90,118,53,37,1,67,49,455
4699,Olu Ashaolu,JR,2010-11,F,Louisiana Tech,WAC,32,990,163,309,.528,151,268,12,41,.293,117,194,.603,86,214,300,52,31,10,111,116,455
4700,Byron Ashe,JR,2015-16,G,Mount St. Mary's,NEC,33,1030,166,412,.403,113,242,53,170,.312,70,97,.722,31,118,149,56,42,16,58,92,455
4701,Justin Bowen,SR,2005-06,F,Illinois-Chicago,Horizon,31,1003,182,347,.524,173,320,9,27,.333,82,105,.781,77,134,211,32,40,20,47,83,455
4702,Michael Bramos,JR,2007-08,F,Miami (OH),MAC,28,972,150,345,.435,85,166,65,179,.363,90,107,.841,18,91,109,33,36,42,37,48,455
4703,Zac Cuthbertson,JR,2017-18,F,Coastal Carolina,Sun Belt,31,909,141,313,.450,112,217,29,96,.302,144,181,.796,58,152,210,49,29,22,72,85,455
4704,Ronald Delph,SR,2017-18,C,Florida Atlantic,CUSA,31,910,201,405,.496,201,403,0,2,.000,53,76,.697,84,186,270,23,13,63,52,82,455
4705,Jeremiah Dominguez,JR,2007-08,G,Portland State,Big Sky,32,989,153,325,.471,69,131,84,194,.433,65,80,.813,14,54,68,130,62,2,78,51,455
4706,Andre Fox,JR,2017-18,G,High Point,Big South,29,829,150,316,.475,95,187,55,129,.426,100,133,.752,15,125,140,40,36,8,59,63,455
4707,Warren Gillis,SR,2014-15,G,Coastal Carolina,Big South,34,1064,160,366,.437,134,281,26,85,.306,109,125,.872,22,84,106,108,48,3,88,76,455
4710,Justin Graham,SR,2010-11,G,San Jose State,WAC,32,1161,163,388,.420,126,299,37,89,.416,92,138,.667,25,119,144,141,73,12,72,77,455
4711,David Hanson,JR,2010-11,F,Cal Poly,Big West,30,1060,165,402,.410,92,200,73,202,.361,52,83,.627,63,121,184,55,30,8,37,68,455
4712,Josh Hawkinson,SO,2014-15,F,Washington State,Pac-12,31,1015,166,332,.500,159,297,7,35,.200,116,136,.853,65,269,334,30,12,34,32,67,455
4713,Dakarai Henderson,JR,2015-16,G,Sam Houston State,Southland,32,953,151,397,.380,76,178,75,219,.342,78,113,.690,26,65,91,47,19,2,42,48,455
4714,Jeromie Hill,FR,2010-11,F,Texas-San Antonio,Southland,34,1037,177,373,.475,135,268,42,105,.400,59,93,.634,69,156,225,35,26,17,87,82,455
4715,Ian Hummer,SR,2012-13,F,Princeton,Ivy,28,952,171,331,.517,164,307,7,24,.292,106,147,.721,51,127,178,115,36,23,79,64,455
4716,Holton Hunsaker,SR,2013-14,G,Utah Valley,WAC,32,1076,118,351,.336,51,152,67,199,.337,152,176,.864,2,70,72,134,32,0,87,76,455
4717,Kareem Jamar,JR,2012-13,G,Montana,Big Sky,32,1119,157,318,.494,119,211,38,107,.355,103,145,.710,36,152,188,129,29,21,93,79,455
4718,Scottie James,JR,2018-19,F,Liberty,A-Sun,36,882,175,263,.665,167,239,8,24,.333,97,136,.713,103,206,309,39,11,20,62,72,455
4719,Joseph Jones,JR,2006-07,C,Texas A&M,Big 12,34,929,159,288,.552,147,258,12,30,.400,125,160,.781,84,146,230,43,39,26,54,114,455
4720,Paris Lee,SR,2016-17,G,Illinois State,MVC,35,1080,149,354,.421,68,160,81,194,.418,76,97,.784,11,117,128,176,65,4,86,50,455
4721,Ray Lee,SR,2016-17,G,Eastern Michigan,MAC,29,755,144,356,.404,91,207,53,149,.356,114,133,.857,13,36,49,72,45,2,80,64,455
4722,Shake Milton,SO,2016-17,G,Southern Methodist,AAC,35,1239,152,348,.437,70,154,82,194,.423,69,91,.758,15,129,144,159,44,11,63,54,455
4723,Stefan Moody,FR,2012-13,G,Florida Atlantic,Sun Belt,29,908,151,359,.421,99,212,52,147,.354,101,124,.815,19,102,121,65,21,9,91,59,455
4724,Jovan Mooring,SR,2017-18,G,Nevada-Las Vegas,MWC,33,1077,135,362,.373,72,160,63,202,.312,122,152,.803,9,91,100,110,38,2,62,75,455
4725,Matt Mullery,SR,2009-10,F,Brown,Ivy,30,939,165,303,.545,157,268,8,35,.229,117,164,.713,40,147,187,86,22,48,83,65,455
4726,Mark Nwakamma,SO,2012-13,F,Hartford,AEC,31,883,178,375,.475,161,323,17,52,.327,82,133,.617,47,123,170,57,44,21,101,102,455
4727,David Patten,SR,2006-07,F,Weber State,Big Sky,32,866,167,313,.534,145,255,22,58,.379,99,180,.550,58,114,172,33,37,34,65,79,455
4728,Adrian Powell,SR,2012-13,F,North Carolina A&T,MEAC,37,1159,162,408,.397,100,238,62,170,.365,69,118,.585,43,140,183,72,66,12,78,70,455
4729,Marvin Prochet,SR,2018-19,F,Niagara,MAAC,29,933,150,356,.421,75,178,75,178,.421,80,115,.696,50,163,213,49,21,23,48,53,455
4732,Evan Roquemore,JR,2012-13,G,Santa Clara,WCC,38,1194,138,330,.418,89,184,49,146,.336,130,160,.813,20,102,122,196,46,8,83,78,455
4733,Keith Simmons,JR,2005-06,G,Holy Cross,Patriot,32,995,158,301,.525,98,175,60,126,.476,79,97,.814,67,99,166,47,37,10,49,66,455
4734,Addison Spruill,SR,2014-15,G,North Carolina-Wilmington,CAA,32,981,165,371,.445,151,320,14,51,.275,111,152,.730,57,152,209,52,30,16,73,81,455
4735,B.J. Stith,JR,2017-18,G,Old Dominion,CUSA,32,1006,157,359,.437,101,220,56,139,.403,85,101,.842,24,157,181,55,25,5,50,58,455
4736,Michael Tveidt,JR,2009-10,F,North Dakota State,Summit,29,997,181,417,.434,152,321,29,96,.302,64,82,.780,34,129,163,44,35,12,61,81,455
4737,Eric Washington,JR,2014-15,G,Miami (OH),MAC,32,1029,137,304,.451,111,225,26,79,.329,155,195,.795,26,76,102,176,45,1,108,71,455
4738,Maalik Wayns,SO,2010-11,G,Villanova,Big East,33,994,141,353,.399,109,235,32,118,.271,141,172,.820,21,72,93,148,38,1,91,78,455
4739,Kelly Whitney,SR,2005-06,F,Seton Hall,Big East,30,1085,163,360,.453,163,360,0,0,,129,184,.701,88,150,238,36,36,22,88,83,455
4740,C.J. Wilcox,SO,2011-12,G,Washington,Pac-12,32,912,152,348,.437,79,167,73,181,.403,78,93,.839,26,82,108,39,29,20,40,63,455
4741,Jeff Allen,SR,2010-11,F,Virginia Tech,ACC,34,1097,178,355,.501,173,321,5,34,.147,93,141,.660,92,238,330,60,44,25,99,117,454
4742,Terry Allen,JR,2014-15,F,Richmond,A-10,35,1093,170,331,.514,154,265,16,66,.242,98,131,.748,56,177,233,47,48,23,67,77,454
4743,Carlon Brown,SR,2011-12,G,Colorado,Pac-12,36,1027,169,378,.447,126,238,43,140,.307,73,101,.723,31,105,136,73,28,10,70,59,454
4744,Antwan Carter,SO,2009-10,C,Longwood,Ind,31,779,196,374,.524,191,356,5,18,.278,57,92,.620,106,159,265,26,25,20,70,105,454
4745,Travis Charles,SR,2017-18,F,Albany (NY),AEC,31,896,174,314,.554,174,314,0,0,,106,129,.822,60,115,175,22,17,13,55,87,454
4746,Sherron Dorsey-Walker,SR,2016-17,G,Oakland,Horizon,34,1114,139,358,.388,69,167,70,191,.366,106,140,.757,19,153,172,129,37,6,74,66,454
4747,Muhammad El-Amin,JR,2008-09,G,Stony Brook,AEC,29,768,159,364,.437,111,239,48,125,.384,88,107,.822,39,61,100,34,18,2,64,55,454
4748,Brandon Fortenberry,SR,2012-13,G,Southeastern Louisiana,Southland,31,1101,148,369,.401,98,222,50,147,.340,108,147,.735,24,114,138,86,29,8,58,59,454
4749,Ja'Dante' Frye,SR,2016-17,F,Nicholls State,Southland,31,1044,157,344,.456,119,239,38,105,.362,102,132,.773,55,130,185,48,26,14,60,59,454
4750,Jay Harris,SR,2014-15,G,Illinois-Chicago,Horizon,30,974,122,318,.384,71,161,51,157,.325,159,177,.898,19,71,90,110,39,3,84,57,454
4751,Roy Hibbert,SR,2007-08,C,Georgetown,Big East,34,894,179,294,.609,176,291,3,3,1.000,93,144,.646,75,141,216,63,18,75,57,92,454
4752,Tra Holder,SO,2015-16,G,Arizona State,Pac-12,32,1017,140,362,.387,91,228,49,134,.366,125,172,.727,22,90,112,117,33,2,84,66,454
4753,Kelsey Howard,SO,2011-12,G,Jackson State,SWAC,31,999,151,390,.387,105,246,46,144,.319,106,139,.763,39,88,127,28,30,4,78,73,454
4754,Shawn Huff,SR,2007-08,G,Valparaiso,Horizon,36,1130,153,314,.487,62,124,91,190,.479,57,68,.838,42,119,161,56,10,18,77,75,454
4755,Casey Jones,SO,2014-15,G,Chattanooga,Southern,32,945,168,324,.519,165,312,3,12,.250,115,162,.710,80,145,225,59,37,37,85,82,454
4756,Jamal Jones,JR,2013-14,G,Texas A&M,SEC,34,945,147,403,.365,65,179,82,224,.366,78,104,.750,34,104,138,43,25,12,53,61,454
4757,LeAntwan Luckett,SO,2012-13,F,Alcorn State,SWAC,34,1117,158,421,.375,145,351,13,70,.186,125,193,.648,47,89,136,80,34,8,97,98,454
4758,Sam Maniscalco,SO,2008-09,G,Bradley,MVC,36,1181,138,336,.411,67,130,71,206,.345,107,128,.836,4,64,68,110,41,0,74,81,454
4759,Stephen Maxwell,SO,2012-13,F,Cal State Northridge,Big West,31,865,173,311,.556,173,311,0,0,,108,149,.725,119,138,257,16,30,10,53,73,454
4760,Tahjere McCall,SR,2015-16,G,Tennessee State,OVC,31,932,138,303,.455,118,231,20,72,.278,158,209,.756,47,112,159,93,72,11,97,101,454
4761,Jamie McNeilly,SR,2006-07,G,New Orleans,Sun Belt,30,1128,157,350,.449,95,197,62,153,.405,78,98,.796,17,95,112,90,48,6,59,74,454
4762,Afam Muojeke,FR,2008-09,G,Wyoming,MWC,33,991,154,333,.462,113,209,41,124,.331,105,144,.729,18,157,175,51,27,13,106,66,454
4763,Justin Nabors,SR,2009-10,F,Lamar,Southland,31,955,165,322,.512,159,301,6,21,.286,118,172,.686,110,191,301,50,27,21,103,80,454
4764,Obadiah Noel,SO,2018-19,G,Massachusetts-Lowell,AEC,31,894,160,309,.518,135,231,25,78,.321,109,150,.727,38,71,109,62,40,11,69,78,454
4765,Gerald Robinson,SR,2011-12,G,Georgia,SEC,32,979,159,367,.433,133,296,26,71,.366,110,138,.797,21,102,123,114,41,2,79,60,454
4766,Matt Stainbrook,SR,2014-15,C,Xavier,Big East,37,987,173,282,.613,172,277,1,5,.200,107,140,.764,73,184,257,89,22,24,73,93,454
4767,Anthony Tarke,SO,2017-18,F,NJIT,A-Sun,29,930,161,399,.404,120,256,41,143,.287,91,142,.641,45,136,181,57,38,24,60,65,454
4768,Sindarius Thornwell,FR,2013-14,G,South Carolina,SEC,34,1007,143,370,.386,106,270,37,100,.370,131,178,.736,48,91,139,101,40,21,106,100,454
4769,Dante Thorpe,SR,2018-19,G,Northern Illinois,MAC,33,1064,169,319,.530,141,249,28,70,.400,88,110,.800,17,76,93,82,37,0,63,78,454
4770,Austin Tillotson,SR,2015-16,G,Colgate,Patriot,30,1032,161,370,.435,105,206,56,164,.341,76,95,.800,20,79,99,155,58,1,72,56,454
4771,Sebastian Townes,JR,2018-19,F,Bryant,NEC,30,874,159,344,.462,130,260,29,84,.345,107,163,.656,54,94,148,37,13,6,66,86,454
4774,Anthony Vereen,JR,2007-08,F,Texas-Arlington,Southland,33,752,146,257,.568,138,229,8,28,.286,154,209,.737,45,112,157,54,21,3,79,97,454
4775,Corey Walden,SO,2012-13,G,Eastern Kentucky,OVC,35,1019,142,285,.498,101,171,41,114,.360,129,147,.878,28,93,121,65,61,4,57,105,454
4776,DeVaughn Washington,SR,2010-11,F,Ohio,MAC,34,1004,167,320,.522,166,319,1,1,1.000,119,188,.633,59,133,192,32,36,13,62,102,454
4777,DaShaun Wiggins,SR,2014-15,G,Portland State,Big Sky,29,823,133,322,.413,74,187,59,135,.437,129,176,.733,17,93,110,47,44,2,59,79,454
4778,Jamaal Williams,SR,2005-06,F,Washington,Pac-10,33,781,200,403,.496,199,401,1,2,.500,53,79,.671,75,81,156,43,44,25,63,79,454
4779,Jerrell Williams,SR,2010-11,F,La Salle,A-10,33,878,173,358,.483,170,348,3,10,.300,105,177,.593,114,129,243,46,37,7,111,108,454
4780,Tim Williams,FR,2012-13,F,Samford,Southern,32,1119,178,327,.544,178,327,0,0,,98,144,.681,58,170,228,25,47,35,48,67,454
4781,McKinley Wright IV,FR,2017-18,G,Colorado,Pac-12,32,1042,166,368,.451,138,276,28,92,.304,94,122,.770,52,97,149,175,31,14,94,49,454
4782,Michael Young,SO,2014-15,F,Pittsburgh,ACC,34,1077,167,315,.530,162,298,5,17,.294,115,166,.693,111,138,249,44,21,28,38,89,454
4783,Talib Zanna,JR,2013-14,F,Pittsburgh,ACC,35,1061,160,273,.586,160,271,0,2,.000,134,201,.667,115,185,300,19,22,29,54,90,454
4784,Chase Adams,JR,2008-09,G,Centenary (LA),Summit,31,1071,142,327,.434,70,146,72,181,.398,97,138,.703,,,131,141,83,2,63,,453
4785,Ben Aird,JR,2012-13,C,Utah Valley,GWC,30,1009,177,308,.575,170,284,7,24,.292,92,125,.736,79,190,269,28,24,58,35,83,453
4786,O'Darien Bassett,JR,2006-07,G,Troy,Sun Belt,30,928,161,389,.414,106,244,55,145,.379,76,100,.760,12,51,63,91,28,3,82,50,453
4787,Justin Black,JR,2012-13,G,Morgan State,MEAC,32,1064,165,376,.439,128,264,37,112,.330,86,141,.610,76,59,135,94,39,1,94,81,453
4788,Jon Brockman,SO,2006-07,F,Washington,Pac-10,32,921,175,318,.550,175,318,0,0,,103,156,.660,117,190,307,35,24,4,84,90,453
4789,Ahmad Caver,JR,2017-18,G,Old Dominion,CUSA,32,1189,155,380,.408,90,194,65,186,.349,78,117,.667,19,94,113,197,73,5,65,52,453
4790,Daryl Cohen,SR,2006-07,G,Southeastern Louisiana,Southland,30,912,155,394,.393,50,109,105,285,.368,38,58,.655,20,76,96,26,30,6,47,51,453
4791,Dikembe Dixson,SO,2017-18,F,Illinois-Chicago,Horizon,32,950,149,383,.389,114,272,35,111,.315,120,164,.732,22,89,111,26,40,6,89,58,453
4792,Kevin Downey,SR,2005-06,G,Canisius,MAAC,29,1077,176,367,.480,132,237,44,130,.338,57,74,.770,25,112,137,97,36,0,62,46,453
4793,Anthony Downing,SR,2012-13,G,Missouri State,MVC,33,1133,150,375,.400,115,239,35,136,.257,118,148,.797,33,112,145,88,35,2,55,68,453
4796,Madarious Gibbs,SR,2014-15,G,Texas Southern,SWAC,32,1234,158,368,.429,135,277,23,91,.253,114,169,.675,20,86,106,135,30,2,92,71,453
4797,Matt Haryasz,SR,2005-06,F,Stanford,Pac-10,28,917,156,325,.480,152,310,4,15,.267,137,183,.749,75,169,244,39,16,47,60,65,453
4798,Andrew Hayles,JR,2007-08,G,Alabama State,SWAC,31,981,155,345,.449,89,172,66,173,.382,77,102,.755,32,81,113,54,35,4,46,55,453
4799,Corey Henson,SO,2015-16,G,Wagner,NEC,34,1025,155,362,.428,81,178,74,184,.402,69,84,.821,21,82,103,98,39,1,61,77,453
4800,Boomer Herndon,JR,2005-06,C,Belmont,A-Sun,31,702,184,318,.579,184,318,0,0,,85,145,.586,107,123,230,25,23,56,78,81,453
4801,Travis Holmes,JR,2007-08,F,Virginia Military Institute,Big South,29,798,148,361,.410,107,209,41,152,.270,116,150,.773,53,117,170,80,63,17,79,65,453
4802,Tony Hooper,JR,2007-08,G,Louisiana-Monroe,Sun Belt,30,866,156,371,.420,94,174,62,197,.315,79,116,.681,23,48,71,72,47,6,106,94,453
4803,Deonte Huff,SR,2007-08,G,Portland State,Big Sky,33,1012,155,307,.505,131,229,24,78,.308,119,159,.748,71,128,199,85,42,6,81,69,453
4804,Kevin Lisch,JR,2007-08,G,Saint Louis,A-10,31,1068,137,320,.428,74,156,63,164,.384,116,143,.811,12,106,118,97,38,4,64,63,453
4805,Ian Miller,SR,2013-14,G,Florida State,ACC,33,938,146,325,.449,81,162,65,163,.399,96,110,.873,11,72,83,92,24,1,96,64,453
4806,Randy Miller,SR,2018-19,G,North Carolina Central,MEAC,34,972,139,332,.419,73,154,66,178,.371,109,135,.807,13,68,81,64,29,1,67,66,453
4807,Justin Patton,FR,2016-17,C,Creighton,Big East,35,885,200,296,.676,192,281,8,15,.533,45,87,.517,59,159,218,41,30,50,60,96,453
4808,Evan Payne,JR,2016-17,G,Cal State Long Beach,Big West,32,875,146,353,.414,90,197,56,156,.359,105,122,.861,20,100,120,38,25,5,61,51,453
4809,JayVaughn Pinkston,SO,2012-13,F,Villanova,Big East,34,889,136,293,.464,126,256,10,37,.270,171,241,.710,63,107,170,58,33,16,86,89,453
4810,K.C. Rivers,SR,2008-09,G,Clemson,ACC,32,991,173,385,.449,104,209,69,176,.392,38,57,.667,64,129,193,52,55,14,44,48,453
4811,Fatts Russell,SO,2018-19,G,Rhode Island,A-10,32,1090,149,441,.338,109,262,40,179,.223,115,156,.737,18,69,87,117,56,10,74,81,453
4812,Rodriguez Sherman,SR,2010-11,G,Kent State,MAC,36,1099,158,347,.455,112,223,46,124,.371,91,121,.752,52,85,137,103,56,4,88,83,453
4813,Devin Sibley,SR,2017-18,G,Furman,Southern,32,850,172,373,.461,121,221,51,152,.336,58,106,.547,14,143,157,63,25,10,87,63,453
4814,Terence Smith,JR,2013-14,G,Tennessee-Martin,OVC,31,960,134,312,.429,74,175,60,137,.438,125,152,.822,35,77,112,86,31,4,45,80,453
4815,Bryan Smithson,JR,2006-07,G,North Carolina-Asheville,Big South,31,960,156,374,.417,113,253,43,121,.355,98,115,.852,18,94,112,84,60,8,92,53,453
4818,Dylan Talley,SR,2012-13,G,Nebraska,Big Ten,33,1173,161,433,.372,110,284,51,149,.342,80,108,.741,27,130,157,81,30,8,71,74,453
4819,Ayinde Ubaka,SR,2006-07,G,University of California,Pac-10,33,1158,152,361,.421,93,196,59,165,.358,90,116,.776,14,85,99,142,24,1,67,50,453
4820,Benny Valentine,JR,2008-09,G,Eastern Washington,Big Sky,30,908,160,406,.394,105,248,55,158,.348,78,108,.722,10,73,83,92,44,0,81,85,453
4821,Travis Wallace,JR,2012-13,F,North Florida,A-Sun,32,764,183,317,.577,182,316,1,1,1.000,86,130,.662,58,108,166,21,17,29,49,57,453
4822,Christian Watford,JR,2011-12,F,Indiana,Big Ten,36,1023,141,339,.416,89,220,52,119,.437,119,146,.815,42,166,208,48,27,16,62,73,453
4823,Ryan Wedel,SO,2007-08,G,Arkansas State,Sun Belt,30,959,148,343,.431,58,119,90,224,.402,67,82,.817,9,67,76,50,30,5,53,63,453
4824,Jordan Williams,SO,2012-13,G,North Texas,Sun Belt,32,1014,153,368,.416,107,233,46,135,.341,101,138,.732,50,69,119,23,23,18,69,72,453
4825,Kendall Williams,JR,2012-13,G,New Mexico,MWC,34,1170,126,310,.406,78,172,48,138,.348,153,200,.765,17,103,120,166,38,3,72,48,453
4826,Elijah Wilson,JR,2015-16,G,Coastal Carolina,Big South,33,1028,156,396,.394,80,185,76,211,.360,65,93,.699,30,102,132,31,25,8,56,70,453
4827,Derrick Barden,SR,2013-14,F,Northern Colorado,Big Sky,32,983,180,313,.575,164,270,16,43,.372,76,115,.661,99,150,249,40,41,16,35,48,452
4828,Beau Beech,JR,2014-15,G,North Florida,A-Sun,35,1065,149,351,.425,60,118,89,233,.382,65,83,.783,36,164,200,50,43,10,64,92,452
4829,Jeremiah Bell,JR,2017-18,G,Milwaukee,Horizon,32,975,157,371,.423,82,175,75,196,.383,63,83,.759,10,92,102,57,38,3,44,74,452
4830,Johnnie Bryant,JR,2006-07,G,Utah,MWC,30,1036,150,344,.436,62,136,88,208,.423,64,78,.821,17,65,82,81,14,0,52,55,452
4831,Brian Burrell,JR,2006-07,G,Texas-Rio Grande Valley,Ind,29,915,161,372,.433,80,169,81,203,.399,49,56,.875,37,111,148,41,42,3,55,57,452
4832,Kenny Carpenter,SR,2017-18,G,Cleveland State,Horizon,34,1146,177,372,.476,120,211,57,161,.354,41,58,.707,24,149,173,82,37,15,42,79,452
4833,Tre' Coggins,JR,2015-16,G,Cal State Fullerton,Big West,29,865,145,368,.394,70,158,75,210,.357,87,102,.853,14,98,112,52,20,4,71,61,452
4834,Erik Etherly,JR,2011-12,F,Loyola (MD),MAAC,33,1030,168,317,.530,165,306,3,11,.273,113,162,.698,83,163,246,63,35,48,79,65,452
4835,Armon Fletcher,JR,2017-18,G,Southern Illinois,MVC,32,1011,153,315,.486,113,200,40,115,.348,106,145,.731,46,116,162,54,38,16,41,73,452
4836,Taj Gibson,FR,2006-07,F,Southern California,Pac-10,37,1198,174,312,.558,174,312,0,0,,104,167,.623,101,220,321,55,20,69,107,110,452
4837,Mustapha Heron,JR,2018-19,G,St. John's (NY),Big East,31,982,153,348,.440,105,229,48,119,.403,98,130,.754,30,114,144,41,33,6,71,97,452
4840,Jordan Hill,SR,2017-18,G,Seattle,WAC,33,1112,150,378,.397,76,174,74,204,.363,78,101,.772,19,107,126,114,41,14,99,107,452
4841,Solomon Hill,JR,2011-12,F,Arizona,Pac-12,35,1134,151,302,.500,114,207,37,95,.389,113,156,.724,76,195,271,91,36,18,86,91,452
4842,David Holston,JR,2006-07,G,Chicago State,Ind,29,961,147,366,.402,53,132,94,234,.402,64,77,.831,41,50,91,100,44,3,73,83,452
4843,Troy Huff,FR,2010-11,G,North Dakota,GWC,34,894,165,377,.438,126,259,39,118,.331,83,133,.624,57,100,157,38,41,11,75,51,452
4844,Justin Ingram,JR,2005-06,G,Toledo,MAC,31,981,134,330,.406,77,161,57,169,.337,127,145,.876,20,79,99,91,58,9,66,60,452
4845,Dominic James,JR,2007-08,G,Marquette,Big East,35,1060,159,399,.398,114,254,45,145,.310,89,134,.664,31,62,93,154,62,8,75,76,452
4846,Tony Johnson,SR,2012-13,G,Lafayette,Patriot,34,1060,166,304,.546,137,241,29,63,.460,91,112,.813,20,109,129,162,65,7,76,65,452
4847,Christian Kessee,JR,2015-16,G,Coppin State,MEAC,31,1007,150,385,.390,62,162,88,223,.395,64,80,.800,15,62,77,58,20,0,63,74,452
4848,Michael Kessens,FR,2012-13,F,Longwood,Big South,33,1078,174,324,.537,170,306,4,18,.222,100,143,.699,86,204,290,47,38,42,96,105,452
4849,Marvin Lea,SR,2006-07,G,Pepperdine,WCC,31,947,151,407,.371,102,258,49,149,.329,101,162,.623,42,108,150,96,62,3,87,65,452
4850,Alex Len,SO,2012-13,C,Maryland,ACC,38,1004,173,324,.534,172,316,1,8,.125,105,153,.686,109,189,298,37,8,78,60,101,452
4851,Mike Lewis,FR,2016-17,G,Duquesne,A-10,32,1025,140,342,.409,77,167,63,175,.360,109,131,.832,4,68,72,53,20,1,63,65,452
4852,Scottie Lindsey,JR,2016-17,G,Northwestern,Big Ten,32,975,163,384,.424,105,204,58,180,.322,68,81,.840,17,105,122,73,30,9,44,73,452
4853,Frank Mason,SO,2014-15,G,Kansas,Big 12,36,1207,150,340,.441,108,242,42,98,.429,110,140,.786,22,119,141,142,50,4,74,65,452
4854,Matt Mullery,JR,2008-09,F,Brown,Ivy,28,927,174,287,.606,166,267,8,20,.400,96,149,.644,55,128,183,56,22,59,69,72,452
4855,Abdel Nader,SR,2015-16,F,Iowa State,Big 12,35,1088,161,337,.478,109,197,52,140,.371,78,106,.736,26,148,174,54,37,23,79,98,452
4856,Shane Nichols,JR,2006-07,G,Wofford,Southern,29,926,140,327,.428,55,126,85,201,.423,87,106,.821,14,51,65,52,15,3,49,58,452
4857,Sir'Dominic Pointer,SR,2014-15,G,St. John's (NY),Big East,33,1143,175,334,.524,173,309,2,25,.080,100,138,.725,64,189,253,98,63,80,66,99,452
4858,Leon Powell,JR,2010-11,F,Southeast Missouri State,OVC,32,1007,172,273,.630,172,273,0,0,,108,205,.527,103,144,247,32,19,49,58,117,452
4859,Ryan Rhoomes,SR,2015-16,F,Fordham,A-10,31,984,187,289,.647,187,289,0,0,,78,133,.586,130,171,301,42,21,57,63,100,452
4860,Latif Rivers,SO,2011-12,G,Wagner,NEC,31,941,143,351,.407,84,183,59,168,.351,107,121,.884,12,70,82,68,22,12,67,79,452
4861,Kerwin Roach,SR,2018-19,G,Texas,Big 12,31,905,156,355,.439,102,203,54,152,.355,86,125,.688,20,113,133,100,36,9,70,70,452
4862,Willie Rodriguez,SO,2015-16,F,Binghamton,AEC,30,945,156,346,.451,134,262,22,84,.262,118,154,.766,66,134,200,39,32,9,78,84,452
4863,Diamon Simpson,SO,2006-07,F,Saint Mary's (CA),WCC,32,909,155,320,.484,149,290,6,30,.200,136,211,.645,107,138,245,28,43,79,84,79,452
4864,Stephen Sir,SR,2006-07,G,Northern Arizona,Big Sky,30,826,142,302,.470,18,49,124,253,.490,44,50,.880,6,61,67,48,15,2,49,66,452
4865,Devin Thomas,SR,2015-16,F,Wake Forest,ACC,29,891,162,299,.542,162,299,0,0,,128,219,.584,89,207,296,70,19,46,81,88,452
4866,Rashawn Thomas,SO,2014-15,F,Texas A&M-Corpus Christi,Southland,33,913,154,281,.548,154,275,0,6,.000,144,226,.637,95,167,262,34,18,40,103,121,452
4867,Kris Wilkes,FR,2017-18,G,UCLA,Pac-12,33,983,160,363,.441,104,204,56,159,.352,76,116,.655,43,119,162,56,25,18,44,83,452
4868,Jason Williams,SR,2005-06,G,Texas-El Paso,CUSA,30,1039,163,335,.487,151,297,12,38,.316,114,178,.640,79,142,221,108,46,7,90,55,452
4869,DeVaughn Akoon-Purcell,SR,2015-16,G,Illinois State,MVC,32,895,157,364,.431,138,291,19,73,.260,118,165,.715,51,107,158,60,30,13,86,62,451
4870,Jeff Allen,SO,2008-09,F,Virginia Tech,ACC,33,1006,158,324,.488,141,282,17,42,.405,118,193,.611,93,184,277,43,61,42,90,115,451
4871,Schadrac Casimir,SR,2018-19,G,Florida Gulf Coast,A-Sun,32,986,134,279,.480,60,124,74,155,.477,109,124,.879,17,67,84,76,31,0,67,45,451
4872,Maurice Creek,SR,2013-14,G,George Washington,A-10,32,940,145,350,.414,65,150,80,200,.400,81,109,.743,23,85,108,56,34,5,69,69,451
4873,Jeantal Cylla,JR,2018-19,F,North Carolina-Wilmington,CAA,33,930,156,365,.427,123,259,33,106,.311,106,125,.848,48,103,151,18,17,17,46,86,451
4874,Kyvon Davenport,JR,2017-18,F,Memphis,AAC,34,995,153,300,.510,114,190,39,110,.355,106,153,.693,71,138,209,27,21,42,56,95,451
4875,Rodney Elliott,FR,2013-14,G,Maryland-Baltimore County,AEC,30,941,141,312,.452,96,185,45,127,.354,124,178,.697,19,99,118,108,40,1,108,101,451
4876,Phil Fayne,JR,2017-18,F,Illinois State,MVC,29,866,181,304,.595,181,304,0,0,,89,173,.514,99,117,216,27,35,28,51,82,451
4877,Phil Forte,SO,2013-14,G,Oklahoma State,Big 12,34,976,129,302,.427,29,75,100,227,.441,93,107,.869,12,50,62,46,29,1,22,46,451
4878,Jarrid Frye,JR,2005-06,G,Sacred Heart,NEC,28,888,162,361,.449,143,286,19,75,.253,108,161,.671,42,138,180,73,49,14,88,85,451
4879,Novar Gadson,JR,2010-11,G,Rider,MAAC,33,924,163,347,.470,124,243,39,104,.375,86,128,.672,43,148,191,56,27,31,79,97,451
4882,Clide Geffrard,SR,2015-16,F,Stephen F. Austin,Southland,34,825,153,312,.490,108,182,45,130,.346,100,125,.800,70,130,200,47,31,19,56,79,451
4883,Daniel Hamilton,SO,2015-16,G,Connecticut,AAC,36,1147,159,411,.387,112,269,47,142,.331,86,100,.860,33,288,321,170,38,15,85,66,451
4884,T.J. Holyfield,JR,2017-18,F,Stephen F. Austin,Southland,35,956,167,305,.548,139,237,28,68,.412,89,119,.748,84,139,223,30,40,44,95,101,451
4885,Keith Hornsby,SO,2012-13,G,North Carolina-Asheville,Big South,30,1007,151,348,.434,101,216,50,132,.379,99,107,.925,25,101,126,94,43,7,67,52,451
4886,Aundre Jackson,JR,2016-17,F,Loyola (IL),MVC,32,764,178,266,.669,164,235,14,31,.452,81,118,.686,39,94,133,31,17,11,54,80,451
4887,Donovan Jackson,SR,2017-18,G,Iowa State,Big 12,30,1032,143,375,.381,48,138,95,237,.401,70,80,.875,8,55,63,62,15,2,48,62,451
4888,Trejon Jacob,SO,2017-18,G,Florida International,CUSA,31,1043,158,367,.431,86,175,72,192,.375,63,98,.643,26,128,154,28,35,8,37,51,451
4889,Deckie Johnson,JR,2015-16,G,North Texas,CUSA,31,1007,140,361,.388,67,141,73,220,.332,98,124,.790,44,95,139,69,29,6,59,77,451
4890,Steffan Johnson,JR,2007-08,G,Pacific,Big West,31,971,151,327,.462,87,171,64,156,.410,85,114,.746,14,75,89,151,45,8,107,36,451
4891,Raijon Kelly,SO,2012-13,G,Samford,Southern,32,1180,161,388,.415,100,237,61,151,.404,68,87,.782,13,60,73,151,27,3,103,77,451
4892,Jonathan Lee,JR,2011-12,G,Northeastern,CAA,31,1089,151,320,.472,101,200,50,120,.417,99,126,.786,28,90,118,107,46,3,97,74,451
4893,Loudon Love,FR,2017-18,F,Wright State,Horizon,35,972,186,349,.533,186,348,0,1,.000,79,146,.541,106,235,341,38,27,34,84,95,451
4894,Joey Lynch-Flohr,JR,2008-09,C,Radford,Big South,33,980,170,327,.520,170,327,0,0,,111,154,.721,79,117,196,48,21,13,72,105,451
4895,Charles Minlend,SO,2018-19,G,San Francisco,WCC,31,940,159,382,.416,115,229,44,153,.288,89,128,.695,41,104,145,52,28,16,47,43,451
4896,Kenneth Ogbe,SR,2017-18,G,Utah Valley,WAC,33,1002,150,311,.482,83,155,67,156,.429,84,121,.694,19,85,104,49,26,7,57,60,451
4897,Jordan Sibert,JR,2013-14,G,Dayton,A-10,37,963,147,323,.455,64,128,83,195,.426,74,104,.712,14,70,84,55,30,4,46,64,451
4898,Kyle Singler,FR,2007-08,F,Duke,ACC,34,972,159,348,.457,108,198,51,150,.340,82,106,.774,70,128,198,48,36,25,75,104,451
4899,Malik Smith,JR,2012-13,G,Florida International,Sun Belt,32,1060,135,371,.364,39,106,96,265,.362,85,111,.766,14,73,87,41,31,1,66,70,451
4900,Martin Smith,JR,2013-14,F,Lipscomb,A-Sun,29,946,134,327,.410,66,138,68,189,.360,115,142,.810,30,78,108,66,28,9,53,64,451
4901,James Southerland,SR,2012-13,F,Syracuse,Big East,34,1003,161,358,.450,77,147,84,211,.398,45,57,.789,44,133,177,36,49,28,39,79,451
4904,Chehales Tapscott,SR,2011-12,F,Portland State,Big Sky,32,1019,154,293,.526,140,248,14,45,.311,129,175,.737,97,200,297,59,56,43,78,90,451
4905,Josh Taylor,SR,2009-10,F,Eastern Kentucky,OVC,33,1061,161,341,.472,84,144,77,197,.391,52,72,.722,38,100,138,55,27,17,45,101,451
4906,Ronald Timus,SR,2006-07,F,Morgan State,MEAC,31,1078,163,324,.503,161,318,2,6,.333,123,201,.612,75,85,160,44,28,4,71,57,451
4907,Alex Tyus,SO,2008-09,F,Florida,SEC,36,944,195,330,.591,195,330,0,0,,61,89,.685,76,146,222,24,17,28,42,65,451
4908,Ayinde Ubaka,JR,2005-06,G,University of California,Pac-10,31,1156,140,339,.413,79,175,61,164,.372,110,132,.833,7,86,93,119,22,0,71,54,451
4909,Aaron Valdes,SO,2014-15,G,Hawaii,Big West,33,934,161,338,.476,130,252,31,86,.360,98,148,.662,62,114,176,40,56,12,56,78,451
4910,Jamel Waters,SO,2013-14,G,Alabama State,SWAC,32,1114,146,377,.387,117,277,29,100,.290,130,170,.765,25,79,104,194,58,1,76,70,451
4911,RJ White,SR,2016-17,C,North Carolina-Greensboro,Southern,35,889,181,329,.550,165,278,16,51,.314,73,120,.608,74,159,233,43,30,39,70,114,451
4912,Brandon Young,SO,2011-12,G,DePaul,Big East,31,944,162,383,.423,126,255,36,128,.281,91,119,.765,17,65,82,147,49,3,75,41,451
4913,Scott Bamforth,JR,2011-12,G,Weber State,Big Sky,31,995,134,305,.439,57,113,77,192,.401,105,120,.875,17,95,112,74,28,0,57,66,450
4914,J.R. Blount,SR,2008-09,G,Loyola (IL),Horizon,32,1088,160,417,.384,149,359,11,58,.190,119,182,.654,43,94,137,104,39,1,92,77,450
4915,Alphonso Dawson,SO,2008-09,G,Delaware,CAA,32,1043,171,442,.387,121,265,50,177,.282,58,80,.725,60,109,169,34,27,19,54,82,450
4916,Bryant Dunston,SR,2007-08,F,Fordham,A-10,29,961,165,314,.525,160,285,5,29,.172,115,176,.653,90,194,284,57,29,79,55,67,450
4917,Tyreek Duren,SO,2011-12,G,La Salle,A-10,34,1191,155,327,.474,117,230,38,97,.392,102,126,.810,17,97,114,135,58,6,82,59,450
4918,Kyndall Dykes,SR,2008-09,F,New Orleans,Sun Belt,26,921,174,357,.487,172,341,2,16,.125,100,149,.671,29,103,132,43,37,6,64,45,450
4919,Marcus Evans,JR,2018-19,G,Virginia Commonwealth,A-10,33,886,138,323,.427,97,173,41,150,.273,133,172,.773,15,88,103,105,65,5,90,79,450
4920,Javorn Farrell,SR,2013-14,G,Texas-Rio Grande Valley,WAC,28,941,154,379,.406,127,270,27,109,.248,115,155,.742,37,114,151,92,46,16,77,88,450
4921,John Gillon,JR,2015-16,G,Colorado State,MWC,34,1079,119,311,.383,59,131,60,180,.333,152,173,.879,14,83,97,131,26,5,77,84,450
4922,Malcolm Hawkins,SR,2013-14,G,Norfolk State,MEAC,29,874,135,322,.419,76,180,59,142,.415,121,155,.781,24,100,124,55,23,10,83,80,450
4923,Jordan Hill,SO,2007-08,F,Arizona,Pac-10,34,1001,184,297,.620,184,297,0,0,,82,120,.683,84,186,270,27,17,56,72,105,450
4926,Scotty Hopson,SO,2009-10,G,Tennessee,SEC,37,1024,174,391,.445,122,235,52,156,.333,50,85,.588,34,90,124,44,36,7,78,55,450
4927,Jordan Johnson,SR,2017-18,G,Nevada-Las Vegas,MWC,33,1132,124,290,.428,75,164,49,126,.389,153,182,.841,15,78,93,199,39,8,90,76,450
4928,Shaquille Johnson,JR,2014-15,G,Longwood,Big South,33,1065,166,419,.396,135,292,31,127,.244,87,115,.757,61,124,185,94,49,18,114,92,450
4929,Riley LaChance,SR,2017-18,G,Vanderbilt,SEC,32,1015,156,341,.457,75,147,81,194,.418,57,73,.781,12,90,102,103,15,0,40,64,450
4930,Vic Law,SR,2018-19,F,Northwestern,Big Ten,30,1002,151,381,.396,95,214,56,167,.335,92,117,.786,31,160,191,90,31,29,66,87,450
4931,Nick Mayo,FR,2015-16,F,Eastern Kentucky,OVC,31,923,179,295,.607,164,268,15,27,.556,77,96,.802,48,105,153,34,20,34,63,71,450
4932,Mike Moser,SR,2013-14,F,Oregon,Pac-12,34,964,169,368,.459,113,220,56,148,.378,56,73,.767,63,200,263,55,39,25,60,87,450
4933,Keiton Page,JR,2010-11,G,Oklahoma State,Big 12,34,1160,128,342,.374,69,148,59,194,.304,135,151,.894,7,63,70,59,32,1,60,79,450
4934,Kevin Pangos,FR,2011-12,G,Gonzaga,WCC,33,1044,137,318,.431,58,121,79,197,.401,97,114,.851,8,81,89,111,40,2,60,56,450
4935,Michael Roll,SR,2009-10,G,UCLA,Pac-10,32,1144,167,357,.468,87,169,80,188,.426,36,47,.766,9,79,88,115,31,3,61,62,450
4936,Mike Rosario,SR,2012-13,G,Florida,SEC,36,1062,160,357,.448,99,191,61,166,.367,69,83,.831,27,65,92,72,34,1,63,41,450
4937,Ben Simons,SR,2012-13,F,Drake,MVC,32,1106,153,351,.436,75,156,78,195,.400,66,75,.880,4,112,116,58,29,8,59,68,450
4938,Jared Stohl,SR,2010-11,G,Portland,WCC,32,1042,138,319,.433,47,106,91,213,.427,83,93,.892,23,54,77,58,27,0,35,30,450
4939,Andrew Strait,JR,2006-07,F,Montana,Big Sky,30,956,196,321,.611,196,317,0,4,.000,58,111,.523,66,126,192,29,16,35,34,60,450
4940,Ryan Taylor,SO,2014-15,F,Marshall,CUSA,32,920,152,359,.423,124,257,28,102,.275,118,169,.698,60,215,275,90,28,25,88,100,450
4941,Bilal Abdullah,SR,2007-08,G,Lafayette,Patriot,30,937,137,288,.476,76,152,61,136,.449,114,153,.745,49,108,157,74,25,16,90,80,449
4942,Josh Adams,JR,2014-15,G,Wyoming,MWC,35,1176,146,334,.437,99,189,47,145,.324,110,148,.743,21,93,114,126,48,8,90,74,449
4943,Trevon Allen,JR,2018-19,G,Idaho,Big Sky,32,968,173,407,.425,128,269,45,138,.326,58,79,.734,11,122,133,98,22,4,63,51,449
4944,Remi Barry,SR,2014-15,F,New Mexico State,WAC,34,1095,154,337,.457,111,239,43,98,.439,98,128,.766,46,115,161,35,19,6,61,62,449
4945,Ledarrius Brewer,FR,2017-18,G,Southeast Missouri State,OVC,31,912,152,362,.420,81,166,71,196,.362,74,100,.740,14,104,118,40,29,16,57,66,449
4948,Aaron Broussard,JR,2010-11,F,Seattle,Ind,31,956,167,352,.474,146,285,21,67,.313,94,135,.696,81,158,239,39,48,6,73,74,449
4949,Dejuan Clayton,SO,2018-19,G,Coppin State,MEAC,31,1066,142,356,.399,111,227,31,129,.240,134,179,.749,9,81,90,119,28,2,87,59,449
4950,Phil Cofer,SR,2017-18,F,Florida State,ACC,35,1026,168,346,.486,120,218,48,128,.375,65,94,.691,56,122,178,26,19,8,42,49,449
4951,Keaton Cole,SR,2011-12,G,Western Carolina,Southern,35,1055,143,335,.427,27,61,116,274,.423,47,67,.701,16,39,55,52,46,0,52,60,449
4952,Seth Curry,JR,2011-12,G,Duke,ACC,34,1026,141,336,.420,77,169,64,167,.383,103,118,.873,26,63,89,83,43,7,69,73,449
4953,Evan Fjeld,SR,2010-11,F,Vermont,AEC,31,926,184,339,.543,182,330,2,9,.222,79,120,.658,62,133,195,38,15,58,67,71,449
4954,Kareem Grant,SR,2005-06,F,Tennessee State,OVC,28,946,172,337,.510,115,190,57,147,.388,48,57,.842,34,80,114,35,28,5,39,74,449
4955,Rob Hampton,SR,2010-11,G,Norfolk State,MEAC,32,990,152,350,.434,121,245,31,105,.295,114,174,.655,40,78,118,60,36,5,105,96,449
4956,Robbie Harman,SR,2009-10,G,Central Michigan,MAC,30,1014,148,350,.423,43,105,105,245,.429,48,63,.762,11,56,67,91,56,5,60,80,449
4957,Jared Harper,SO,2017-18,G,Auburn,SEC,34,1038,111,308,.360,50,136,61,172,.355,166,202,.822,14,68,82,185,40,1,72,63,449
4958,Lazar Hayward,SO,2007-08,F,Marquette,Big East,35,889,158,333,.474,117,242,41,91,.451,92,119,.773,66,162,228,21,39,13,63,94,449
4959,Nathan Healy,SR,2012-13,F,Appalachian State,Southern,31,1085,168,347,.484,116,212,52,135,.385,61,76,.803,55,184,239,42,59,45,51,80,449
4960,Sam Hinnant,SR,2008-09,G,East Carolina,CUSA,30,1047,138,358,.385,53,123,85,235,.362,88,106,.830,22,87,109,58,17,2,46,49,449
4961,Dante Holmes,SR,2015-16,G,North Carolina Central,MEAC,29,975,151,374,.404,77,177,74,197,.376,73,106,.689,28,113,141,52,29,2,60,98,449
4962,Markel Humphrey,SO,2006-07,F,Marshall,CUSA,32,1093,157,361,.435,119,239,38,122,.311,97,134,.724,79,130,209,45,25,12,56,64,449
4963,DeWayne Jackson,SO,2010-11,F,Morgan State,MEAC,31,993,153,378,.405,106,198,47,180,.261,96,130,.738,35,108,143,44,44,22,73,85,449
4964,Jalen Jones,SO,2012-13,G,Southern Methodist,CUSA,32,1036,165,326,.506,157,303,8,23,.348,111,152,.730,107,140,247,32,39,23,71,111,449
4965,Daishon Knight,JR,2013-14,G,Illinois State,MVC,34,967,142,387,.367,94,223,48,164,.293,117,150,.780,18,139,157,74,42,4,77,52,449
4966,Scott Machado,SR,2011-12,G,Iona,MAAC,33,1171,155,313,.495,115,214,40,99,.404,99,122,.811,30,133,163,327,53,7,108,86,449
4967,Anthony Morrow,SO,2005-06,G,Georgia Tech,ACC,28,901,154,348,.443,76,166,78,182,.429,63,71,.887,51,76,127,46,30,5,64,72,449
4968,Mamadou Ndiaye,JR,2015-16,C,UC-Irvine,Big West,37,857,169,251,.673,169,251,0,0,,111,176,.631,74,193,267,24,6,87,83,92,449
4969,Devon Peltier,SR,2010-11,G,Cal State Fullerton,Big West,31,986,144,316,.456,72,139,72,177,.407,89,99,.899,16,37,53,31,20,1,56,73,449
4970,Devonta Pollard,SR,2015-16,F,Houston,AAC,32,951,156,326,.479,155,324,1,2,.500,136,182,.747,59,122,181,51,29,20,50,76,449
4971,Jared Sam,JR,2016-17,F,Southern,SWAC,33,1077,145,246,.589,145,245,0,1,.000,159,208,.764,82,163,245,34,28,23,62,88,449
4972,Brenton Scott,SR,2017-18,G,Indiana State,MVC,31,1018,156,390,.400,94,206,62,184,.337,75,105,.714,14,163,177,73,53,6,78,78,449
4973,Russ Smith,SO,2011-12,G,Louisville,Big East,39,837,149,419,.356,108,285,41,134,.306,110,144,.764,27,71,98,76,87,1,90,110,449
4974,Alexander Starr,SR,2006-07,F,Centenary (LA),Mid-Cont,31,1013,159,302,.526,140,259,19,43,.442,112,135,.830,,,182,92,43,13,,,449
4975,Lance Tejada,SR,2018-19,G,Lehigh,Patriot,31,937,150,360,.417,65,156,85,204,.417,64,81,.790,11,64,75,101,26,1,69,91,449
4976,James Washington,SR,2010-11,G,Middle Tennessee,Sun Belt,32,1121,122,302,.404,50,120,72,182,.396,133,154,.864,10,62,72,91,52,1,74,75,449
4977,Alan Williams,SR,2014-15,C,UC-Santa Barbara,Big West,26,847,160,349,.458,160,346,0,3,.000,129,168,.768,86,222,308,45,31,47,51,70,449
4978,Brandon Worthy,JR,2005-06,G,Loyola Marymount,WCC,30,998,131,323,.406,106,254,25,69,.362,162,197,.822,37,69,106,130,53,8,82,91,449
4979,Chaisson Allen,JR,2009-10,G,Northeastern,CAA,33,1167,151,343,.440,82,169,69,174,.397,77,104,.740,35,121,156,118,51,1,75,53,448
4980,James Augustine,SR,2005-06,F,Illinois,Big Ten,33,1079,174,279,.624,173,277,1,2,.500,99,152,.651,100,200,300,59,47,24,67,84,448
4981,Lamonte Bearden,JR,2017-18,G,Western Kentucky,CUSA,38,1053,151,317,.476,132,256,19,61,.311,127,154,.825,21,67,88,131,65,6,92,82,448
4982,Jordan Bitzer,SR,2009-10,G,Central Michigan,MAC,30,1015,143,353,.405,71,174,72,179,.402,90,105,.857,16,134,150,66,45,13,57,76,448
4983,Ronnie Boyce,SR,2016-17,G,San Francisco,WCC,33,624,168,371,.453,128,231,40,140,.286,72,99,.727,28,105,133,47,28,8,68,37,448
4984,Zack Bryant,FR,2017-18,G,Alabama-Birmingham,CUSA,33,1056,162,355,.456,132,261,30,94,.319,94,125,.752,14,91,105,101,37,7,73,85,448
4985,Bruce Carter,SR,2007-08,F,Murray State,OVC,31,854,161,331,.486,117,217,44,114,.386,82,100,.820,48,125,173,60,32,7,55,93,448
4986,Derrick Favors,FR,2009-10,F,Georgia Tech,ACC,36,989,179,293,.611,179,292,0,1,.000,90,143,.629,108,195,303,37,32,74,90,94,448
4987,Chase Fischer,JR,2014-15,G,Brigham Young,WCC,34,914,147,351,.419,44,103,103,248,.415,51,65,.785,10,64,74,67,25,2,49,50,448
4990,Greg Gantt,SO,2010-11,G,Florida Atlantic,Sun Belt,32,967,166,362,.459,108,180,58,182,.319,58,83,.699,27,97,124,29,23,0,38,54,448
4991,Nick Garth,JR,2017-18,G,Lamar,Southland,33,885,143,346,.413,64,137,79,209,.378,83,99,.838,16,61,77,54,20,0,42,52,448
4992,Louis Graham,JR,2006-07,F,Georgia Southern,Southern,31,818,185,351,.527,183,337,2,14,.143,76,118,.644,70,185,255,17,29,46,80,91,448
4993,Kevyn Green,SR,2007-08,G,Southeastern Louisiana,Southland,29,907,145,352,.412,65,151,80,201,.398,78,107,.729,28,104,132,29,18,9,66,58,448
4994,Justin Greene,SR,2011-12,F,Kent State,MAC,32,975,162,328,.494,162,328,0,0,,124,171,.725,68,149,217,47,37,27,101,85,448
4995,Noah Horchler,JR,2018-19,F,North Florida,A-Sun,28,874,192,357,.538,171,286,21,71,.296,43,84,.512,69,192,261,36,26,48,58,74,448
4996,Mike Hughes,SO,2015-16,G,Georgia Southern,Sun Belt,30,907,141,326,.433,74,152,67,174,.385,99,136,.728,26,116,142,48,63,10,62,77,448
4997,Yassin Idbihi,JR,2005-06,F,Buffalo,MAC,32,924,156,333,.468,132,266,24,67,.358,112,144,.778,92,128,220,52,20,24,92,90,448
4998,Clarence Jackson,JR,2009-10,G,Siena,MAAC,33,882,154,360,.428,83,161,71,199,.357,69,95,.726,15,67,82,27,58,12,45,63,448
4999,Stanton Kidd,JR,2012-13,F,North Carolina Central,MEAC,31,997,173,313,.553,154,262,19,51,.373,83,119,.697,75,139,214,31,32,18,64,85,448
5000,Tyler Lydon,SO,2016-17,F,Syracuse,ACC,34,1227,151,319,.473,102,195,49,124,.395,97,116,.836,79,215,294,70,35,49,59,84,448
5001,Jordan Mathews,SO,2014-15,G,University of California,Pac-12,33,1027,143,321,.445,73,163,70,158,.443,92,117,.786,18,95,113,46,20,1,50,64,448
5002,Tywain McKee,FR,2005-06,G,Coppin State,MEAC,29,915,154,365,.422,107,237,47,128,.367,93,122,.762,41,82,123,71,46,3,88,58,448
5003,Alex McLean,JR,2006-07,F,Liberty,Big South,31,997,185,340,.544,183,334,2,6,.333,76,122,.623,94,181,275,31,14,20,72,62,448
5004,Mike Morsell,SR,2017-18,G,Towson,CAA,32,899,162,369,.439,111,222,51,147,.347,73,101,.723,46,88,134,30,33,14,56,94,448
5005,Jeffery Moss,SO,2013-14,F,Murray State,OVC,34,1170,147,337,.436,89,184,58,153,.379,96,120,.800,24,90,114,72,15,10,42,72,448
5006,Jake Odum,JR,2012-13,G,Indiana State,MVC,33,1068,127,267,.476,108,216,19,51,.373,175,227,.771,24,123,147,151,48,10,90,74,448
5007,A.J. Ogilvy,SO,2008-09,C,Vanderbilt,SEC,29,799,152,280,.543,145,253,7,27,.259,137,196,.699,51,156,207,37,25,48,80,78,448
5008,Brett Olson,JR,2013-14,G,Denver,Summit,31,1141,144,302,.477,76,147,68,155,.439,92,102,.902,8,96,104,108,34,3,61,87,448
5009,Colbey Ross,FR,2017-18,G,Pepperdine,WCC,32,1017,151,325,.465,110,229,41,96,.427,105,128,.820,11,84,95,179,33,5,88,77,448
5012,Vincent Simpson,SR,2009-10,G,Hampton,MEAC,32,931,155,384,.404,94,184,61,200,.305,77,105,.733,14,53,67,84,52,1,99,63,448
5013,Brian Stafford,SR,2011-12,G,Denver,Sun Belt,31,1035,146,293,.498,71,129,75,164,.457,81,99,.818,14,41,55,65,35,5,40,65,448
5014,Jordan Sugars,JR,2010-11,G,Navy,Patriot,28,954,154,381,.404,86,178,68,203,.335,72,99,.727,38,130,168,35,38,2,68,53,448
5015,Jason Thompson,SO,2005-06,C,Rider,MAAC,27,858,159,291,.546,152,270,7,21,.333,123,175,.703,78,148,226,43,24,48,80,86,448
5016,B.J. Tyson,SR,2017-18,G,East Carolina,AAC,30,1093,162,394,.411,120,250,42,144,.292,82,99,.828,25,105,130,81,24,7,58,60,448
5017,Chris Udofia,SO,2011-12,F,Denver,Sun Belt,31,928,165,309,.534,144,237,21,72,.292,97,134,.724,51,110,161,82,22,72,74,97,448
5018,Cody Wichmann,SR,2016-17,G,Milwaukee,Horizon,35,1149,149,367,.406,52,101,97,266,.365,53,67,.791,13,124,137,54,28,2,34,80,448
5019,Musa Abdul-Aleem,SR,2014-15,G,Troy,Sun Belt,28,811,151,341,.443,81,152,70,189,.370,75,95,.789,25,109,134,20,33,1,53,60,447
5020,Bryon Allen,SR,2013-14,G,George Mason,A-10,29,985,156,346,.451,113,236,43,110,.391,92,110,.836,28,86,114,87,28,1,61,68,447
5021,Maurice Barrow,SR,2013-14,F,Fairfield,MAAC,32,943,149,342,.436,109,219,40,123,.325,109,147,.741,53,106,159,39,28,24,60,91,447
5022,Earl Brown,JR,2013-14,F,Saint Francis (PA),NEC,31,1032,181,341,.531,178,331,3,10,.300,82,141,.582,82,166,248,49,22,34,80,74,447
5023,Jamaya Burr,JR,2015-16,G,McNeese State,Southland,29,1048,127,309,.411,93,216,34,93,.366,159,207,.768,23,85,108,104,44,1,98,64,447
5024,Nico Clareth,FR,2015-16,G,Siena,MAAC,34,905,174,379,.459,119,207,55,172,.320,44,74,.595,33,76,109,75,54,20,77,86,447
5025,Javier Duren,SR,2014-15,G,Yale,Ivy,32,1004,132,328,.402,80,185,52,143,.364,131,167,.784,26,150,176,126,41,9,87,80,447
5026,Nick Emery,SO,2016-17,G,Brigham Young,WCC,34,1024,152,366,.415,77,164,75,202,.371,68,82,.829,4,99,103,82,55,9,69,100,447
5027,George Fant,SO,2012-13,F,Western Kentucky,Sun Belt,35,1016,163,338,.482,163,338,0,0,,121,200,.605,90,142,232,24,26,39,95,108,447
5028,Eric Ferguson,JR,2012-13,F,Georgia Southern,Southern,33,976,160,335,.478,139,271,21,64,.328,106,158,.671,56,147,203,33,51,26,80,98,447
5029,Chase Fieler,JR,2012-13,F,Florida Gulf Coast,A-Sun,37,1031,169,300,.563,135,211,34,89,.382,75,102,.735,80,121,201,58,39,49,62,104,447
5030,Danny Green,JR,2007-08,F,North Carolina,ACC,39,869,161,343,.469,105,193,56,150,.373,69,79,.873,67,126,193,77,48,46,74,91,447
5031,Marcus Hall,SR,2007-08,G,Colorado,Big 12,32,1202,171,359,.476,118,220,53,139,.381,52,77,.675,29,95,124,128,58,7,71,61,447
5034,Kason Harrell,JR,2017-18,G,Purdue-Fort Wayne,Summit,33,1015,160,365,.438,71,123,89,242,.368,38,46,.826,21,75,96,44,37,17,61,74,447
5035,Shaquille Harrison,JR,2014-15,G,Tulsa,AAC,34,1069,163,363,.449,150,308,13,55,.236,108,171,.632,40,133,173,125,67,20,81,83,447
5036,Calvin Hermanson,JR,2016-17,F,Saint Mary's (CA),WCC,34,971,155,314,.494,67,110,88,204,.431,49,60,.817,23,78,101,31,16,6,33,79,447
5037,Jerome Hill,SO,2013-14,F,Gardner-Webb,Big South,31,909,154,314,.490,154,312,0,2,.000,139,215,.647,102,162,264,40,25,14,62,76,447
5038,Anthony Humpty Hitchens,SR,2011-12,G,James Madison,CAA,30,1095,158,374,.422,76,163,82,211,.389,49,75,.653,10,58,68,111,39,1,89,86,447
5039,Caleb Homesley,JR,2018-19,G,Liberty,A-Sun,36,1002,179,388,.461,123,208,56,180,.311,33,47,.702,18,182,200,96,26,22,50,68,447
5040,Darryl Hudson,SR,2006-07,F,Howard,MEAC,31,985,142,274,.518,113,209,29,65,.446,134,197,.680,59,119,178,56,28,6,83,63,447
5041,Sam Hunt,SO,2015-16,G,North Carolina A&T,MEAC,29,967,134,345,.388,68,150,66,195,.338,113,125,.904,8,51,59,61,20,1,69,82,447
5042,Darnell Jackson,SR,2007-08,F,Kansas,Big 12,40,971,171,273,.626,169,267,2,6,.333,103,149,.691,81,186,267,43,31,19,51,90,447
5043,Melvin Johnson,JR,2014-15,G,Virginia Commonwealth,A-10,36,1003,155,385,.403,69,148,86,237,.363,51,65,.785,17,53,70,65,37,3,36,56,447
5044,Gordon Klaiber,SR,2005-06,F,Fairleigh Dickinson,NEC,30,970,148,366,.404,99,223,49,143,.343,102,156,.654,48,126,174,53,48,41,59,81,447
5045,Anthony Lamb,FR,2016-17,F,Vermont,AEC,35,787,171,334,.512,145,271,26,63,.413,79,106,.745,68,124,192,24,27,43,70,98,447
5046,Stephane Lasme,SR,2006-07,F,Massachusetts,A-10,33,1010,165,270,.611,165,270,0,0,,117,188,.622,126,189,315,28,29,168,79,111,447
5047,Kenny Lawson,JR,2009-10,C,Creighton,MVC,34,821,163,303,.538,155,290,8,13,.615,113,138,.819,63,167,230,22,14,50,46,65,447
5048,Lonnie McClanahan,JR,2013-14,G,Texas-Arlington,Sun Belt,32,856,149,335,.445,148,330,1,5,.200,148,200,.740,36,95,131,113,29,1,105,86,447
5049,Jason McManamen,JR,2015-16,G,Wyoming,MWC,31,1086,136,296,.459,44,87,92,209,.440,83,110,.755,10,83,93,48,13,3,40,88,447
5050,Harouna Mutombo,FR,2008-09,G,Western Carolina,Southern,31,944,167,359,.465,138,266,29,93,.312,84,135,.622,55,87,142,68,56,16,66,74,447
5051,Anthony Nelson,SR,2010-11,G,Niagara,MAAC,29,1081,127,347,.366,89,201,38,146,.260,155,221,.701,48,96,144,147,98,2,105,57,447
5052,Sa'eed Nelson,FR,2016-17,G,American,Patriot,30,1136,164,372,.441,145,285,19,87,.218,100,178,.562,20,113,133,82,72,4,86,82,447
5053,Obie Nwadike,SR,2006-07,F,Central Connecticut State,NEC,31,1061,128,270,.474,128,269,0,1,.000,191,251,.761,136,195,331,43,33,1,80,99,447
5056,Dererk Pardon,SR,2018-19,C,Northwestern,Big Ten,32,1047,173,303,.571,167,275,6,28,.214,95,139,.683,96,152,248,58,27,30,45,85,447
5057,Jordan Reed,SO,2013-14,G,Binghamton,AEC,29,961,134,324,.414,120,285,14,39,.359,165,231,.714,72,186,258,36,45,23,78,87,447
5058,Clarke Rosenberg,JR,2013-14,G,Chicago State,WAC,32,989,154,340,.453,129,266,25,74,.338,114,152,.750,39,82,121,83,46,7,74,84,447
5059,Nick Russell,JR,2012-13,G,Southern Methodist,CUSA,32,1159,178,436,.408,152,354,26,82,.317,65,89,.730,13,102,115,138,48,8,121,60,447
5060,Dante Scott,JR,2017-18,G,Mississippi Valley State,SWAC,30,948,162,386,.420,118,267,44,119,.370,79,102,.775,51,116,167,57,15,9,76,74,447
5061,Montrael Scott,SR,2014-15,G,Prairie View,SWAC,29,993,163,384,.424,110,217,53,167,.317,68,91,.747,28,96,124,51,41,1,65,61,447
5062,Tanoris Shepard,SR,2005-06,G,Idaho,WAC,29,1043,155,366,.423,107,224,48,142,.338,89,125,.712,16,95,111,106,41,4,88,53,447
5063,Chase Tapley,SR,2012-13,G,San Diego State,MWC,33,1016,162,378,.429,92,192,70,186,.376,53,66,.803,10,95,105,90,46,18,43,55,447
5064,Mark Tollefsen,JR,2014-15,F,San Francisco,WCC,32,1001,176,329,.535,134,218,42,111,.378,53,82,.646,56,118,174,48,27,27,35,58,447
5065,Erving Walker,SR,2011-12,G,Florida,SEC,37,1158,134,340,.394,65,150,69,190,.363,110,135,.815,18,88,106,170,37,0,76,56,447
5066,Bryce Washington,JR,2016-17,F,Louisiana,Sun Belt,33,1159,173,287,.603,173,281,0,6,.000,101,158,.639,132,237,369,70,41,25,65,65,447
5067,Hassan Whiteside,FR,2009-10,C,Marshall,CUSA,34,889,167,319,.524,164,314,3,5,.600,110,187,.588,92,211,303,10,19,182,64,82,447
5068,Scottie Wilbekin,SR,2013-14,G,Florida,SEC,34,1150,140,348,.402,73,176,67,172,.390,100,138,.725,6,77,83,123,56,0,58,59,447
5069,Eric Williams,SO,2018-19,G,Duquesne,A-10,32,987,151,356,.424,95,205,56,151,.371,89,119,.748,93,149,242,45,36,7,55,62,447
5070,Nic Wise,SR,2009-10,G,Arizona,Pac-10,31,1021,130,337,.386,80,198,50,139,.360,137,156,.878,7,95,102,103,54,2,73,72,447
5071,Scott Wood,JR,2011-12,F,North Carolina State,ACC,36,1183,132,310,.426,37,78,95,232,.409,88,97,.907,11,71,82,58,26,23,39,82,447
5072,Raheem Appleby,FR,2011-12,G,Louisiana Tech,WAC,32,892,173,368,.470,133,268,40,100,.400,60,84,.714,31,47,78,37,35,2,44,46,446
5073,Brent Benson,SR,2008-09,G,Texas State,Southland,29,745,138,309,.447,43,92,95,217,.438,75,109,.688,17,63,80,43,20,4,48,86,446
5074,Darrell Brown,SO,2017-18,G,Bradley,MVC,33,1051,141,400,.353,92,262,49,138,.355,115,143,.804,7,70,77,142,25,0,95,69,446
5075,Devin Brown,JR,2010-11,G,Holy Cross,Patriot,29,852,141,339,.416,81,172,60,167,.359,104,129,.806,7,55,62,42,17,1,58,60,446
5076,Jomaru Brown,FR,2018-19,G,Eastern Kentucky,OVC,31,770,158,360,.439,120,245,38,115,.330,92,136,.676,20,73,93,67,60,2,85,95,446
5077,Brian Butch,SR,2007-08,F,Wisconsin,Big Ten,36,885,162,355,.456,137,274,25,81,.309,97,150,.647,77,160,237,29,20,29,51,69,446
5078,Folarin Campbell,JR,2006-07,G,George Mason,CAA,32,1045,139,370,.376,88,204,51,166,.307,117,162,.722,24,102,126,122,41,10,97,85,446
5079,Colin Chiverton,JR,2011-12,F,Eastern Washington,Big Sky,32,706,147,401,.367,59,184,88,217,.406,64,81,.790,17,50,67,17,24,13,32,73,446
5080,Dylon Cormier,SR,2013-14,G,Loyola (MD),Patriot,21,727,150,325,.462,130,255,20,70,.286,126,191,.660,63,59,122,38,46,9,42,52,446
5081,Jaye Crockett,SR,2013-14,F,Texas Tech,Big 12,32,941,170,329,.517,150,266,20,63,.317,86,104,.827,68,138,206,38,32,12,58,74,446
5082,Paul Crosby,SR,2011-12,C,Mississippi Valley State,SWAC,34,1116,153,389,.393,117,266,36,123,.293,104,144,.722,89,161,250,56,53,28,85,106,446
5083,Richard Delk,JR,2008-09,G,Troy,Sun Belt,32,1031,179,368,.486,133,237,46,131,.351,42,79,.532,42,112,154,79,35,12,70,77,446
5084,David DiLeo,SO,2017-18,F,Central Michigan,MAC,36,1210,140,359,.390,44,84,96,275,.349,70,87,.805,67,172,239,50,34,9,27,64,446
5085,Ousmane Drame,SR,2014-15,F,Quinnipiac,MAAC,30,873,158,347,.455,157,344,1,3,.333,129,160,.806,108,227,335,31,21,88,69,89,446
5086,Frankie Ferrari,JR,2017-18,G,San Francisco,WCC,39,1119,157,382,.411,87,202,70,180,.389,62,78,.795,8,89,97,179,38,0,69,72,446
5087,Shep Garner,SR,2017-18,G,Penn State,Big Ten,39,1279,146,329,.444,26,52,120,277,.433,34,41,.829,8,72,80,52,35,4,47,83,446
5088,Chris Gaston,SO,2010-11,F,Fordham,A-10,28,950,178,381,.467,178,379,0,2,.000,90,174,.517,96,220,316,38,26,41,97,81,446
5089,Chris Gradnigo,SR,2011-12,F,Coastal Carolina,Big South,30,836,172,377,.456,133,264,39,113,.345,63,79,.797,44,143,187,31,19,25,68,78,446
5090,Josh Hawkinson,JR,2015-16,F,Washington State,Pac-12,29,967,170,313,.543,155,274,15,39,.385,91,117,.778,45,276,321,44,20,31,59,60,446
5091,ShanQuan Hemphill,JR,2018-19,F,Green Bay,Horizon,38,1061,188,356,.528,188,354,0,2,.000,70,147,.476,64,148,212,58,40,20,72,74,446
5092,Victor Joseph,SR,2017-18,G,Cal Poly,Big West,31,913,147,365,.403,83,188,64,177,.362,88,100,.880,18,61,79,59,26,5,59,64,446
5093,DaVonte Lacy,JR,2013-14,G,Washington State,Pac-12,23,787,132,308,.429,56,113,76,195,.390,106,127,.835,22,75,97,33,28,3,47,57,446
5094,Andrew Lawrence,SR,2012-13,G,College of Charleston,Southern,33,1075,131,328,.399,72,159,59,169,.349,125,163,.767,11,89,100,122,44,9,86,58,446
5095,David Lighty,SR,2010-11,G,Ohio State,Big Ten,37,1186,153,327,.468,102,208,51,119,.429,89,142,.627,49,99,148,122,55,17,58,72,446
5098,Geno Luzcando,SO,2015-16,G,Idaho State,Big Sky,31,950,151,300,.503,114,197,37,103,.359,107,150,.713,31,95,126,41,61,3,84,91,446
5099,Ray McCallum,FR,2010-11,G,Detroit Mercy,Horizon,33,1098,140,318,.440,115,238,25,80,.313,141,204,.691,46,110,156,161,54,5,85,70,446
5100,Quinn McDowell,SO,2009-10,G,William & Mary,CAA,32,1065,145,294,.493,87,158,58,136,.426,98,122,.803,38,101,139,41,19,3,38,75,446
5101,Amadi McKenzie,JR,2006-07,F,Tennessee Tech,OVC,32,875,163,268,.608,162,260,1,8,.125,119,185,.643,101,147,248,33,38,17,60,100,446
5102,Marshun Newell,SR,2014-15,G,Tennessee-Martin,OVC,34,1199,146,354,.412,77,184,69,170,.406,85,112,.759,52,182,234,91,35,3,75,59,446
5103,Jake Odum,SR,2013-14,G,Indiana State,MVC,34,1096,124,291,.426,102,221,22,70,.314,176,229,.769,20,123,143,155,35,5,63,66,446
5104,Kruize Pinkins,SR,2014-15,F,San Francisco,WCC,32,837,154,316,.487,122,234,32,82,.390,106,163,.650,70,106,176,44,22,13,57,99,446
5105,Chase Plummer,SO,2011-12,F,Maryland-Baltimore County,AEC,29,821,155,374,.414,138,321,17,53,.321,119,180,.661,70,144,214,40,40,9,114,84,446
5106,Tajuan Porter,SO,2007-08,G,Oregon,Pac-10,32,1036,152,393,.387,69,160,83,233,.356,59,75,.787,16,59,75,78,15,4,75,73,446
5107,Zaynah Robinson,JR,2016-17,G,Norfolk State,MEAC,33,1176,148,390,.379,89,211,59,179,.330,91,117,.778,12,101,113,148,53,4,55,69,446
5108,Evan Roquemore,FR,2010-11,G,Santa Clara,WCC,38,1193,115,311,.370,58,167,57,144,.396,159,193,.824,23,114,137,139,36,12,88,89,446
5109,Edward Stephens,SO,2015-16,G,South Carolina State,MEAC,34,1033,149,341,.437,59,118,90,223,.404,58,69,.841,12,70,82,56,24,1,33,60,446
5110,Christian Terrell,SO,2015-16,G,Florida Gulf Coast,A-Sun,35,1021,159,357,.445,112,226,47,131,.359,81,113,.717,38,139,177,82,42,13,46,67,446
5111,Tre'Shawn Thurman,SO,2015-16,F,Omaha,Summit,32,878,172,321,.536,159,274,13,47,.277,89,138,.645,62,151,213,43,25,35,52,93,446
5112,Ryan Tillema,SR,2008-09,G,Green Bay,Horizon,26,701,138,297,.465,64,134,74,163,.454,96,126,.762,25,92,117,38,20,12,34,67,446
5113,Julian Washburn,JR,2013-14,F,Texas-El Paso,CUSA,34,1170,162,380,.426,114,248,48,132,.364,74,94,.787,20,100,120,85,33,13,49,51,446
5114,Kobe Webster,FR,2017-18,G,Western Illinois,Summit,28,935,165,383,.431,106,222,59,161,.366,57,73,.781,10,106,116,97,20,3,63,44,446
5115,Will Whittington,JR,2005-06,G,Marist,MAAC,29,947,134,326,.411,31,72,103,254,.406,75,95,.789,12,67,79,45,18,4,41,50,446
5116,Ryan Willen,SR,2011-12,F,Lafayette,Patriot,31,889,129,291,.443,99,207,30,84,.357,158,193,.819,57,108,165,55,30,8,63,82,446
5117,Shizz Alston,SO,2016-17,G,Temple,AAC,32,1164,156,382,.408,89,188,67,194,.345,66,76,.868,20,96,116,131,53,12,48,80,445
5120,Jordan Bohannon,SO,2017-18,G,Iowa,Big Ten,33,1050,137,324,.423,41,101,96,223,.430,75,83,.904,4,70,74,178,22,0,68,59,445
5121,Pat Calathes,JR,2006-07,G,Saint Joseph's,A-10,32,1021,144,316,.456,97,204,47,112,.420,110,130,.846,63,165,228,116,17,28,96,73,445
5122,David Carson,SR,2008-09,G,Purdue-Fort Wayne,Summit,30,955,151,366,.413,129,293,22,73,.301,121,155,.781,44,122,166,55,13,7,72,93,445
5123,Markeith Cummings,SR,2012-13,F,Kennesaw State,A-Sun,27,890,159,350,.454,137,278,22,72,.306,105,148,.709,47,71,118,39,27,4,69,87,445
5124,JamesOn Curry,SO,2005-06,G,Oklahoma State,Big 12,33,1124,159,400,.398,95,230,64,170,.376,63,90,.700,13,80,93,132,38,6,110,68,445
5125,Damyean Dotson,JR,2015-16,G,Houston,AAC,32,991,164,324,.506,102,155,62,169,.367,55,66,.833,62,155,217,40,22,6,33,61,445
5126,Wayne Ellington,FR,2006-07,G,North Carolina,ACC,38,909,164,379,.433,98,201,66,178,.371,51,61,.836,28,81,109,79,29,1,47,49,445
5127,Frank Gaines,SO,2010-11,G,Purdue-Fort Wayne,Summit,30,822,151,306,.493,123,220,28,86,.326,115,151,.762,42,143,185,25,28,20,43,85,445
5128,Marcus Gilbert,SO,2013-14,F,Fairfield,MAAC,32,1042,143,353,.405,70,154,73,199,.367,86,112,.768,28,136,164,50,20,14,91,92,445
5129,Ruben Guerrero,SR,2018-19,C,Samford,Southern,33,988,187,306,.611,187,306,0,0,,71,109,.651,108,169,277,20,19,69,67,95,445
5130,Blake Hamilton,JR,2015-16,G,Buffalo,MAC,34,901,152,334,.455,99,194,53,140,.379,88,119,.739,45,195,240,85,47,12,97,96,445
5131,Tyrone Hanson,SR,2010-11,G,Jackson State,SWAC,32,962,151,354,.427,69,147,82,207,.396,61,85,.718,24,102,126,70,27,15,75,61,445
5132,Paul Harris,JR,2008-09,F,Syracuse,Big East,37,1130,154,312,.494,144,268,10,44,.227,127,168,.756,89,209,298,80,38,26,78,71,445
5133,Brady Heslip,SR,2013-14,G,Baylor,Big 12,38,1042,133,295,.451,15,41,118,254,.465,61,76,.803,11,37,48,33,20,0,14,45,445
5134,Quinton Hosley,SR,2006-07,G,Fresno State,WAC,32,1064,140,335,.418,102,217,38,118,.322,127,189,.672,84,200,284,47,42,19,86,89,445
5135,Richard Howell,SR,2012-13,F,North Carolina State,ACC,35,1105,183,321,.570,183,321,0,0,,79,122,.648,131,249,380,60,36,32,57,105,445
5136,Terone Johnson,JR,2012-13,G,Purdue,Big Ten,33,1060,171,425,.402,134,318,37,107,.346,66,106,.623,42,112,154,95,17,6,66,68,445
5137,Perry Jones,SO,2011-12,F,Baylor,Big 12,33,1013,182,364,.500,172,331,10,33,.303,71,102,.696,89,163,252,42,28,20,56,77,445
5138,Tony Lee,JR,2006-07,G,Robert Morris,NEC,28,947,169,285,.593,150,224,19,61,.311,88,130,.677,66,104,170,123,77,6,96,69,445
5139,Dakota Mathias,SR,2017-18,G,Purdue,Big Ten,37,1161,151,320,.472,55,114,96,206,.466,47,57,.825,5,145,150,146,46,9,54,64,445
5142,Geoff McCammon,SR,2010-11,G,Loyola (IL),Horizon,31,964,147,358,.411,62,154,85,204,.417,66,79,.835,13,81,94,32,27,6,59,55,445
5143,Byron Mulkey,SR,2010-11,G,Buffalo,MAC,34,1192,146,350,.417,93,210,53,140,.379,100,128,.781,8,123,131,154,85,1,83,74,445
5144,Robert Olson,SR,2012-13,G,Loyola (MD),MAAC,35,1141,159,413,.385,86,186,73,227,.322,54,74,.730,41,114,155,74,37,7,56,93,445
5145,Arinze Onuaku,JR,2007-08,C,Syracuse,Big East,35,1070,186,296,.628,186,296,0,0,,73,164,.445,114,170,284,26,36,47,67,108,445
5146,Pele Paelay,SR,2005-06,G,Coastal Carolina,Big South,30,971,153,343,.446,104,207,49,136,.360,90,121,.744,46,109,155,80,34,10,54,52,445
5147,Omar Prewitt,SO,2014-15,G,William & Mary,CAA,33,1089,152,331,.459,102,184,50,147,.340,91,130,.700,16,128,144,84,40,27,63,77,445
5148,Joe Reitz,JR,2006-07,C,Western Michigan,MAC,32,906,150,268,.560,150,268,0,0,,145,219,.662,100,175,275,14,20,2,72,91,445
5149,Justin Rutty,SO,2008-09,F,Quinnipiac,NEC,30,968,194,321,.604,194,321,0,0,,57,136,.419,137,158,295,27,19,30,64,83,445
5150,Damian Saunders,SO,2008-09,F,Duquesne,A-10,34,1176,179,328,.546,142,220,37,108,.343,50,98,.510,84,174,258,77,71,83,68,103,445
5151,Myles Stephens,JR,2017-18,G,Princeton,Ivy,29,998,171,329,.520,131,232,40,97,.412,63,92,.685,40,142,182,41,13,26,64,61,445
5152,Barry Stewart,JR,2008-09,G,Mississippi State,SEC,36,1138,126,343,.367,54,146,72,197,.365,121,156,.776,28,107,135,66,46,10,66,84,445
5153,Andrew Warren,JR,2009-10,G,Bradley,MVC,31,1041,142,353,.402,81,199,61,154,.396,100,115,.870,28,111,139,47,26,3,63,65,445
5154,Corey Wilford,SR,2012-13,G,Southeast Missouri State,OVC,31,890,156,343,.455,74,150,82,193,.425,51,71,.718,27,85,112,69,24,8,55,66,445
5155,Thaddeus Young,FR,2006-07,F,Georgia Tech,ACC,31,917,177,370,.478,138,277,39,93,.419,52,70,.743,72,79,151,63,39,12,67,61,445
5156,Omer Yurtseven,SO,2017-18,C,North Carolina State,ACC,33,786,187,327,.572,165,283,22,44,.500,49,80,.613,91,131,222,15,16,60,38,99,445
5157,Josh Alexander,SR,2008-09,G,Stephen F. Austin,Southland,31,1051,142,363,.391,70,151,72,212,.340,88,113,.779,73,94,167,29,36,15,52,71,444
5158,Eric Atkins,SR,2013-14,G,Notre Dame,ACC,32,1211,159,375,.424,98,210,61,165,.370,65,96,.677,28,60,88,156,39,5,61,73,444
5159,Marquiz Baker,JR,2010-11,G,Alcorn State,SWAC,28,793,128,382,.335,71,219,57,163,.350,131,168,.780,29,65,94,31,45,0,65,56,444
5160,Tre Bowman,SR,2013-14,G,Iona,MAAC,32,1004,156,298,.523,88,128,68,170,.400,64,81,.790,28,115,143,40,31,6,24,44,444
5161,Kenny Boynton,SR,2012-13,G,Florida,SEC,37,1170,145,368,.394,74,147,71,221,.321,83,101,.822,19,91,110,102,31,3,48,31,444
5164,Keith Braxton,FR,2016-17,G,Saint Francis (PA),NEC,34,1136,164,308,.532,139,251,25,57,.439,91,119,.765,69,224,293,107,49,13,85,69,444
5165,Derrick Bruce,JR,2017-18,G,Texas Southern,SWAC,32,1057,143,363,.394,59,150,84,213,.394,74,90,.822,18,103,121,63,37,8,71,71,444
5166,Melvin Buckley,SR,2006-07,F,South Florida,Big East,30,1070,151,391,.386,72,163,79,228,.346,63,83,.759,32,114,146,31,20,9,73,65,444
5167,Noah Dickerson,SR,2018-19,F,Washington,Pac-12,36,931,145,261,.556,145,260,0,1,.000,154,224,.688,87,183,270,32,37,22,91,106,444
5168,Damiyne Durham,SO,2016-17,G,Cal State Bakersfield,WAC,35,742,163,423,.385,66,137,97,286,.339,21,33,.636,28,79,107,27,44,13,51,34,444
5169,Randal Falker,JR,2006-07,F,Southern Illinois,MVC,36,1062,162,272,.596,162,272,0,0,,120,221,.543,92,185,277,43,27,75,91,112,444
5170,Savion Flagg,SO,2018-19,G,Texas A&M,SEC,32,1112,171,366,.467,126,233,45,133,.338,57,86,.663,68,179,247,73,22,11,82,42,444
5171,Justin Forrest,FR,2017-18,G,Appalachian State,Sun Belt,33,924,147,399,.368,81,181,66,218,.303,84,126,.667,10,85,95,67,42,2,95,86,444
5172,Jarvis Garner,SR,2012-13,F,Central Arkansas,Southland,28,845,156,374,.417,103,219,53,155,.342,79,109,.725,39,158,197,36,31,12,68,67,444
5173,Christavious Gill,JR,2015-16,G,New Orleans,Southland,30,908,140,372,.376,76,187,64,185,.346,100,120,.833,26,48,74,83,57,3,51,55,444
5174,Jalen Hayes,SO,2015-16,F,Oakland,Horizon,34,1041,168,320,.525,165,311,3,9,.333,105,144,.729,74,218,292,26,32,17,50,100,444
5175,Tamir Jackson,SO,2010-11,G,Rice,CUSA,32,1064,143,338,.423,119,270,24,68,.353,134,183,.732,25,62,87,115,41,0,87,81,444
5176,Kedren Johnson,SO,2012-13,G,Vanderbilt,SEC,33,1047,145,355,.408,90,198,55,157,.350,99,137,.723,15,102,117,119,34,17,94,64,444
5177,Jalen Jones,JR,2015-16,G,Texas-Arlington,Sun Belt,35,877,155,337,.460,105,197,50,140,.357,84,104,.808,67,115,182,43,29,1,29,75,444
5178,Mathieu Kamba,JR,2016-17,G,Central Arkansas,Southland,32,1001,167,315,.530,159,295,8,20,.400,102,172,.593,90,125,215,56,25,16,71,92,444
5179,Levi Knutson,SR,2010-11,G,Colorado,Big 12,38,1019,158,312,.506,77,141,81,171,.474,47,52,.904,23,87,110,38,22,2,31,70,444
5180,Craig Moore,SR,2008-09,G,Northwestern,Big Ten,31,1105,142,336,.423,32,65,110,271,.406,50,63,.794,19,80,99,84,41,8,56,73,444
5181,Obi Muonelo,JR,2008-09,G,Oklahoma State,Big 12,35,1053,158,380,.416,70,159,88,221,.398,40,59,.678,44,208,252,57,33,1,52,76,444
5182,Gary Neal,JR,2005-06,G,Towson,CAA,17,600,138,310,.445,76,157,62,153,.405,106,132,.803,12,54,66,49,30,3,60,48,444
5183,Matt O'Leary,SR,2016-17,F,IUPUI,Summit,32,956,161,320,.503,93,168,68,152,.447,54,74,.730,31,165,196,71,31,14,52,67,444
5184,Cameron Oluyitan,JR,2018-19,G,Southern Utah,Big Sky,34,1098,153,343,.446,102,202,51,141,.362,87,116,.750,14,129,143,77,38,13,86,82,444
5185,Kendall Pollard,SO,2014-15,F,Dayton,A-10,35,1020,159,288,.552,156,279,3,9,.333,123,212,.580,39,148,187,37,30,32,85,116,444
5186,Paul Reed,SO,2018-19,F,DePaul,Big East,36,967,176,313,.562,161,276,15,37,.405,77,100,.770,98,207,305,34,40,55,64,92,444
5187,Brandon Rush,FR,2005-06,G,Kansas,Big 12,33,1047,170,359,.474,120,253,50,106,.472,54,71,.761,48,147,195,65,29,23,83,39,444
5188,Tomas Sanchez,SR,2013-14,G,Idaho State,Big Sky,29,1099,126,325,.388,67,165,59,160,.369,133,160,.831,16,68,84,125,50,3,92,61,444
5189,Justin Sears,JR,2014-15,F,Yale,Ivy,31,1012,154,301,.512,152,295,2,6,.333,134,194,.691,94,140,234,48,34,73,85,77,444
5190,Raymond Spalding,JR,2017-18,F,Louisville,ACC,36,995,183,337,.543,178,318,5,19,.263,73,114,.640,113,199,312,46,54,62,61,107,444
5191,Ronald Steele,SO,2005-06,G,Alabama,SEC,31,1191,133,320,.416,79,189,54,131,.412,124,139,.892,21,93,114,132,45,8,83,46,444
5192,Ben Stywall,SR,2009-10,F,North Carolina-Greensboro,Southern,31,1051,161,331,.486,160,323,1,8,.125,121,180,.672,131,192,323,32,48,18,79,90,444
5193,Justice Sueing,SO,2018-19,F,University of California,Pac-12,31,1070,140,324,.432,105,208,35,116,.302,129,165,.782,46,140,186,61,52,15,53,78,444
5194,Isaiah Taylor,FR,2013-14,G,Texas,Big 12,35,1055,144,368,.391,139,349,5,19,.263,151,202,.748,10,105,115,141,37,3,83,90,444
5195,Jonathan Thompson,SR,2012-13,G,Rider,MAAC,34,1152,146,293,.498,97,173,49,120,.408,103,135,.763,34,98,132,105,51,22,70,55,444
5196,Hank Thorns,SR,2011-12,G,Texas Christian,MWC,33,1121,140,370,.378,66,181,74,189,.392,90,120,.750,18,75,93,152,44,1,104,83,444
5197,Michael Tveidt,SR,2010-11,F,North Dakota State,Summit,29,934,162,332,.488,122,243,40,89,.449,80,100,.800,17,89,106,64,21,13,52,75,444
5198,Rashad Whack,JR,2012-13,G,Mount St. Mary's,NEC,32,958,145,364,.398,62,133,83,231,.359,71,91,.780,33,86,119,50,67,5,55,70,444
5199,Ken Williams,SR,2016-17,G,South Alabama,Sun Belt,32,941,141,392,.360,91,205,50,187,.267,112,144,.778,19,74,93,106,27,7,61,52,444
5200,Wink Adams,SR,2008-09,G,Nevada-Las Vegas,MWC,31,987,146,389,.375,107,244,39,145,.269,112,165,.679,22,106,128,87,43,1,63,48,443
5201,Francis Alonso,FR,2015-16,G,North Carolina-Greensboro,Southern,34,965,139,313,.444,54,98,85,215,.395,80,94,.851,8,52,60,61,18,5,66,67,443
5202,Tim Ambrose,SO,2008-09,G,Albany (NY),AEC,31,753,167,364,.459,140,284,27,80,.338,82,105,.781,48,111,159,80,35,3,96,91,443
5203,Stefan Blaszczynski,JR,2005-06,G,Nicholls State,Southland,27,860,157,328,.479,131,236,26,92,.283,103,142,.725,58,129,187,57,29,9,76,83,443
5206,Courtney Bradley,JR,2005-06,F,Jacksonville State,OVC,29,879,170,328,.518,151,278,19,50,.380,84,122,.689,61,158,219,29,38,9,53,57,443
5207,Anthony Brown,JR,2013-14,G,Stanford,Pac-12,36,1206,142,299,.475,89,182,53,117,.453,106,135,.785,33,147,180,75,31,4,70,67,443
5208,Tasheed Carr,SR,2008-09,G,Saint Joseph's,A-10,31,1081,143,360,.397,92,235,51,125,.408,106,148,.716,33,118,151,134,43,6,78,84,443
5209,Robert Carter,JR,2015-16,F,Maryland,Big Ten,36,950,170,307,.554,144,229,26,78,.333,77,103,.748,61,189,250,67,30,45,79,102,443
5210,Brandon Cole,SR,2005-06,G,IUPUI,Mid-Cont,29,1100,153,366,.418,72,155,81,211,.384,56,75,.747,51,152,203,37,28,6,43,45,443
5211,Darren Collison,SO,2006-07,G,UCLA,Pac-10,35,1155,149,312,.478,98,198,51,114,.447,94,116,.810,11,68,79,199,78,3,102,53,443
5212,Troy Cotton,SR,2009-10,G,Green Bay,Horizon,35,1149,147,350,.420,44,103,103,247,.417,46,57,.807,24,82,106,36,29,2,38,81,443
5213,Benson Egemonye,SR,2008-09,C,Niagara,MAAC,35,920,143,256,.559,143,256,0,0,,157,225,.698,112,136,248,7,24,56,62,106,443
5214,Alex Francis,FR,2010-11,F,Bryant,NEC,30,927,170,335,.507,170,328,0,7,.000,103,198,.520,80,159,239,24,27,16,112,82,443
5215,Kelly Golob,SR,2005-06,G,Northern Arizona,Big Sky,31,909,157,332,.473,86,166,71,166,.428,58,71,.817,19,97,116,39,32,12,41,64,443
5216,Tyler Hagedorn,JR,2017-18,F,South Dakota,Summit,34,836,153,346,.442,109,235,44,111,.396,93,113,.823,51,148,199,37,24,28,45,84,443
5217,DeAndre Hall,JR,2008-09,G,Texas Southern,SWAC,32,912,173,386,.448,166,358,7,28,.250,90,154,.584,44,83,127,56,34,3,82,93,443
5218,Joe Harris ,SR,2013-14,G,Virginia,ACC,37,1066,149,338,.441,77,158,72,180,.400,73,114,.640,22,87,109,84,35,8,48,88,443
5219,Jeremy Hemsley,FR,2015-16,G,San Diego State,MWC,37,1014,147,342,.430,105,224,42,118,.356,107,141,.759,19,70,89,68,27,12,71,82,443
5220,LaDontae Henton,SO,2012-13,F,Providence,Big East,34,1162,158,392,.403,127,272,31,120,.258,96,118,.814,90,192,282,34,34,21,68,92,443
5221,Jeremy Hollowell,JR,2015-16,F,Georgia State,Sun Belt,30,958,152,349,.436,115,238,37,111,.333,102,126,.810,30,116,146,50,31,13,56,88,443
5222,Vander Joaquim,SR,2012-13,C,Hawaii,Big West,32,843,168,349,.481,155,317,13,32,.406,94,123,.764,71,189,260,28,12,31,75,83,443
5223,Vic Law,SO,2016-17,F,Northwestern,Big Ten,36,1155,147,365,.403,88,217,59,148,.399,90,122,.738,46,164,210,63,38,18,56,96,443
5224,Kareem Maddox,SR,2010-11,F,Princeton,Ivy,32,991,158,278,.568,157,271,1,7,.143,126,161,.783,62,162,224,80,27,56,65,67,443
5225,Fletcher Magee,FR,2015-16,G,Wofford,Southern,32,921,133,282,.472,42,92,91,190,.479,86,93,.925,12,85,97,47,12,3,47,49,443
5228,Malik Moore,SR,2018-19,F,South Carolina Upstate,Big South,28,808,156,340,.459,112,192,44,148,.297,87,124,.702,50,143,193,63,39,19,67,79,443
5229,Wen Mukubu,SR,2006-07,G,Alabama-Birmingham,CUSA,31,1094,147,351,.419,89,206,58,145,.400,91,138,.659,42,136,178,76,44,11,93,79,443
5230,Adam Smith,JR,2014-15,C,Virginia Tech,ACC,33,986,158,361,.438,77,170,81,191,.424,46,62,.742,14,71,85,30,12,4,26,54,443
5231,Michael Southall,SR,2005-06,C,Louisiana,Sun Belt,28,843,164,266,.617,164,265,0,1,.000,115,177,.650,66,157,223,41,27,93,59,95,443
5232,Elijah Stewart,JR,2016-17,G,Southern California,Pac-12,36,1073,154,357,.431,76,155,78,202,.386,57,81,.704,45,96,141,43,29,42,37,94,443
5233,Reyshawn Terry,JR,2005-06,F,North Carolina,ACC,31,750,145,306,.474,100,188,45,118,.381,108,135,.800,60,132,192,42,30,27,82,93,443
5234,Anthony Tolliver,SR,2006-07,C,Creighton,MVC,33,1044,158,312,.506,154,293,4,19,.211,123,187,.658,74,146,220,64,24,57,67,102,443
5235,Christian Watford,SR,2012-13,F,Indiana,Big Ten,36,1007,127,295,.431,67,170,60,125,.480,129,159,.811,48,178,226,31,23,17,57,81,443
5236,Micah Williams,JR,2009-10,G,East Tennessee State,A-Sun,35,936,148,314,.471,107,197,41,117,.350,106,147,.721,37,80,117,33,27,15,68,71,443
5237,Pendarvis Williams,JR,2012-13,G,Norfolk State,MEAC,31,1025,143,316,.453,78,156,65,160,.406,92,113,.814,30,109,139,53,34,18,38,53,443
5238,Anton Wilson,SR,2015-16,G,Detroit Mercy,Horizon,31,1001,137,314,.436,51,113,86,201,.428,83,93,.892,28,94,122,68,41,19,54,91,443
5239,Keith Wright,JR,2010-11,F,Harvard,Ivy,30,968,174,298,.584,174,297,0,1,.000,95,134,.709,96,153,249,46,25,51,69,74,443
5240,Alexis Yetna,FR,2018-19,F,South Florida,AAC,36,1088,165,306,.539,137,230,28,76,.368,85,136,.625,118,228,346,36,30,21,59,91,443
5241,Bashir Ahmed,JR,2016-17,F,St. John's (NY),Big East,33,881,142,360,.394,90,213,52,147,.354,106,156,.679,59,121,180,40,18,19,75,83,442
5242,James Akinjo,FR,2018-19,G,Georgetown,Big East,33,1043,128,351,.365,76,218,52,133,.391,134,165,.812,7,89,96,173,37,1,99,81,442
5243,Jarrett Allen,FR,2016-17,F,Texas,Big 12,33,1061,179,316,.566,179,309,0,7,.000,84,149,.564,100,178,278,27,19,51,84,68,442
5244,Chris Anderson,SR,2013-14,C,Louisiana Tech,CUSA,37,874,160,367,.436,128,261,32,106,.302,90,138,.652,81,127,208,36,42,12,70,122,442
5245,Derrell Armstrong,SR,2012-13,G,North Carolina-Greensboro,Southern,30,816,158,346,.457,117,236,41,110,.373,85,118,.720,43,105,148,63,39,4,74,75,442
5246,Dedrick Basile,SR,2016-17,G,Cal State Bakersfield,WAC,35,1042,165,376,.439,100,208,65,168,.387,47,68,.691,23,88,111,106,56,3,73,85,442
5247,Paris Bass,SO,2015-16,G,Detroit Mercy,Horizon,24,714,159,342,.465,137,274,22,68,.324,102,149,.685,50,141,191,50,33,33,81,84,442
5250,Ray Bowles,JR,2016-17,G,Pacific,WCC,33,1107,141,397,.355,95,251,46,146,.315,114,162,.704,35,88,123,89,26,10,72,88,442
5251,Anthony Brown,SO,2006-07,F,Pacific,Big West,31,1032,149,279,.534,148,276,1,3,.333,143,204,.701,72,152,224,49,24,21,69,75,442
5252,Jay Canty,SO,2012-13,F,Appalachian State,Southern,31,982,162,368,.440,147,308,15,60,.250,103,149,.691,68,123,191,94,31,15,79,56,442
5253,Akeim Claborn,SR,2005-06,F,Alabama State,SWAC,30,851,150,292,.514,129,224,21,68,.309,121,197,.614,83,143,226,34,24,22,57,113,442
5254,Mike Cunningham,SO,2016-17,G,South Carolina Upstate,A-Sun,33,1041,145,360,.403,70,165,75,195,.385,77,94,.819,15,66,81,103,44,1,49,40,442
5255,Jermareo Davidson,JR,2005-06,F,Alabama,SEC,31,1048,168,352,.477,168,349,0,3,.000,106,142,.746,86,190,276,38,26,58,67,68,442
5256,Ayo Dosunmu,FR,2018-19,G,Illinois,Big Ten,32,1000,163,375,.435,113,233,50,142,.352,66,95,.695,23,105,128,104,41,8,72,64,442
5257,Devon Dotson,FR,2018-19,G,Kansas,Big 12,36,1168,147,305,.482,114,214,33,91,.363,115,147,.782,22,110,132,127,49,5,81,91,442
5258,Bryan Dougher,SO,2009-10,G,Stony Brook,AEC,32,1011,146,352,.415,51,128,95,224,.424,55,67,.821,27,60,87,57,31,2,43,63,442
5259,Ernie Duncan,SR,2018-19,G,Vermont,AEC,32,946,142,297,.478,63,117,79,180,.439,79,95,.832,7,48,55,65,21,8,47,60,442
5260,Festus Ezeli,JR,2010-11,C,Vanderbilt,SEC,34,799,151,257,.588,151,257,0,0,,140,216,.648,95,118,213,6,20,88,60,104,442
5261,Darien Fernandez,SR,2016-17,G,Jacksonville,A-Sun,33,975,134,334,.401,77,184,57,150,.380,117,158,.741,35,110,145,123,79,2,81,116,442
5262,Tarvin Gaines,Sr,2012-13,F,Jacksonville State,OVC,27,856,139,293,.474,110,202,29,91,.319,135,162,.833,46,94,140,23,27,19,41,75,442
5263,Dan Geriot,SO,2007-08,C,Richmond,A-10,31,909,165,349,.473,134,271,31,78,.397,81,108,.750,45,126,171,56,22,10,78,94,442
5264,Dorian Green,SR,2012-13,G,Colorado State,MWC,34,1115,135,325,.415,82,178,53,147,.361,119,152,.783,6,81,87,124,27,4,60,59,442
5265,Vernon Hamilton,SR,2006-07,G,Clemson,ACC,36,1133,178,380,.468,141,259,37,121,.306,49,100,.490,25,88,113,122,70,3,95,58,442
5266,Luke Hancock,SR,2013-14,F,Louisville,AAC,36,861,124,304,.408,56,107,68,197,.345,126,152,.829,22,73,95,79,36,7,53,95,442
5267,Troy Harper,SR,2018-19,G,Drexel,CAA,28,844,130,334,.389,107,241,23,93,.247,159,205,.776,10,79,89,65,16,2,72,68,442
5268,Samajae Haynes-Jones,SR,2018-19,G,Wichita State,AAC,37,1196,164,459,.357,100,244,64,215,.298,50,59,.847,18,91,109,99,23,2,60,70,442
5269,LaVone Holland,SR,2017-18,G,Northern Kentucky,Horizon,32,969,147,357,.412,90,193,57,164,.348,91,108,.843,17,116,133,140,34,7,82,74,442
5272,Al Horford,SO,2005-06,F,Florida,SEC,39,1011,177,291,.608,177,289,0,2,.000,88,144,.611,86,209,295,77,40,68,74,97,442
5273,Keith Hornsby,JR,2014-15,G,Louisiana State,SEC,33,1172,156,370,.422,84,187,72,183,.393,58,74,.784,20,118,138,69,37,16,47,52,442
5274,Yassin Idbihi,SR,2006-07,F,Buffalo,MAC,28,886,146,334,.437,131,268,15,66,.227,135,169,.799,93,168,261,48,16,34,80,78,442
5275,Darius Johnson-Odom,SO,2009-10,G,Marquette,Big East,34,1009,152,334,.455,79,180,73,154,.474,65,96,.677,16,74,90,81,30,6,68,77,442
5276,Carl Jones,SR,2012-13,G,Saint Joseph's,A-10,30,1024,143,351,.407,80,179,63,172,.366,93,138,.674,10,70,80,79,27,6,60,37,442
5277,Jacques Jones,JR,2006-07,F,Texas Southern,SWAC,31,1065,164,355,.462,162,333,2,22,.091,112,154,.727,85,114,199,54,38,22,93,96,442
5278,Jamie Jones,SR,2009-10,F,Portland State,Big Sky,32,926,180,309,.583,180,309,0,0,,82,111,.739,99,146,245,31,23,75,45,87,442
5279,Lucky Jones,SR,2014-15,G,Robert Morris,NEC,31,924,135,346,.390,75,165,60,181,.331,112,142,.789,43,141,184,43,42,12,73,82,442
5280,DJ Laster,JR,2017-18,F,Gardner-Webb,Big South,32,844,188,372,.505,167,306,21,66,.318,45,74,.608,63,109,172,14,18,13,61,79,442
5281,J.R. Lynch,JR,2017-18,G,Hartford,AEC,33,1190,154,361,.427,103,220,51,141,.362,83,100,.830,11,132,143,126,48,2,80,89,442
5282,Stephen McDowell,JR,2007-08,G,Chattanooga,Southern,31,1017,142,383,.371,34,90,108,293,.369,50,65,.769,20,47,67,38,40,0,53,48,442
5283,Shonn Miller,SR,2015-16,F,Connecticut,AAC,36,924,170,297,.572,161,273,9,24,.375,93,116,.802,44,142,186,20,34,31,22,108,442
5284,Vado Morse,FR,2018-19,G,Mount St. Mary's,NEC,30,923,141,338,.417,83,175,58,163,.356,102,131,.779,13,64,77,87,32,1,72,68,442
5285,Mike Morsell,JR,2016-17,G,Towson,CAA,33,896,140,323,.433,92,179,48,144,.333,114,149,.765,33,68,101,43,27,19,69,81,442
5286,De'Sean Parsons,SR,2016-17,F,Portland State,Big Sky,31,905,167,346,.483,151,295,16,51,.314,92,174,.529,56,137,193,83,41,22,89,66,442
5287,Josh Peppers,SR,2006-07,F,Central Florida,CUSA,31,912,150,330,.455,95,185,55,145,.379,87,115,.757,45,96,141,60,28,16,72,69,442
5288,Bryquis Perine,JR,2009-10,G,Green Bay,Horizon,33,1107,152,376,.404,120,280,32,96,.333,106,138,.768,15,74,89,138,37,6,76,47,442
5289,Jabari Peters,JR,2013-14,G,Sam Houston State,Southland,35,1113,115,300,.383,65,172,50,128,.391,162,236,.686,29,130,159,147,44,13,81,59,442
5290,Ed Polite,SR,2018-19,F,Radford,Big South,33,1104,163,316,.516,137,235,26,81,.321,90,121,.744,78,236,314,52,49,40,54,73,442
5291,D.J. Richardson,SR,2012-13,G,Illinois,Big Ten,36,1218,142,391,.363,59,133,83,258,.322,75,92,.815,25,114,139,58,48,6,50,71,442
5292,Daniel Ruffin,JR,2006-07,G,Bradley,MVC,32,1072,152,367,.414,86,194,66,173,.382,72,93,.774,13,67,80,172,61,5,78,70,442
5293,Shay Shine,JR,2010-11,G,High Point,Big South,31,947,154,357,.431,99,221,55,136,.404,79,107,.738,40,91,131,83,41,7,69,83,442
5294,Scoochie Smith,SR,2016-17,G,Dayton,A-10,32,1000,145,310,.468,91,171,54,139,.388,98,127,.772,11,87,98,144,51,3,70,76,442
5295,Kareem South,JR,2018-19,G,Texas A&M-Corpus Christi,Southland,32,1045,155,375,.413,104,236,51,139,.367,81,98,.827,57,107,164,64,40,2,46,72,442
5296,Maze Stallworth,SR,2009-10,F,Morehead State,OVC,35,1121,140,347,.403,45,114,95,233,.408,67,82,.817,77,99,176,45,47,18,52,107,442
5297,Justice Sueing,FR,2017-18,F,University of California,Pac-12,32,1023,157,362,.434,115,227,42,135,.311,86,128,.672,48,124,172,44,48,15,68,75,442
5298,D'Shon Taylor,JR,2014-15,G,Norfolk State,MEAC,34,1082,145,322,.450,95,181,50,141,.355,102,151,.675,54,116,170,45,28,25,57,93,442
5299,Tahjai Teague,JR,2018-19,F,Ball State,MAC,33,932,174,317,.549,161,267,13,50,.260,81,121,.669,64,183,247,41,44,29,70,102,442
5300,Pancake Thomas,SR,2016-17,G,Western Kentucky,CUSA,32,1112,149,358,.416,73,167,76,191,.398,68,87,.782,23,83,106,82,28,1,42,47,442
5301,Tre'Shawn Thurman,JR,2016-17,F,Omaha,Summit,32,954,166,334,.497,155,290,11,44,.250,99,147,.673,65,183,248,43,13,26,63,91,442
5302,Elston Turner,JR,2011-12,G,Texas A&M,Big 12,32,1080,150,369,.407,80,189,70,180,.389,72,91,.791,9,106,115,72,31,7,67,54,442
5303,Alan Wiggins,SR,2006-07,F,San Francisco,WCC,31,965,155,297,.522,152,277,3,20,.150,129,175,.737,71,151,222,47,28,46,76,108,442
5304,Akeem Williams,SR,2013-14,G,Massachusetts-Lowell,AEC,28,896,145,379,.383,91,222,54,157,.344,98,122,.803,26,88,114,95,36,2,90,67,442
5305,Cassius Winston,SO,2017-18,G,Michigan State,Big Ten,35,985,143,282,.507,68,131,75,151,.497,81,90,.900,7,111,118,241,23,2,87,69,442
5306,Derrick Alston,SO,2018-19,G,Boise State,MWC,33,920,145,299,.485,89,153,56,146,.384,95,116,.819,21,108,129,37,13,13,48,65,441
5307,Kyan Anderson,SR,2014-15,G,Texas Christian,Big 12,33,1055,132,332,.398,75,164,57,168,.339,120,138,.870,9,39,48,141,41,5,84,68,441
5308,Trae Anderson,SR,2015-16,G,Eastern Illinois,OVC,30,711,171,357,.479,166,325,5,32,.156,94,142,.662,46,110,156,53,31,22,85,91,441
5309,Ryan Andino,JR,2016-17,G,Maryland-Eastern Shore,MEAC,34,1055,138,379,.364,17,61,121,318,.381,44,52,.846,9,60,69,33,29,1,36,40,441
5310,Cedric Blossom,JR,2014-15,F,Morgan State,MEAC,31,1077,161,378,.426,159,370,2,8,.250,117,168,.696,100,119,219,22,33,8,37,73,441
5311,Marshon Brooks,JR,2009-10,G,Providence,Big East,31,824,168,360,.467,122,229,46,131,.351,59,83,.711,55,74,129,44,41,16,52,72,441
5314,Mike Brown,JR,2014-15,G,Western Carolina,Southern,32,1117,162,354,.458,120,240,42,114,.368,75,112,.670,67,133,200,51,29,18,70,95,441
5315,Jordan Capps,SR,2017-18,F,Southeastern Louisiana,Southland,33,692,178,329,.541,160,276,18,53,.340,67,122,.549,37,105,142,17,15,31,63,79,441
5316,Eli Carter,FR,2011-12,G,Rutgers,Big East,32,952,153,374,.409,98,218,55,156,.353,80,115,.696,16,82,98,68,42,3,88,81,441
5317,Mike Conley,FR,2006-07,G,Ohio State,Big Ten,39,1231,160,309,.518,139,240,21,69,.304,100,144,.694,27,107,134,238,87,10,86,60,441
5318,Pat Connaughton,JR,2013-14,G,Notre Dame,ACC,32,1190,155,343,.452,79,142,76,201,.378,55,66,.833,38,189,227,95,33,18,35,57,441
5319,Troy Daniels,SR,2012-13,G,Virginia Commonwealth,A-10,36,947,149,357,.417,25,49,124,308,.403,19,27,.704,23,89,112,23,32,3,32,76,441
5320,Cade Davis,SR,2010-11,G,Oklahoma,Big 12,31,1081,147,329,.447,83,150,64,179,.358,83,114,.728,28,127,155,57,31,14,61,83,441
5321,Cameron Delaney,SR,2018-19,G,Sam Houston State,Southland,33,1041,145,311,.466,68,134,77,177,.435,74,90,.822,52,129,181,66,30,15,52,69,441
5322,Daniel Emerson,JR,2008-09,F,Mercer,A-Sun,32,1118,146,307,.476,126,250,20,57,.351,129,186,.694,119,224,343,72,14,5,102,80,441
5323,George Fant,SR,2014-15,F,Western Kentucky,CUSA,32,920,170,321,.530,170,321,0,0,,101,163,.620,103,165,268,50,30,21,66,107,441
5324,Keith Gabriel,JR,2010-11,G,Virginia Military Institute,Big South,31,738,151,355,.425,88,163,63,192,.328,76,115,.661,28,70,98,43,53,17,71,83,441
5325,Langston Galloway,JR,2012-13,G,Saint Joseph's,A-10,32,1142,150,362,.414,70,159,80,203,.394,61,79,.772,22,94,116,72,44,11,47,74,441
5326,Sterling Gibbs,SR,2015-16,G,Connecticut,AAC,36,1186,125,323,.387,46,119,79,204,.387,112,131,.855,11,67,78,83,34,1,58,57,441
5327,Ricardo Glenn,SR,2013-14,F,South Carolina Upstate,A-Sun,33,945,158,249,.635,158,248,0,1,.000,125,176,.710,105,160,265,59,21,9,70,76,441
5328,A.J. Graves,SO,2005-06,G,Butler,Horizon,33,1070,148,368,.402,80,186,68,182,.374,77,94,.819,6,69,75,80,43,1,54,65,441
5329,Isaac Haas,JR,2016-17,C,Purdue,Big Ten,35,682,159,271,.587,159,271,0,0,,123,173,.711,62,112,174,20,9,26,78,73,441
5330,Alex Harris,SR,2014-15,G,Cal State Fullerton,Big West,28,897,147,354,.415,112,231,35,123,.285,112,167,.671,12,99,111,98,41,4,77,54,441
5331,DeAndre Haynes,SR,2005-06,G,Kent State,MAC,34,1053,152,348,.437,96,207,56,141,.397,81,103,.786,27,66,93,134,57,4,104,104,441
5332,Kyle Hittle,SO,2013-14,G,Incarnate Word,Southland,27,915,154,290,.531,95,145,59,145,.407,74,105,.705,30,123,153,48,21,8,47,48,441
5333,Aaron Holiday,SO,2016-17,G,UCLA,Pac-12,36,952,150,309,.485,97,180,53,129,.411,88,111,.793,12,91,103,158,39,6,87,81,441
5336,Jeremy Hollimon,SR,2016-17,G,Troy,Sun Belt,37,807,145,305,.475,98,192,47,113,.416,104,134,.776,29,65,94,58,20,6,56,68,441
5337,Ian Hummer,SO,2010-11,F,Princeton,Ivy,32,965,180,324,.556,180,324,0,0,,81,126,.643,62,154,216,61,36,36,70,66,441
5338,Michael Hunter,SR,2009-10,G,UC-Irvine,Big West,32,937,140,346,.405,60,125,80,221,.362,81,93,.871,7,70,77,75,42,2,68,54,441
5339,Jarrod Jones,SR,2011-12,F,Ball State,MAC,30,935,161,334,.482,148,299,13,35,.371,106,138,.768,69,192,261,24,21,24,51,68,441
5340,Jeremy Kelly,SR,2005-06,G,Tennessee-Martin,OVC,27,945,136,334,.407,93,173,43,161,.267,126,158,.797,24,65,89,120,56,8,100,95,441
5341,D.J. Kennedy,SO,2008-09,G,St. John's (NY),Big East,34,1176,134,333,.402,98,225,36,108,.333,137,187,.733,59,167,226,101,52,14,73,76,441
5342,John Konchar,FR,2015-16,G,Purdue-Fort Wayne,Summit,34,1211,163,279,.584,134,213,29,66,.439,86,119,.723,91,221,312,92,71,9,51,81,441
5343,Bryant McIntosh,SO,2015-16,G,Northwestern,Big Ten,32,1142,161,381,.423,112,247,49,134,.366,70,85,.824,12,104,116,213,31,5,78,65,441
5344,Darrius Morrow,JR,2010-11,F,East Carolina,CUSA,34,1038,141,277,.509,141,276,0,1,.000,159,239,.665,87,126,213,26,25,28,80,95,441
5345,Jeffery Moss,SR,2015-16,F,Murray State,OVC,31,1106,146,336,.435,66,143,80,193,.415,69,88,.784,28,97,125,63,23,3,40,70,441
5346,Jim Mower,SO,2009-10,G,Lafayette,Patriot,32,857,149,334,.446,57,136,92,198,.465,51,63,.810,15,50,65,61,14,4,33,60,441
5347,Shabazz Napier,SO,2011-12,G,Connecticut,Big East,34,1191,136,350,.389,77,184,59,166,.355,110,148,.743,23,97,120,198,56,9,94,87,441
5348,Ike Ofoegbu,SR,2006-07,F,Southern Methodist,CUSA,31,953,137,274,.500,108,210,29,64,.453,138,196,.704,109,127,236,30,36,13,103,84,441
5349,A.J. Ogilvy,JR,2009-10,C,Vanderbilt,SEC,33,764,142,279,.509,142,279,0,0,,157,215,.730,66,138,204,29,34,48,62,97,441
5350,Ashton Pankey,JR,2014-15,F,Manhattan,MAAC,33,908,145,274,.529,145,274,0,0,,151,217,.696,77,143,220,31,23,47,76,120,441
5351,Darius Quisenberry,FR,2018-19,G,Youngstown State,Horizon,32,870,142,346,.410,91,186,51,160,.319,106,133,.797,12,82,94,120,43,1,65,72,441
5352,Justin Robinson,SO,2014-15,G,Monmouth,MAAC,33,1062,139,331,.420,87,190,52,141,.369,111,140,.793,21,92,113,120,56,0,64,48,441
5353,Jonathon Simmons,JR,2011-12,G,Houston,CUSA,30,902,154,301,.512,122,218,32,83,.386,101,141,.716,42,107,149,65,21,11,100,75,441
5354,Jared Terrell,JR,2016-17,G,Rhode Island,A-10,35,1074,142,339,.419,96,206,46,133,.346,111,148,.750,34,66,100,70,36,6,54,90,441
5355,Elijah Thomas,SR,2018-19,F,Clemson,ACC,34,874,172,281,.612,172,280,0,1,.000,97,152,.638,84,181,265,46,28,74,94,112,441
5358,Jordan Washington,JR,2015-16,F,Iona,MAAC,31,579,167,325,.514,167,325,0,0,,107,180,.594,95,103,198,11,14,18,66,116,441
5359,Bryson Williams,SO,2017-18,F,Fresno State,MWC,32,916,192,322,.596,191,318,1,4,.250,56,93,.602,60,135,195,37,16,21,59,102,441
5360,J.T. Williams,SR,2005-06,F,McNeese State,Southland,28,838,147,342,.430,81,177,66,165,.400,81,107,.757,50,105,155,35,47,22,64,82,441
5361,Josh Williams,SR,2016-17,G,Lipscomb,A-Sun,33,850,142,321,.442,68,125,74,196,.378,83,98,.847,34,80,114,57,27,8,74,82,441
5362,Scott Wood,SR,2012-13,F,North Carolina State,ACC,35,1189,126,289,.436,22,53,104,236,.441,85,93,.914,11,91,102,37,19,22,34,80,441
5363,Aaron Anderson,JR,2012-13,G,North Dakota,Big Sky,33,1055,126,290,.434,73,161,53,129,.411,135,157,.860,19,91,110,109,45,2,56,44,440
5364,Manny Atkins,JR,2012-13,F,Georgia State,CAA,31,1111,148,350,.423,94,219,54,131,.412,90,113,.796,59,148,207,69,48,9,67,71,440
5365,Sean Baptiste,JR,2008-09,G,Fairleigh Dickinson,NEC,27,967,154,361,.427,106,221,48,140,.343,84,120,.700,59,100,159,29,47,4,56,61,440
5366,Javon Bess,JR,2017-18,F,Saint Louis,A-10,33,1195,128,324,.395,104,235,24,89,.270,160,211,.758,79,165,244,72,41,13,67,78,440
5367,Jenirro Bush,JR,2010-11,G,Jackson State,SWAC,31,846,153,355,.431,101,201,52,154,.338,82,124,.661,32,75,107,32,42,4,61,63,440
5368,Jalen Cannon,SO,2012-13,F,St. Francis (NY),NEC,30,910,170,306,.556,164,282,6,24,.250,94,138,.681,104,161,265,20,30,11,43,66,440
5369,Josh Carter,JR,2007-08,F,Texas A&M,Big 12,36,1041,146,347,.421,67,139,79,208,.380,69,84,.821,37,105,142,50,21,6,28,56,440
5370,Bill Clark,SO,2008-09,G,Duquesne,A-10,34,1004,141,286,.493,75,120,66,166,.398,92,135,.681,54,117,171,91,32,7,84,121,440
5371,David Cohn,SR,2017-18,G,William & Mary,CAA,31,1114,144,272,.529,95,157,49,115,.426,103,113,.912,9,83,92,207,50,0,83,59,440
5372,Glenn Cosey,JR,2012-13,G,Eastern Kentucky,OVC,29,1026,141,330,.427,61,132,80,198,.404,78,96,.813,11,84,95,93,47,0,39,52,440
5373,David Crisp,SR,2018-19,G,Washington,Pac-12,36,1190,150,366,.410,76,168,74,198,.374,66,103,.641,15,61,76,97,36,2,71,78,440
5374,Doug Davis,SR,2011-12,G,Princeton,Ivy,32,1057,155,365,.425,72,167,83,198,.419,47,57,.825,8,53,61,45,37,9,42,46,440
5375,Terence Davis,JR,2017-18,G,Mississippi,SEC,32,874,157,386,.407,98,200,59,186,.317,67,93,.720,47,151,198,66,29,28,72,94,440
5376,Will Davis,SR,2014-15,F,UC-Irvine,Big West,34,1012,185,341,.543,185,340,0,1,.000,70,99,.707,83,157,240,33,18,34,45,47,440
5377,Kevin Dillard,JR,2011-12,G,Dayton,A-10,33,1079,143,347,.412,104,227,39,120,.325,115,139,.827,10,79,89,198,47,13,94,89,440
5380,Vince Edwards,JR,2016-17,F,Purdue,Big Ten,35,1001,160,329,.486,113,218,47,111,.423,73,89,.820,66,107,173,112,20,19,58,64,440
5381,Wes Eikmeier,SR,2012-13,G,Colorado State,MWC,35,1084,145,381,.381,91,232,54,149,.362,96,107,.897,3,56,59,75,19,2,59,97,440
5382,Tyler Ennis,FR,2013-14,G,Syracuse,ACC,34,1215,148,360,.411,118,275,30,85,.353,114,149,.765,27,88,115,187,71,6,58,69,440
5383,Will Felder,SR,2013-14,F,Miami (OH),MAC,31,990,161,301,.535,156,275,5,26,.192,113,135,.837,65,144,209,28,25,31,70,73,440
5384,Corey Fisher,JR,2009-10,G,Villanova,Big East,33,892,134,300,.447,96,204,38,96,.396,134,174,.770,24,70,94,129,42,6,68,83,440
5385,Terry Henderson,SR,2016-17,G,North Carolina State,ACC,32,988,136,314,.433,58,111,78,203,.384,90,117,.769,22,77,99,51,22,18,51,76,440
5386,Brian Hodges,JR,2006-07,G,Maryland-Baltimore County,AEC,30,809,157,400,.393,101,237,56,163,.344,70,92,.761,34,75,109,32,19,2,57,58,440
5387,Will Hudson,SR,2010-11,F,Oakland,Summit,35,1097,160,248,.645,160,242,0,6,.000,120,168,.714,133,120,253,28,24,33,46,88,440
5388,DeWayne Jackson,SR,2012-13,F,Morgan State,MEAC,32,1027,160,359,.446,121,219,39,140,.279,81,123,.659,47,131,178,79,53,29,76,88,440
5389,Wesley Jenkins,SO,2008-09,G,Saint Peter's,MAAC,28,953,151,427,.354,80,234,71,193,.368,67,93,.720,25,95,120,29,57,4,63,57,440
5390,Kenny McGowan,SR,2011-12,G,Idaho State,Big Sky,30,885,136,359,.379,69,153,67,206,.325,101,129,.783,12,30,42,66,28,2,71,96,440
5391,Erik Murphy,SR,2012-13,F,Florida,SEC,36,952,164,318,.516,92,159,72,159,.453,40,51,.784,58,141,199,50,23,25,51,101,440
5392,Devin Oliver,SR,2013-14,F,Dayton,A-10,37,1107,149,308,.484,107,202,42,106,.396,100,131,.763,84,191,275,86,33,10,53,93,440
5393,Kevin Pangos,SR,2014-15,G,Gonzaga,WCC,38,1278,135,301,.449,54,113,81,188,.431,89,108,.824,16,88,104,181,48,4,51,74,440
5394,Chris Perez,SR,2013-14,G,Canisius,MAAC,34,1192,161,364,.442,135,293,26,71,.366,92,131,.702,37,58,95,58,26,1,72,79,440
5395,Angel Rodriguez,SR,2015-16,G,Miami (FL),ACC,35,1055,144,326,.442,88,162,56,164,.341,96,120,.800,23,66,89,158,58,6,89,90,440
5396,Augustine Rubit,SO,2011-12,F,South Alabama,Sun Belt,29,938,159,314,.506,159,308,0,6,.000,122,171,.713,105,163,268,24,11,26,67,60,440
5397,Tyler Scanlon,JR,2018-19,F,Boston University,Patriot,32,1070,165,357,.462,115,211,50,146,.342,60,75,.800,28,131,159,106,44,5,72,49,440
5398,Justin Sears,SR,2015-16,F,Yale,Ivy,28,869,163,310,.526,158,294,5,16,.313,109,163,.669,103,107,210,79,21,48,69,78,440
5399,Jarred Shaw,JR,2012-13,F,Utah State,WAC,31,907,179,332,.539,178,327,1,5,.200,81,112,.723,69,192,261,25,9,30,65,91,440
5400,TJ Shorts,SR,2018-19,G,UC-Davis,Big West,29,960,163,328,.497,151,285,12,43,.279,102,142,.718,18,119,137,126,46,6,88,73,440
5401,Chet Stachitas,SR,2005-06,G,Saint Joseph's,A-10,33,1149,135,330,.409,60,145,75,185,.405,95,118,.805,19,65,84,73,39,7,49,78,440
5402,Will Thomas,JR,2006-07,F,George Mason,CAA,33,1147,178,284,.627,178,283,0,1,.000,84,135,.622,66,161,227,73,21,21,52,45,440
5403,Bernard Thompson,SR,2014-15,G,Florida Gulf Coast,A-Sun,32,1031,151,383,.394,77,187,74,196,.378,64,87,.736,46,114,160,56,55,4,50,66,440
5404,Wyatt Walker,SO,2016-17,F,Samford,Southern,34,991,157,268,.586,155,262,2,6,.333,124,163,.761,99,230,329,51,21,29,67,88,440
5405,Marquis Weddle,SO,2008-09,G,Tennessee-Martin,OVC,32,936,156,434,.359,63,161,93,273,.341,35,44,.795,10,47,57,27,25,0,53,45,440
5406,D.J. White,JR,2006-07,F,Indiana,Big Ten,32,1017,170,332,.512,170,332,0,0,,100,146,.685,77,157,234,40,28,73,62,84,440
5407,Matthew Wilson,JR,2018-19,F,Army,Patriot,32,847,187,319,.586,187,319,0,0,,66,107,.617,58,218,276,14,9,8,47,70,440
5408,Andre Wolford,JR,2017-18,G,Saint Francis (PA),NEC,31,899,141,280,.504,44,84,97,196,.495,61,72,.847,16,77,93,25,16,3,24,56,440
5409,Jalen Adams,SR,2018-19,G,Connecticut,AAC,26,781,169,347,.487,126,226,43,121,.355,58,70,.829,24,80,104,88,28,8,72,67,439
5410,Jordan Barnett,SR,2017-18,F,Missouri,SEC,32,1091,142,316,.449,60,118,82,198,.414,73,82,.890,50,139,189,35,23,19,50,51,439
5411,Matt Bell,SR,2006-07,G,Army,Patriot,30,920,134,282,.475,91,196,43,86,.500,128,161,.795,13,89,102,63,22,2,71,36,439
5412,Trae Bell-Haynes,SO,2015-16,G,Vermont,AEC,36,995,135,286,.472,109,220,26,66,.394,143,179,.799,16,80,96,126,41,2,98,87,439
5413,Takais Brown,JR,2006-07,F,Georgia,SEC,31,876,181,320,.566,179,315,2,5,.400,75,109,.688,104,70,174,27,17,16,68,59,439
5414,Dan Coleman,JR,2006-07,F,Minnesota,Big Ten,31,1003,169,374,.452,150,306,19,68,.279,82,106,.774,52,133,185,42,21,41,57,74,439
5415,Kyle Davis,JR,2015-16,F,Brigham Young,WCC,37,1001,175,321,.545,168,306,7,15,.467,82,136,.603,85,191,276,46,26,49,69,92,439
5416,Malcolm Drumwright,JR,2016-17,G,Jacksonville State,OVC,35,1160,155,372,.417,92,196,63,176,.358,66,83,.795,9,74,83,135,21,8,86,95,439
5417,Phil Forte,SR,2016-17,G,Oklahoma State,Big 12,33,1028,135,316,.427,50,112,85,204,.417,84,88,.955,23,62,85,49,37,2,33,50,439
5418,Alex Franklin,SO,2007-08,F,Siena,MAAC,29,855,158,278,.568,158,278,0,0,,123,186,.661,74,152,226,33,46,23,57,85,439
5419,Branden Frazier,JR,2012-13,G,Fordham,A-10,31,1085,130,377,.345,86,218,44,159,.277,135,163,.828,31,84,115,154,28,1,94,66,439
5422,Trent Frazier,SO,2018-19,G,Illinois,Big Ten,32,975,148,360,.411,68,163,80,197,.406,63,83,.759,10,65,75,82,44,1,65,74,439
5423,Tyrece Gibbs,SR,2008-09,G,New Hampshire,AEC,30,1017,148,373,.397,61,152,87,221,.394,56,78,.718,20,116,136,70,20,25,82,61,439
5424,Gary Harris,FR,2012-13,G,Michigan State,Big Ten,34,1010,150,329,.456,85,171,65,158,.411,74,98,.755,30,56,86,46,45,6,51,68,439
5425,Matt Howard,JR,2009-10,F,Butler,Horizon,38,959,129,268,.481,126,257,3,11,.273,178,227,.784,68,128,196,30,22,23,60,133,439
5426,Justin Jaworski,SO,2018-19,G,Lafayette,Patriot,30,919,142,281,.505,57,107,85,174,.489,70,81,.864,16,70,86,81,20,1,59,61,439
5427,Ryan Kemrite,JR,2016-17,G,Liberty,Big South,33,1037,130,267,.487,49,75,81,192,.422,98,116,.845,17,71,88,28,31,3,24,85,439
5428,Gerald Lee,SO,2007-08,C,Old Dominion,CAA,34,1041,168,349,.481,165,338,3,11,.273,100,136,.735,91,106,197,48,16,30,64,78,439
5429,James Mays,JR,2006-07,C,Clemson,ACC,36,1014,172,360,.478,165,329,7,31,.226,88,160,.550,98,134,232,95,69,34,101,81,439
5430,Gerald McLemore,SO,2009-10,G,Maine,AEC,30,1040,144,359,.401,42,103,102,256,.398,49,66,.742,9,72,81,40,30,6,56,58,439
5431,Lorenzo Miles,SR,2006-07,G,Niagara,MAAC,34,1167,138,356,.388,77,177,61,179,.341,102,144,.708,34,84,118,120,40,1,76,87,439
5432,Robert Mitchell,JR,2008-09,F,Seton Hall,Big East,30,1084,169,406,.416,137,304,32,102,.314,69,93,.742,76,163,239,50,37,25,68,93,439
5433,Austin Montgomery,SR,2007-08,G,IUPUI,Summit,32,967,150,316,.475,78,146,72,170,.424,67,76,.882,22,76,98,51,33,11,56,69,439
5434,Obi Muonelo,SR,2009-10,G,Oklahoma State,Big 12,33,1010,148,342,.433,68,154,80,188,.426,63,107,.589,38,128,166,78,31,9,65,66,439
5435,Bubba Parham,FR,2017-18,G,Virginia Military Institute,Southern,30,895,145,363,.399,87,188,58,175,.331,91,114,.798,12,89,101,74,24,0,83,67,439
5436,Anthony Register,SR,2005-06,G,Stetson,A-Sun,32,1073,140,356,.393,95,218,45,138,.326,114,137,.832,26,87,113,56,64,0,75,57,439
5437,Travis Releford,SR,2012-13,G,Kansas,Big 12,37,1252,155,270,.574,116,176,39,94,.415,90,114,.789,43,99,142,95,47,9,59,73,439
5438,Justin Robinson,JR,2009-10,G,Rider,MAAC,33,1084,146,346,.422,82,203,64,143,.448,83,94,.883,18,97,115,91,48,5,57,84,439
5439,Robert Sacre,JR,2010-11,C,Gonzaga,WCC,35,906,138,283,.488,138,282,0,1,.000,163,198,.823,86,136,222,40,27,66,75,94,439
5440,Jherrod Stiggers,JR,2014-15,G,Houston,AAC,31,1105,139,384,.362,43,104,96,280,.343,65,85,.765,17,96,113,79,37,10,89,54,439
5441,Paul Stoll,SR,2007-08,G,Texas-Rio Grande Valley,Ind,31,1026,108,222,.486,22,41,86,181,.475,137,161,.851,6,75,81,224,79,4,109,82,439
5444,Omar Strong,JR,2011-12,G,Texas Southern,SWAC,33,1012,135,347,.389,33,85,102,262,.389,67,78,.859,15,63,78,53,32,2,69,72,439
5445,Kammron Taylor,JR,2005-06,G,Wisconsin,Big Ten,31,1064,140,364,.385,73,196,67,168,.399,92,111,.829,18,74,92,73,24,3,81,58,439
5446,Marc Trasolini,SO,2009-10,F,Santa Clara,WCC,32,936,149,280,.532,130,226,19,54,.352,122,156,.782,66,129,195,20,22,50,56,89,439
5447,Nick Ward,JR,2018-19,F,Michigan State,Big Ten,34,708,163,281,.580,161,279,2,2,1.000,111,170,.653,59,147,206,23,11,42,69,84,439
5448,Desmond Washington,SO,2012-13,G,Saint Peter's,MAAC,30,1033,146,392,.372,65,173,81,219,.370,66,75,.880,16,86,102,31,41,3,49,62,439
5449,Kevin Zabo,SR,2017-18,G,Kent State,MAC,34,980,155,369,.420,111,232,44,137,.321,85,108,.787,19,89,108,82,36,2,63,97,439
5450,Joe Zeglinski,SR,2010-11,G,Hartford,AEC,31,1116,143,427,.335,53,150,90,277,.325,63,98,.643,42,83,125,58,36,7,60,79,439
5451,Martin Zeno,SO,2005-06,G,Texas Tech,Big 12,32,1127,161,344,.468,156,327,5,17,.294,112,154,.727,49,122,171,91,45,13,79,70,439
5452,Shizz Alston,JR,2017-18,G,Temple,AAC,33,1111,157,392,.401,86,213,71,179,.397,53,59,.898,22,82,104,102,26,1,52,53,438
5453,James Anderson,FR,2007-08,G,Oklahoma State,Big 12,33,1021,148,340,.435,81,163,67,177,.379,75,105,.714,56,67,123,35,26,16,65,41,438
5454,Anthony Banks,SO,2010-11,F,Florida Gulf Coast,A-Sun,30,926,164,335,.490,164,333,0,2,.000,110,155,.710,106,85,191,26,23,13,73,78,438
5455,Brett Bisping,SO,2013-14,F,Siena,MAAC,38,1023,156,302,.517,144,264,12,38,.316,114,151,.755,98,150,248,29,23,35,50,131,438
5456,LaVell Boyd,JR,2015-16,G,Kansas City,WAC,31,1014,149,345,.432,68,152,81,193,.420,59,73,.808,13,92,105,70,24,4,45,78,438
5457,Brandon Brooks,SR,2008-09,G,Alabama State,SWAC,32,1137,143,285,.502,119,220,24,65,.369,128,166,.771,24,110,134,212,43,10,105,63,438
5458,Anthony Campbell,SR,2012-13,F,Austin Peay,OVC,30,930,149,324,.460,85,153,64,171,.374,76,88,.864,35,111,146,58,25,0,72,39,438
5459,Jordan Chatman,JR,2017-18,G,Boston College,ACC,34,1250,140,337,.415,53,117,87,220,.395,71,79,.899,16,84,100,54,22,1,28,58,438
5460,Simon Conn,SR,2005-06,C,Gardner-Webb,A-Sun,29,945,187,330,.567,186,324,1,6,.167,63,86,.733,95,149,244,50,18,70,69,77,438
5461,Vincent Council,SO,2010-11,G,Providence,Big East,32,1160,140,393,.356,93,254,47,139,.338,111,154,.721,40,95,135,189,55,14,106,77,438
5462,Michael Craion,JR,2009-10,F,Oral Roberts,Summit,33,1028,166,327,.508,163,312,3,15,.200,103,162,.636,82,160,242,52,42,32,75,93,438
5463,Scott Cutley,SR,2007-08,F,Cal State Fullerton,Big West,30,987,175,339,.516,164,304,11,35,.314,77,127,.606,65,158,223,85,37,6,77,61,438
5466,Tyler Davis,SO,2016-17,C,Texas A&M,SEC,31,812,166,269,.617,166,268,0,1,.000,106,153,.693,95,121,216,44,15,29,83,82,438
5467,Deki Delic,SR,2006-07,F,Monmouth,NEC,30,961,149,334,.446,69,124,80,210,.381,60,102,.588,20,85,105,63,18,7,65,72,438
5468,Nicchaeus Doaks,JR,2007-08,F,Chattanooga,Southern,31,860,164,279,.588,146,229,18,50,.360,92,137,.672,66,153,219,45,26,36,71,61,438
5469,Chris Flores,FR,2009-10,G,NJIT,GWC,31,935,151,359,.421,93,205,58,154,.377,78,115,.678,34,88,122,69,55,1,59,81,438
5470,Ramon Galloway,JR,2011-12,G,La Salle,A-10,31,1033,154,337,.457,86,183,68,154,.442,62,79,.785,17,127,144,108,47,8,94,73,438
5471,Jonathan Gibson,JR,2008-09,G,New Mexico State,WAC,31,934,149,350,.426,84,182,65,168,.387,75,109,.688,7,52,59,65,44,1,61,77,438
5472,JaMychal Green,SO,2009-10,F,Alabama,SEC,31,837,162,327,.495,162,322,0,5,.000,114,164,.695,86,136,222,33,27,52,79,97,438
5473,Ashley Hamilton,SR,2012-13,F,Loyola Marymount,WCC,34,1098,142,367,.387,114,285,28,82,.341,126,172,.733,75,168,243,48,35,14,106,97,438
5474,Desmar Jackson,SO,2010-11,G,Wyoming,MWC,30,893,151,340,.444,126,251,25,89,.281,111,147,.755,39,108,147,64,61,17,101,88,438
5475,James Johnson,FR,2007-08,F,Wake Forest,ACC,30,875,164,337,.487,136,237,28,100,.280,82,119,.689,93,151,244,37,41,40,78,93,438
5476,Marcus Johnson,JR,2015-16,G,Little Rock,Sun Belt,35,1072,140,296,.473,65,135,75,161,.466,83,106,.783,21,87,108,54,27,0,47,39,438
5477,Travele Jones,JR,2009-10,F,Texas Southern,SWAC,32,1034,147,311,.473,123,226,24,85,.282,120,204,.588,51,137,188,44,56,26,106,72,438
5478,Rysheed Jordan,SO,2014-15,G,St. John's (NY),Big East,31,952,143,329,.435,100,211,43,118,.364,109,166,.657,37,77,114,95,54,10,93,82,438
5479,Terrence Joyner,SR,2011-12,G,Mississippi Valley State,SWAC,34,1077,147,363,.405,78,175,69,188,.367,75,123,.610,44,71,115,88,43,3,74,90,438
5480,Evan Kelley,SR,2014-15,G,Sacred Heart,NEC,32,999,172,375,.459,161,326,11,49,.224,83,136,.610,30,99,129,76,38,7,68,62,438
5481,Andrew Lovedale,SR,2008-09,F,Davidson,Southern,35,1060,185,367,.504,185,367,0,0,,68,115,.591,99,207,306,23,31,54,59,91,438
5482,Tommy Mason-Griffin,FR,2009-10,G,Oklahoma,Big 12,31,1107,147,369,.398,77,204,70,165,.424,74,91,.813,15,74,89,154,28,0,87,41,438
5483,Kellen McCoy,SR,2008-09,G,Weber State,Big Sky,31,976,134,281,.477,74,144,60,137,.438,110,136,.809,20,91,111,85,41,1,91,67,438
5484,Lorenzo Miles,JR,2005-06,G,Niagara,MAAC,29,1075,134,347,.386,61,161,73,186,.392,97,130,.746,31,81,112,97,38,7,84,69,438
5485,Kenny Moore,JR,2010-11,F,Tennessee State,OVC,30,872,137,298,.460,101,210,36,88,.409,128,165,.776,72,134,206,56,42,12,87,93,438
5488,Davide Moretti,SO,2018-19,G,Texas Tech,Big 12,38,1199,134,269,.498,61,110,73,159,.459,97,105,.924,3,76,79,91,42,0,50,84,438
5489,Laurynas Motuzis,JR,2017-18,G,American,Patriot,30,1083,155,373,.416,92,183,63,190,.332,65,102,.637,22,121,143,50,49,7,66,85,438
5490,Miye Oni,SO,2017-18,G,Yale,Ivy,29,952,156,385,.405,99,201,57,184,.310,69,92,.750,26,147,173,105,27,22,81,82,438
5491,Miguel Paul,JR,2012-13,G,East Carolina,CUSA,33,1093,118,319,.370,59,146,59,173,.341,143,164,.872,8,64,72,236,49,5,120,87,438
5492,David Perez,SO,2009-10,G,Centenary (LA),Summit,29,841,138,322,.429,73,157,65,165,.394,97,115,.843,22,53,75,54,29,0,53,56,438
5493,Corey Petros,JR,2013-14,C,Oakland,Horizon,33,1171,182,316,.576,182,316,0,0,,74,145,.510,102,170,272,50,16,14,48,72,438
5494,Nate Pierre-Louis,SO,2018-19,G,Temple,AAC,33,1132,153,333,.459,127,249,26,84,.310,106,159,.667,43,149,192,69,53,10,56,75,438
5495,Giddy Potts,SR,2017-18,G,Middle Tennessee,CUSA,33,1051,142,343,.414,57,133,85,210,.405,69,80,.863,15,126,141,63,45,8,54,85,438
5496,Darion Rackley,SR,2014-15,G,Jacksonville State,OVC,29,941,120,338,.355,80,195,40,143,.280,158,211,.749,29,83,112,62,41,7,77,60,438
5497,Alex Robinson,SO,2016-17,G,Texas Christian,Big 12,39,1283,164,391,.419,125,274,39,117,.333,71,112,.634,18,104,122,228,59,20,107,73,438
5498,Tony Snell,JR,2012-13,G,New Mexico,MWC,35,1093,144,341,.422,80,177,64,164,.390,86,102,.843,14,78,92,101,29,17,72,46,438
5499,Jackson Stevenett,JR,2011-12,F,Southern Utah,Summit,31,1008,166,324,.512,157,297,9,27,.333,97,128,.758,60,116,176,47,21,22,64,86,438
5500,Marcus Stout,SR,2007-08,G,Fordham,A-10,29,975,152,379,.401,79,169,73,210,.348,61,84,.726,19,52,71,85,29,0,69,76,438
5501,D'Shon Taylor,SR,2015-16,G,Norfolk State,MEAC,33,946,147,327,.450,103,203,44,124,.355,100,130,.769,57,118,175,51,38,20,63,86,438
5502,Jeffery Taylor,FR,2009-10,F,Vanderbilt,SEC,33,883,148,300,.493,147,289,1,11,.091,141,189,.746,64,108,172,57,36,13,74,87,438
5503,Junior Treasure,JR,2009-10,G,Texas Southern,SWAC,30,834,136,341,.399,83,165,53,176,.301,113,146,.774,12,63,75,87,55,3,101,93,438
5504,Ladarious Weaver,JR,2006-07,G,Tennessee State,OVC,32,1101,155,387,.401,62,131,93,256,.363,35,48,.729,20,69,89,56,37,3,44,69,438
5505,Devonta White,SO,2011-12,G,Georgia State,CAA,34,1165,148,378,.392,94,221,54,157,.344,88,106,.830,19,57,76,100,60,2,67,73,438
5506,Isaac Williams,SR,2016-17,G,Mississippi Valley State,SWAC,32,916,157,395,.397,91,209,66,186,.355,58,70,.829,40,75,115,29,28,4,23,65,438
5507,Braian Angola-Rodas,SR,2017-18,G,Florida State,ACC,35,963,135,324,.417,71,154,64,170,.376,103,123,.837,32,106,138,105,46,9,72,86,437
